customer_id,recency_days,frequency,monetary,R_score,F_score,M_score,RFM_score,segment
1,278,12,2460.02,2,4,4,10,At Risk
2,681,13,3148.68,1,4,5,10,At Risk
3,109,9,642.51,4,2,1,7,Regulars
4,28,15,2096.85,5,5,4,14,Champions
5,141,14,5110.12,4,5,5,14,Champions
6,181,6,635.22,3,1,1,5,Regulars
7,465,10,724.66,1,3,1,5,Regulars
8,126,15,2435.58,4,5,4,13,Champions
9,166,9,1002.13,3,2,2,7,Regulars
10,600,10,1079.04,1,3,2,6,Regulars
11,234,11,1133.14,3,3,2,8,Regulars
12,394,7,1210.15,2,1,2,5,Hibernating
13,191,4,1461.49,3,1,3,7,Regulars
14,314,13,2638.42,2,4,5,11,At Risk
15,40,12,3856.42,5,4,5,14,Champions
16,447,11,969.6200000000001,2,3,2,7,Regulars
17,212,11,2112.79,3,3,4,10,Big Spenders
18,697,6,635.01,1,1,1,3,Hibernating
19,528,12,2674.6499999999996,1,4,5,10,At Risk
20,127,11,843.54,4,3,1,8,Loyal
21,551,5,2216.35,1,1,4,6,Regulars
22,616,10,2236.7400000000002,1,3,4,8,Regulars
23,120,16,1948.07,4,5,4,13,Champions
24,110,11,3482.07,4,3,5,12,Loyal
25,566,13,3157.65,1,4,5,10,At Risk
26,272,7,4972.34,2,1,5,8,Regulars
27,207,2,133.64000000000001,3,1,1,5,Regulars
28,140,10,1212.1399999999999,4,3,2,9,Loyal
29,26,9,2327.27,5,2,4,11,Big Spenders
30,234,9,1177.3400000000001,3,2,2,7,Regulars
31,322,9,687.73,2,2,1,5,Hibernating
32,76,7,546.59,4,1,1,6,Regulars
33,57,12,1431.0900000000001,5,4,3,12,Loyal
34,135,14,4988.78,4,5,5,14,Champions
35,142,9,2947.31,4,2,5,11,Big Spenders
36,1424,10,4671.5599999999995,1,3,5,9,Regulars
37,122,11,1748.5400000000002,4,3,4,11,Loyal
38,23,11,2037.26,5,3,4,12,Loyal
39,26,8,3262.69,5,2,5,12,Big Spenders
40,267,6,939.29,2,1,2,5,Hibernating
41,31,9,1018.05,5,2,2,9,Regulars
42,308,17,3284.36,2,5,5,12,At Risk
43,99,8,595.65,4,2,1,7,Regulars
44,554,9,3390.2299999999996,1,2,5,8,Regulars
45,597,8,858.9399999999999,1,2,2,5,Hibernating
46,54,11,1616.91,5,3,3,11,Loyal
47,1328,7,1058.0900000000001,1,1,2,4,Hibernating
48,78,7,387.15999999999997,4,1,1,6,Regulars
49,190,14,2069.2200000000003,3,5,4,12,Big Spenders
50,228,6,646.15,3,1,1,5,Regulars
51,691,6,762.94,1,1,1,3,Hibernating
52,426,9,1298.35,2,2,3,7,Regulars
53,590,8,1017.96,1,2,2,5,Hibernating
54,40,12,2114.92,5,4,4,13,Champions
55,319,10,1115.34,2,3,2,7,Regulars
56,189,12,1618.1100000000001,3,4,3,10,Regulars
57,87,16,1744.22,4,5,4,13,Champions
58,137,12,3857.27,4,4,5,13,Champions
59,109,10,976.52,4,3,2,9,Loyal
60,141,11,1353.45,4,3,3,10,Loyal
61,230,11,1508.69,3,3,3,9,Regulars
62,376,12,728.51,2,4,1,7,At Risk
63,39,11,5927.23,5,3,5,13,Loyal
64,123,9,6639.380000000001,4,2,5,11,Big Spenders
65,431,4,773.9200000000001,2,1,1,4,Hibernating
66,244,12,1253.79,3,4,3,10,Regulars
67,129,10,1781.5300000000002,4,3,4,11,Loyal
68,22,7,1438.35,5,1,3,9,Regulars
69,811,2,85.96000000000001,1,1,1,3,Hibernating
70,931,10,955.1700000000001,1,3,2,6,Regulars
71,256,13,2350.54,2,4,4,10,At Risk
72,86,12,1748.6000000000001,4,4,4,12,Champions
73,9,14,2758.82,5,5,5,15,Champions
74,141,12,935.8,4,4,2,10,Loyal
75,161,13,6380.610000000001,3,4,5,12,Big Spenders
76,324,7,1504.44,2,1,3,6,Regulars
77,123,14,1145.72,4,5,2,11,Loyal
78,521,14,3198.9799999999996,1,5,5,11,At Risk
79,30,11,2142.56,5,3,4,12,Loyal
80,105,14,2232.28,4,5,4,13,Champions
81,97,11,851.2,4,3,2,9,Loyal
82,38,13,2954.4700000000003,5,4,5,14,Champions
83,408,8,866.49,2,2,2,6,Hibernating
84,53,11,3160.04,5,3,5,13,Loyal
85,636,7,775.1899999999999,1,1,1,3,Hibernating
86,180,7,414.07,3,1,1,5,Regulars
87,272,7,809.1899999999999,2,1,1,4,Hibernating
88,210,7,788.1099999999999,3,1,1,5,Regulars
89,167,8,917.26,3,2,2,7,Regulars
90,496,11,2058.7799999999997,1,3,4,8,Regulars
91,166,6,644.13,3,1,1,5,Regulars
92,241,11,1691.7800000000002,3,3,3,9,Regulars
93,92,8,879.64,4,2,2,8,Regulars
94,129,12,1343.8600000000001,4,4,3,11,Loyal
95,154,15,857.48,3,5,2,10,Regulars
96,16,10,1824.2,5,3,4,12,Loyal
97,192,10,1148.28,3,3,2,8,Regulars
98,103,3,687.3800000000001,4,1,1,6,Regulars
99,529,8,2976.4,1,2,5,8,Regulars
100,50,9,1116.64,5,2,2,9,Regulars
101,530,8,3231.62,1,2,5,8,Regulars
102,252,13,4090.53,2,4,5,11,At Risk
103,35,10,1094.57,5,3,2,10,Loyal
104,912,11,1954.03,1,3,4,8,Regulars
105,331,17,2299.55,2,5,4,11,At Risk
106,831,11,2886.77,1,3,5,9,Regulars
107,230,9,1120.92,3,2,2,7,Regulars
108,142,9,2722.32,4,2,5,11,Big Spenders
109,106,10,1689.95,4,3,3,10,Loyal
110,161,8,1858.6,3,2,4,9,Big Spenders
111,1048,14,1854.54,1,5,4,10,At Risk
112,281,10,2826.6400000000003,2,3,5,10,Regulars
113,217,7,1023.18,3,1,2,6,Regulars
114,35,12,2994.77,5,4,5,14,Champions
115,274,4,999.51,2,1,2,5,Hibernating
116,33,11,1671.0,5,3,3,11,Loyal
117,57,9,1043.71,5,2,2,9,Regulars
118,230,21,4735.47,3,5,5,13,Big Spenders
119,11,8,1282.1,5,2,3,10,Regulars
120,46,14,1269.3100000000002,5,5,3,13,Loyal
121,1074,2,186.20999999999998,1,1,1,3,Hibernating
122,158,7,1173.5900000000001,3,1,2,6,Regulars
123,2,12,1337.82,5,4,3,12,Loyal
124,1890,5,264.26,1,1,1,3,Hibernating
125,391,9,732.65,2,2,1,5,Hibernating
126,355,6,860.44,2,1,2,5,Hibernating
127,1884,5,1635.5,1,1,3,5,Regulars
128,341,9,1321.29,2,2,3,7,Regulars
129,402,9,3989.2799999999997,2,2,5,9,Regulars
130,262,5,1723.45,2,1,3,6,Regulars
131,252,6,1604.5200000000002,2,1,3,6,Regulars
132,385,9,1480.3200000000002,2,2,3,7,Regulars
133,461,7,992.03,1,1,2,4,Hibernating
134,70,13,3532.52,4,4,5,13,Champions
135,105,10,3089.3100000000004,4,3,5,12,Loyal
136,182,15,4022.16,3,5,5,13,Big Spenders
137,140,5,439.33000000000004,4,1,1,6,Regulars
138,26,9,1638.67,5,2,3,10,Regulars
139,105,10,1045.8,4,3,2,9,Loyal
140,242,10,1245.32,3,3,3,9,Regulars
141,70,8,622.16,4,2,1,7,Regulars
142,308,10,1884.38,2,3,4,9,Regulars
143,161,10,1347.26,3,3,3,9,Regulars
144,109,8,630.05,4,2,1,7,Regulars
145,488,12,3090.2599999999998,1,4,5,10,At Risk
146,399,9,3594.95,2,2,5,9,Regulars
147,84,12,4301.35,4,4,5,13,Champions
148,243,9,824.44,3,2,1,6,Regulars
149,29,7,541.97,5,1,1,7,Regulars
150,558,6,1098.95,1,1,2,4,Hibernating
151,49,14,7051.79,5,5,5,15,Champions
152,399,13,3068.2200000000003,2,4,5,11,At Risk
153,437,8,1583.96,2,2,3,7,Regulars
154,65,8,1445.73,5,2,3,10,Regulars
155,385,9,1468.31,2,2,3,7,Regulars
156,609,11,1171.41,1,3,2,6,Regulars
157,60,11,1927.3899999999999,5,3,4,12,Loyal
158,521,11,1607.5,1,3,3,7,Regulars
159,239,12,941.9100000000001,3,4,2,9,Regulars
160,191,8,1356.68,3,2,3,8,Regulars
161,223,7,865.06,3,1,2,6,Regulars
162,549,7,2123.54,1,1,4,6,Regulars
163,168,6,817.53,3,1,1,5,Regulars
164,264,9,1583.24,2,2,3,7,Regulars
165,258,7,1709.47,2,1,3,6,Regulars
166,240,13,1626.18,3,4,3,10,Regulars
167,1061,7,2043.71,1,1,4,6,Regulars
168,210,14,1561.3400000000001,3,5,3,11,Regulars
169,513,4,408.15,1,1,1,3,Hibernating
170,119,7,822.21,4,1,1,6,Regulars
171,139,15,3141.11,4,5,5,14,Champions
172,2,8,588.02,5,2,1,8,Regulars
173,11,10,1688.24,5,3,3,11,Loyal
174,56,11,1193.31,5,3,2,10,Loyal
175,272,12,1198.07,2,4,2,8,At Risk
176,229,8,2351.6200000000003,3,2,4,9,Big Spenders
177,269,8,1043.46,2,2,2,6,Hibernating
178,157,8,2005.55,3,2,4,9,Big Spenders
179,45,12,2125.34,5,4,4,13,Champions
180,92,21,3541.33,4,5,5,14,Champions
181,181,13,1944.04,3,4,4,11,Big Spenders
182,195,7,847.9,3,1,2,6,Regulars
183,268,8,1333.01,2,2,3,7,Regulars
184,369,6,1148.06,2,1,2,5,Hibernating
185,86,15,3519.64,4,5,5,14,Champions
186,134,10,1045.79,4,3,2,9,Loyal
187,132,15,1692.99,4,5,3,12,Loyal
188,168,9,5413.67,3,2,5,10,Big Spenders
189,91,6,387.0,4,1,1,6,Regulars
190,250,12,1348.03,2,4,3,9,At Risk
191,88,13,2191.28,4,4,4,12,Champions
192,29,17,1888.49,5,5,4,14,Champions
193,223,12,2869.9700000000003,3,4,5,12,Big Spenders
194,27,11,690.1,5,3,1,9,Loyal
195,53,5,372.6,5,1,1,7,Regulars
196,423,4,429.59000000000003,2,1,1,4,Hibernating
197,144,7,1551.79,4,1,3,8,Regulars
198,17,8,962.7,5,2,2,9,Regulars
199,74,11,801.35,4,3,1,8,Loyal
200,28,15,1418.98,5,5,3,13,Loyal
201,502,12,1204.01,1,4,2,7,At Risk
202,1249,7,447.77,1,1,1,3,Hibernating
203,146,17,3151.23,4,5,5,14,Champions
204,86,8,653.36,4,2,1,7,Regulars
205,582,11,2828.91,1,3,5,9,Regulars
206,5,15,3166.0899999999997,5,5,5,15,Champions
207,100,9,689.66,4,2,1,7,Regulars
208,868,9,1254.93,1,2,3,6,Regulars
209,42,5,516.08,5,1,1,7,Regulars
210,45,10,825.24,5,3,1,9,Loyal
211,318,12,1742.05,2,4,4,10,At Risk
212,235,12,640.15,3,4,1,8,Regulars
213,496,10,1603.14,1,3,3,7,Regulars
214,100,12,1994.56,4,4,4,12,Champions
215,160,10,2406.85,3,3,4,10,Big Spenders
216,59,7,685.1,5,1,1,7,Regulars
217,309,11,1269.17,2,3,3,8,Regulars
218,14,14,3867.29,5,5,5,15,Champions
219,2,13,5459.7,5,4,5,14,Champions
220,530,7,527.63,1,1,1,3,Hibernating
221,49,14,1732.95,5,5,4,14,Champions
222,228,13,2498.85,3,4,4,11,Big Spenders
223,590,6,433.91,1,1,1,3,Hibernating
224,83,12,1185.73,4,4,2,10,Loyal
225,124,9,3398.98,4,2,5,11,Big Spenders
226,109,14,3151.75,4,5,5,14,Champions
227,22,17,1436.71,5,5,3,13,Loyal
228,54,12,975.11,5,4,2,11,Loyal
229,172,21,3381.23,3,5,5,13,Big Spenders
230,246,13,2547.4,3,4,4,11,Big Spenders
231,46,10,1410.5600000000002,5,3,3,11,Loyal
232,635,11,5813.3099999999995,1,3,5,9,Regulars
233,477,8,769.36,1,2,1,4,Hibernating
234,607,11,992.1899999999999,1,3,2,6,Regulars
235,58,17,2428.89,5,5,4,14,Champions
236,85,11,3467.86,4,3,5,12,Loyal
237,178,15,1429.7,3,5,3,11,Regulars
238,345,10,608.95,2,3,1,6,Regulars
239,308,8,1426.63,2,2,3,7,Regulars
240,42,11,2234.96,5,3,4,12,Loyal
241,127,11,1556.7,4,3,3,10,Loyal
242,407,11,1561.28,2,3,3,8,Regulars
243,103,6,369.05,4,1,1,6,Regulars
244,0,9,860.59,5,2,2,9,Regulars
245,321,8,678.37,2,2,1,5,Hibernating
246,163,11,1214.7,3,3,2,8,Regulars
247,4,9,1454.54,5,2,3,10,Regulars
248,291,12,6611.05,2,4,5,11,At Risk
249,119,10,1871.55,4,3,4,11,Loyal
250,24,17,2537.85,5,5,4,14,Champions
251,211,10,2163.88,3,3,4,10,Big Spenders
252,0,12,1710.98,5,4,3,12,Loyal
253,495,9,594.0600000000001,1,2,1,4,Hibernating
254,359,5,1821.27,2,1,4,7,Regulars
255,162,12,1717.2199999999998,3,4,3,10,Regulars
256,53,12,895.51,5,4,2,11,Loyal
257,147,9,1697.25,4,2,3,9,Regulars
258,71,8,723.88,4,2,1,7,Regulars
259,714,9,785.27,1,2,1,4,Hibernating
260,334,7,1696.5900000000001,2,1,3,6,Regulars
261,223,13,1256.55,3,4,3,10,Regulars
262,341,10,2437.4,2,3,4,9,Regulars
263,125,8,1052.62,4,2,2,8,Regulars
264,94,10,1636.5,4,3,3,10,Loyal
265,31,14,3886.06,5,5,5,15,Champions
266,194,9,1649.81,3,2,3,8,Regulars
267,114,11,1311.4299999999998,4,3,3,10,Loyal
268,184,7,633.79,3,1,1,5,Regulars
269,284,11,2289.38,2,3,4,9,Regulars
270,133,9,2880.81,4,2,5,11,Big Spenders
271,48,12,1819.24,5,4,4,13,Champions
272,204,13,876.99,3,4,2,9,Regulars
273,23,5,2545.54,5,1,4,10,Big Spenders
274,161,13,2763.7200000000003,3,4,5,12,Big Spenders
275,124,11,1189.49,4,3,2,9,Loyal
276,84,3,239.64000000000001,4,1,1,6,Regulars
277,463,8,2683.87,1,2,5,8,Regulars
278,331,8,1002.8399999999999,2,2,2,6,Hibernating
279,110,15,3256.75,4,5,5,14,Champions
280,75,14,1007.08,4,5,2,11,Loyal
281,623,17,2262.4300000000003,1,5,4,10,At Risk
282,156,13,3438.37,3,4,5,12,Big Spenders
283,180,12,2255.71,3,4,4,11,Big Spenders
284,134,12,1088.05,4,4,2,10,Loyal
285,63,10,752.5699999999999,5,3,1,9,Loyal
286,139,7,887.9300000000001,4,1,2,7,Regulars
287,541,12,1419.1299999999999,1,4,3,8,At Risk
288,6,12,2070.88,5,4,4,13,Champions
289,63,6,542.6899999999999,5,1,1,7,Regulars
290,44,12,1837.06,5,4,4,13,Champions
291,214,12,3980.23,3,4,5,12,Big Spenders
292,73,12,2078.83,4,4,4,12,Champions
293,767,10,1220.71,1,3,2,6,Regulars
294,847,8,1103.72,1,2,2,5,Hibernating
295,43,16,3817.0099999999998,5,5,5,15,Champions
296,251,13,2223.82,2,4,4,10,At Risk
297,225,8,1073.55,3,2,2,7,Regulars
298,419,13,1431.81,2,4,3,9,At Risk
299,96,11,994.98,4,3,2,9,Loyal
300,192,7,777.76,3,1,1,5,Regulars
301,567,6,1262.97,1,1,3,5,Regulars
302,33,12,682.08,5,4,1,10,Loyal
303,466,5,711.98,1,1,1,3,Hibernating
304,792,12,2133.77,1,4,4,9,At Risk
305,263,6,899.5899999999999,2,1,2,5,Hibernating
306,164,11,1131.74,3,3,2,8,Regulars
307,62,14,1566.3999999999999,5,5,3,13,Loyal
308,346,8,868.85,2,2,2,6,Hibernating
309,442,13,1577.87,2,4,3,9,At Risk
310,131,11,1914.05,4,3,4,11,Loyal
311,285,11,736.6700000000001,2,3,1,6,Regulars
312,520,10,874.64,1,3,2,6,Regulars
313,69,4,554.61,4,1,1,6,Regulars
314,346,6,506.71999999999997,2,1,1,4,Hibernating
315,116,16,3472.19,4,5,5,14,Champions
316,229,11,2353.84,3,3,4,10,Big Spenders
317,11,13,3321.01,5,4,5,14,Champions
318,398,6,961.75,2,1,2,5,Hibernating
319,481,19,2449.15,1,5,4,10,At Risk
320,485,7,2737.0,1,1,5,7,Regulars
321,4,11,4084.33,5,3,5,13,Loyal
322,61,5,966.65,5,1,2,8,Regulars
323,187,7,1407.3000000000002,3,1,3,7,Regulars
324,52,10,1567.97,5,3,3,11,Loyal
325,528,5,951.62,1,1,2,4,Hibernating
326,133,9,2616.18,4,2,5,11,Big Spenders
327,171,9,1244.87,3,2,3,8,Regulars
328,19,16,1223.04,5,5,2,12,Loyal
329,304,16,5102.6900000000005,2,5,5,12,At Risk
330,528,12,2174.76,1,4,4,9,At Risk
331,1062,9,2659.99,1,2,5,8,Regulars
332,476,3,224.15,1,1,1,3,Hibernating
333,0,15,1706.51,5,5,3,13,Loyal
334,244,7,473.43,3,1,1,5,Regulars
335,300,14,2257.2,2,5,4,11,At Risk
336,389,14,5309.2,2,5,5,12,At Risk
337,69,11,1493.17,4,3,3,10,Loyal
338,22,6,674.32,5,1,1,7,Regulars
339,350,7,722.44,2,1,1,4,Hibernating
340,188,13,3375.04,3,4,5,12,Big Spenders
341,232,12,1185.04,3,4,2,9,Regulars
342,6,15,2323.07,5,5,4,14,Champions
343,91,15,2887.6099999999997,4,5,5,14,Champions
344,175,11,877.82,3,3,2,8,Regulars
345,65,9,1614.92,5,2,3,10,Regulars
346,21,5,1115.79,5,1,2,8,Regulars
347,174,13,1991.33,3,4,4,11,Big Spenders
348,28,11,1704.2,5,3,3,11,Loyal
349,767,9,513.19,1,2,1,4,Hibernating
350,171,10,948.64,3,3,2,8,Regulars
351,133,10,1083.31,4,3,2,9,Loyal
352,1124,7,540.12,1,1,1,3,Hibernating
353,651,7,1127.42,1,1,2,4,Hibernating
354,142,10,780.69,4,3,1,8,Loyal
355,567,5,210.39000000000001,1,1,1,3,Hibernating
356,9,16,1592.26,5,5,3,13,Loyal
357,474,6,509.51,1,1,1,3,Hibernating
358,354,12,2900.25,2,4,5,11,At Risk
359,418,6,824.9399999999999,2,1,1,4,Hibernating
360,82,10,1338.4699999999998,4,3,3,10,Loyal
361,180,9,1015.87,3,2,2,7,Regulars
362,139,9,1673.6,4,2,3,9,Regulars
363,27,12,1905.56,5,4,4,13,Champions
364,475,9,1997.46,1,2,4,7,Regulars
365,509,11,1273.43,1,3,3,7,Regulars
366,13,6,402.24,5,1,1,7,Regulars
367,621,12,1916.63,1,4,4,9,At Risk
368,36,11,1161.72,5,3,2,10,Loyal
369,295,12,5863.51,2,4,5,11,At Risk
370,36,15,2099.4900000000002,5,5,4,14,Champions
371,124,11,2650.5600000000004,4,3,5,12,Loyal
372,443,12,1932.0800000000002,2,4,4,10,At Risk
373,175,11,1938.89,3,3,4,10,Big Spenders
374,295,14,1866.6499999999999,2,5,4,11,At Risk
375,85,15,1491.1399999999999,4,5,3,12,Loyal
376,262,9,805.28,2,2,1,5,Hibernating
377,93,14,1582.2,4,5,3,12,Loyal
378,107,18,2175.5099999999998,4,5,4,13,Champions
379,110,6,1237.7799999999997,4,1,2,7,Regulars
380,341,17,2057.06,2,5,4,11,At Risk
381,146,12,4688.74,4,4,5,13,Champions
382,477,7,640.14,1,1,1,3,Hibernating
383,1089,4,1242.78,1,1,3,5,Regulars
384,284,13,915.7299999999999,2,4,2,8,At Risk
385,316,7,758.31,2,1,1,4,Hibernating
386,130,12,3241.41,4,4,5,13,Champions
387,592,10,1234.67,1,3,2,6,Regulars
388,119,9,861.76,4,2,2,8,Regulars
389,227,12,602.8100000000001,3,4,1,8,Regulars
390,1265,7,691.94,1,1,1,3,Hibernating
391,312,8,959.59,2,2,2,6,Hibernating
392,0,11,1904.71,5,3,4,12,Loyal
393,514,9,862.93,1,2,2,5,Hibernating
394,81,10,1185.44,4,3,2,9,Loyal
395,621,6,569.97,1,1,1,3,Hibernating
396,345,10,4695.17,2,3,5,10,Regulars
397,13,12,6618.12,5,4,5,14,Champions
398,250,13,1912.6,2,4,4,10,At Risk
399,112,11,1139.96,4,3,2,9,Loyal
400,337,15,1152.34,2,5,2,9,At Risk
401,365,7,453.72,2,1,1,4,Hibernating
402,542,12,1429.89,1,4,3,8,At Risk
403,1236,8,1773.37,1,2,4,7,Regulars
404,93,14,1749.3400000000001,4,5,4,13,Champions
405,276,5,1000.76,2,1,2,5,Hibernating
406,166,7,581.86,3,1,1,5,Regulars
407,540,14,1553.1,1,5,3,9,At Risk
408,247,9,761.3,3,2,1,6,Regulars
409,359,4,392.59000000000003,2,1,1,4,Hibernating
410,31,18,4723.950000000001,5,5,5,15,Champions
411,249,8,918.49,2,2,2,6,Hibernating
412,119,12,1829.63,4,4,4,12,Champions
413,86,8,1538.66,4,2,3,9,Regulars
414,473,9,3068.0,1,2,5,8,Regulars
415,318,6,1202.27,2,1,2,5,Hibernating
416,391,10,1159.17,2,3,2,7,Regulars
417,63,8,1593.99,5,2,3,10,Regulars
418,53,9,2859.6,5,2,5,12,Big Spenders
419,530,5,282.99,1,1,1,3,Hibernating
420,336,7,841.44,2,1,1,4,Hibernating
421,16,18,7385.98,5,5,5,15,Champions
422,93,10,1186.48,4,3,2,9,Loyal
423,35,5,542.9000000000001,5,1,1,7,Regulars
424,411,10,1129.1799999999998,2,3,2,7,Regulars
425,271,9,3606.2,2,2,5,9,Regulars
426,250,12,1301.32,2,4,3,9,At Risk
427,432,9,954.96,2,2,2,6,Hibernating
428,147,11,2372.65,4,3,4,11,Loyal
429,0,7,873.18,5,1,2,8,Regulars
430,32,16,1743.12,5,5,4,14,Champions
431,139,9,473.53,4,2,1,7,Regulars
432,399,12,1762.49,2,4,4,10,At Risk
433,41,17,2035.4899999999998,5,5,4,14,Champions
434,29,6,624.17,5,1,1,7,Regulars
435,36,14,4242.65,5,5,5,15,Champions
436,582,12,1465.58,1,4,3,8,At Risk
437,114,15,1926.9699999999998,4,5,4,13,Champions
438,35,11,1521.46,5,3,3,11,Loyal
439,195,10,1239.34,3,3,2,8,Regulars
440,327,7,522.8599999999999,2,1,1,4,Hibernating
441,715,9,1451.72,1,2,3,6,Regulars
442,152,12,954.25,3,4,2,9,Regulars
443,479,6,356.54,1,1,1,3,Hibernating
444,93,10,1611.3899999999999,4,3,3,10,Loyal
445,91,8,773.36,4,2,1,7,Regulars
446,127,10,855.75,4,3,2,9,Loyal
447,97,10,1776.1299999999999,4,3,4,11,Loyal
448,128,9,3280.98,4,2,5,11,Big Spenders
449,311,8,1661.3600000000001,2,2,3,7,Regulars
450,308,8,2150.71,2,2,4,8,Regulars
451,23,15,2127.64,5,5,4,14,Champions
452,218,4,3351.2299999999996,3,1,5,9,Big Spenders
453,4,11,885.4200000000001,5,3,2,10,Loyal
454,60,12,1482.94,5,4,3,12,Loyal
455,147,15,1392.49,4,5,3,12,Loyal
456,56,8,1198.9,5,2,2,9,Regulars
457,36,8,2921.46,5,2,5,12,Big Spenders
458,319,14,2592.64,2,5,5,12,At Risk
459,130,8,519.92,4,2,1,7,Regulars
460,527,6,1156.4,1,1,2,4,Hibernating
461,724,9,539.21,1,2,1,4,Hibernating
462,127,15,2929.46,4,5,5,14,Champions
463,101,10,1591.4399999999998,4,3,3,10,Loyal
464,792,6,543.79,1,1,1,3,Hibernating
465,161,9,1048.0,3,2,2,7,Regulars
466,400,10,2095.88,2,3,4,9,Regulars
467,261,8,581.37,2,2,1,5,Hibernating
468,1063,9,2891.77,1,2,5,8,Regulars
469,979,9,2471.3599999999997,1,2,4,7,Regulars
470,621,7,538.78,1,1,1,3,Hibernating
471,145,11,2142.04,4,3,4,11,Loyal
472,200,13,2665.65,3,4,5,12,Big Spenders
473,643,9,1013.04,1,2,2,5,Hibernating
474,224,8,3119.66,3,2,5,10,Big Spenders
475,83,10,851.13,4,3,2,9,Loyal
476,473,9,1237.79,1,2,2,5,Hibernating
477,247,5,461.56,3,1,1,5,Regulars
478,160,9,1929.93,3,2,4,9,Big Spenders
479,200,8,2493.19,3,2,4,9,Big Spenders
480,10,10,1836.57,5,3,4,12,Loyal
481,83,10,2518.24,4,3,4,11,Loyal
482,61,13,1970.57,5,4,4,13,Champions
483,798,12,1462.9,1,4,3,8,At Risk
484,392,14,1433.9,2,5,3,10,At Risk
485,133,13,2739.3,4,4,5,13,Champions
486,88,9,1310.8200000000002,4,2,3,9,Regulars
487,32,12,2359.0099999999998,5,4,4,13,Champions
488,31,10,2447.51,5,3,4,12,Loyal
489,77,11,1349.5,4,3,3,10,Loyal
490,301,11,1933.0200000000002,2,3,4,9,Regulars
491,195,8,1717.94,3,2,3,8,Regulars
492,148,11,1450.3,3,3,3,9,Regulars
493,220,13,1580.3799999999999,3,4,3,10,Regulars
494,474,12,2112.01,1,4,4,9,At Risk
495,216,10,763.9300000000001,3,3,1,7,Regulars
496,309,6,746.3699999999999,2,1,1,4,Hibernating
497,450,8,765.64,2,2,1,5,Hibernating
498,309,8,826.94,2,2,1,5,Hibernating
499,317,11,3255.8199999999997,2,3,5,10,Regulars
500,274,7,2237.95,2,1,4,7,Regulars
501,53,7,1106.79,5,1,2,8,Regulars
502,956,5,2315.59,1,1,4,6,Regulars
503,61,11,1132.36,5,3,2,10,Loyal
504,498,7,382.15,1,1,1,3,Hibernating
505,82,10,1866.3500000000001,4,3,4,11,Loyal
506,16,10,1807.12,5,3,4,12,Loyal
507,507,6,928.3,1,1,2,4,Hibernating
508,35,11,1897.4599999999998,5,3,4,12,Loyal
509,63,6,564.6,5,1,1,7,Regulars
510,155,14,3960.75,3,5,5,13,Big Spenders
511,164,12,1534.2399999999998,3,4,3,10,Regulars
512,275,9,941.18,2,2,2,6,Hibernating
513,295,14,1285.69,2,5,3,10,At Risk
514,395,10,1428.25,2,3,3,8,Regulars
515,63,12,1581.08,5,4,3,12,Loyal
516,854,8,671.9,1,2,1,4,Hibernating
517,322,9,1354.05,2,2,3,7,Regulars
518,50,12,1647.6399999999999,5,4,3,12,Loyal
519,12,10,3462.2599999999998,5,3,5,13,Loyal
520,129,8,3281.96,4,2,5,11,Big Spenders
521,0,15,2147.8,5,5,4,14,Champions
522,455,13,1230.04,2,4,2,8,At Risk
523,482,12,2385.2799999999997,1,4,4,9,At Risk
524,31,11,1749.8899999999999,5,3,4,12,Loyal
525,40,12,3308.47,5,4,5,14,Champions
526,23,13,2634.54,5,4,5,14,Champions
527,205,10,680.15,3,3,1,7,Regulars
528,347,11,1206.53,2,3,2,7,Regulars
529,135,7,773.63,4,1,1,6,Regulars
530,116,7,1159.96,4,1,2,7,Regulars
531,793,5,1898.6799999999998,1,1,4,6,Regulars
532,6,13,4861.900000000001,5,4,5,14,Champions
533,667,6,794.72,1,1,1,3,Hibernating
534,89,5,364.13,4,1,1,6,Regulars
535,52,8,723.01,5,2,1,8,Regulars
536,166,15,1327.3200000000002,3,5,3,11,Regulars
537,578,8,495.85999999999996,1,2,1,4,Hibernating
538,8,6,2132.3,5,1,4,10,Big Spenders
539,97,14,2028.16,4,5,4,13,Champions
540,30,12,1981.8400000000001,5,4,4,13,Champions
541,628,14,1382.22,1,5,3,9,At Risk
542,665,12,1514.33,1,4,3,8,At Risk
543,199,12,894.5699999999999,3,4,2,9,Regulars
544,178,15,3937.6499999999996,3,5,5,13,Big Spenders
545,462,10,2644.71,1,3,5,9,Regulars
546,8,7,510.56,5,1,1,7,Regulars
547,106,11,790.51,4,3,1,8,Loyal
548,143,11,935.81,4,3,2,9,Loyal
549,408,14,1129.84,2,5,2,9,At Risk
550,204,14,1415.93,3,5,3,11,Regulars
551,79,12,1895.3400000000001,4,4,4,12,Champions
552,8,7,679.75,5,1,1,7,Regulars
553,110,18,2970.96,4,5,5,14,Champions
554,72,9,2865.39,4,2,5,11,Big Spenders
555,992,5,2357.66,1,1,4,6,Regulars
556,746,11,775.73,1,3,1,5,Regulars
557,269,9,2424.27,2,2,4,8,Regulars
558,866,15,1771.55,1,5,4,10,At Risk
559,2,15,2625.2799999999997,5,5,5,15,Champions
560,6,16,2740.82,5,5,5,15,Champions
561,106,14,2044.0900000000001,4,5,4,13,Champions
562,142,9,1369.89,4,2,3,9,Regulars
563,109,11,2067.89,4,3,4,11,Loyal
564,68,11,1287.63,4,3,3,10,Loyal
565,657,4,574.58,1,1,1,3,Hibernating
566,429,10,1182.96,2,3,2,7,Regulars
567,5,13,1202.6299999999999,5,4,2,11,Loyal
568,804,5,1025.18,1,1,2,4,Hibernating
569,0,10,1754.1000000000001,5,3,4,12,Loyal
570,116,10,754.12,4,3,1,8,Loyal
571,123,8,1998.48,4,2,4,10,Big Spenders
572,1017,9,1310.67,1,2,3,6,Regulars
573,526,12,2141.05,1,4,4,9,At Risk
574,46,11,1551.74,5,3,3,11,Loyal
575,542,14,2856.71,1,5,5,11,At Risk
576,156,11,3945.2899999999995,3,3,5,11,Big Spenders
577,16,10,1383.99,5,3,3,11,Loyal
578,1531,5,812.72,1,1,1,3,Hibernating
579,34,9,580.39,5,2,1,8,Regulars
580,10,17,3777.7999999999997,5,5,5,15,Champions
581,250,10,1816.66,2,3,4,9,Regulars
582,53,7,899.71,5,1,2,8,Regulars
583,456,11,4181.76,2,3,5,10,Regulars
584,171,11,1651.66,3,3,3,9,Regulars
585,54,9,767.24,5,2,1,8,Regulars
586,241,10,1405.73,3,3,3,9,Regulars
587,307,11,2755.69,2,3,5,10,Regulars
588,242,6,671.41,3,1,1,5,Regulars
589,48,13,1631.93,5,4,3,12,Loyal
590,294,10,3022.59,2,3,5,10,Regulars
591,689,8,865.3199999999999,1,2,2,5,Hibernating
592,456,12,2672.13,2,4,5,11,At Risk
593,552,5,1251.87,1,1,3,5,Regulars
594,39,13,1008.02,5,4,2,11,Loyal
595,143,13,5372.69,4,4,5,13,Champions
596,115,9,785.1,4,2,1,7,Regulars
597,99,12,2675.0299999999997,4,4,5,13,Champions
598,344,10,900.98,2,3,2,7,Regulars
599,194,12,2076.8399999999997,3,4,4,11,Big Spenders
600,214,10,2628.38,3,3,5,11,Big Spenders
601,52,10,2076.26,5,3,4,12,Loyal
602,144,11,1567.81,4,3,3,10,Loyal
603,719,10,2694.5699999999997,1,3,5,9,Regulars
604,189,8,2837.23,3,2,5,10,Big Spenders
605,169,8,818.78,3,2,1,6,Regulars
606,447,8,2134.28,2,2,4,8,Regulars
607,274,12,1728.4,2,4,4,10,At Risk
608,38,14,4030.5499999999997,5,5,5,15,Champions
609,127,11,2497.12,4,3,4,11,Loyal
610,322,6,2266.39,2,1,4,7,Regulars
611,1073,9,1050.26,1,2,2,5,Hibernating
612,147,8,748.71,4,2,1,7,Regulars
613,283,9,476.78,2,2,1,5,Hibernating
614,135,9,5068.320000000001,4,2,5,11,Big Spenders
615,1051,5,511.57000000000005,1,1,1,3,Hibernating
616,210,11,1311.54,3,3,3,9,Regulars
617,305,17,9691.960000000001,2,5,5,12,At Risk
618,436,13,1532.06,2,4,3,9,At Risk
619,52,8,754.73,5,2,1,8,Regulars
620,247,8,577.84,3,2,1,6,Regulars
621,1028,6,540.63,1,1,1,3,Hibernating
622,399,8,1053.1100000000001,2,2,2,6,Hibernating
623,444,12,1836.59,2,4,4,10,At Risk
624,314,8,2549.24,2,2,4,8,Regulars
625,513,7,2756.9700000000003,1,1,5,7,Regulars
626,44,14,3282.58,5,5,5,15,Champions
627,640,11,930.22,1,3,2,6,Regulars
628,441,14,1611.1,2,5,3,10,At Risk
629,250,9,563.9000000000001,2,2,1,5,Hibernating
630,70,14,1797.09,4,5,4,13,Champions
631,529,10,2701.32,1,3,5,9,Regulars
632,163,11,2704.0,3,3,5,11,Big Spenders
633,96,12,2235.19,4,4,4,12,Champions
634,6,10,1599.96,5,3,3,11,Loyal
635,153,11,1418.36,3,3,3,9,Regulars
636,591,14,2391.09,1,5,4,10,At Risk
637,193,12,1070.2,3,4,2,9,Regulars
638,120,8,1927.1200000000001,4,2,4,10,Big Spenders
639,126,11,1251.46,4,3,3,10,Loyal
640,50,21,3812.73,5,5,5,15,Champions
641,194,15,3313.8,3,5,5,13,Big Spenders
642,95,13,1816.8799999999999,4,4,4,12,Champions
643,127,4,335.09000000000003,4,1,1,6,Regulars
644,549,3,362.53999999999996,1,1,1,3,Hibernating
645,133,16,1852.7800000000002,4,5,4,13,Champions
646,122,12,1523.58,4,4,3,11,Loyal
647,444,8,909.8199999999999,2,2,2,6,Hibernating
648,127,15,2845.39,4,5,5,14,Champions
649,331,14,2187.46,2,5,4,11,At Risk
650,1018,5,2023.8799999999999,1,1,4,6,Regulars
651,590,16,2393.92,1,5,4,10,At Risk
652,145,15,3318.55,4,5,5,14,Champions
653,0,9,2185.13,5,2,4,11,Big Spenders
654,142,5,592.8,4,1,1,6,Regulars
655,124,10,2161.63,4,3,4,11,Loyal
656,748,11,750.29,1,3,1,5,Regulars
657,125,7,1117.91,4,1,2,7,Regulars
658,122,5,590.6800000000001,4,1,1,6,Regulars
659,895,4,1349.3799999999999,1,1,3,5,Regulars
660,538,9,782.9100000000001,1,2,1,4,Hibernating
661,19,7,596.6800000000001,5,1,1,7,Regulars
662,77,10,963.02,4,3,2,9,Loyal
663,285,10,924.8199999999999,2,3,2,7,Regulars
664,48,12,3487.13,5,4,5,14,Champions
665,135,17,1973.85,4,5,4,13,Champions
666,166,10,900.9,3,3,2,8,Regulars
667,316,10,1144.97,2,3,2,7,Regulars
668,205,9,2950.84,3,2,5,10,Big Spenders
669,208,15,2411.19,3,5,4,12,Big Spenders
670,486,7,876.37,1,1,2,4,Hibernating
671,51,10,1384.35,5,3,3,11,Loyal
672,41,11,895.92,5,3,2,10,Loyal
673,360,13,3107.6899999999996,2,4,5,11,At Risk
674,553,6,806.96,1,1,1,3,Hibernating
675,215,12,953.98,3,4,2,9,Regulars
676,812,10,1671.01,1,3,3,7,Regulars
677,468,7,935.25,1,1,2,4,Hibernating
678,506,12,914.24,1,4,2,7,At Risk
679,253,10,1207.6,2,3,2,7,Regulars
680,42,11,1314.39,5,3,3,11,Loyal
681,54,9,1579.69,5,2,3,10,Regulars
682,129,9,509.46,4,2,1,7,Regulars
683,574,12,1664.02,1,4,3,8,At Risk
684,19,8,1050.4,5,2,2,9,Regulars
685,124,14,1829.53,4,5,4,13,Champions
686,24,7,3143.7,5,1,5,11,Big Spenders
687,556,11,885.16,1,3,2,6,Regulars
688,684,13,1798.95,1,4,4,9,At Risk
689,496,9,2235.0,1,2,4,7,Regulars
690,164,11,1236.2800000000002,3,3,2,8,Regulars
691,1015,11,1044.93,1,3,2,6,Regulars
692,116,15,1388.55,4,5,3,12,Loyal
693,107,12,774.3699999999999,4,4,1,9,Loyal
694,58,10,1338.1,5,3,3,11,Loyal
695,127,11,603.1999999999999,4,3,1,8,Loyal
696,283,10,758.76,2,3,1,6,Regulars
697,160,5,298.91999999999996,3,1,1,5,Regulars
698,111,14,1829.29,4,5,4,13,Champions
699,78,13,1758.3899999999999,4,4,4,12,Champions
700,192,8,873.13,3,2,2,7,Regulars
701,94,18,3887.92,4,5,5,14,Champions
702,235,6,1429.75,3,1,3,7,Regulars
703,1759,7,2700.28,1,1,5,7,Regulars
704,167,8,1673.08,3,2,3,8,Regulars
705,97,14,3218.69,4,5,5,14,Champions
706,485,5,1293.74,1,1,3,5,Regulars
707,849,8,1927.96,1,2,4,7,Regulars
708,345,7,2674.61,2,1,5,8,Regulars
709,440,6,395.52,2,1,1,4,Hibernating
710,9,12,2476.4300000000003,5,4,4,13,Champions
711,180,20,3718.3,3,5,5,13,Big Spenders
712,225,12,1342.05,3,4,3,10,Regulars
713,146,11,1380.78,4,3,3,10,Loyal
714,59,7,636.8299999999999,5,1,1,7,Regulars
715,287,11,2381.92,2,3,4,9,Regulars
716,601,12,2025.08,1,4,4,9,At Risk
717,581,12,1411.55,1,4,3,8,At Risk
718,54,8,769.91,5,2,1,8,Regulars
719,146,12,1750.36,4,4,4,12,Champions
720,104,13,1600.6100000000001,4,4,3,11,Loyal
721,108,11,2751.95,4,3,5,12,Loyal
722,333,8,974.3000000000001,2,2,2,6,Hibernating
723,539,13,1431.0,1,4,3,8,At Risk
724,253,9,3515.74,2,2,5,9,Regulars
725,33,5,807.51,5,1,1,7,Regulars
726,513,7,2753.03,1,1,5,7,Regulars
727,155,15,1418.28,3,5,3,11,Regulars
728,212,12,2237.63,3,4,4,11,Big Spenders
729,232,11,1441.1899999999998,3,3,3,9,Regulars
730,12,16,2147.54,5,5,4,14,Champions
731,355,14,2014.2,2,5,4,11,At Risk
732,191,16,2470.46,3,5,4,12,Big Spenders
733,681,5,1650.45,1,1,3,5,Regulars
734,101,11,2376.16,4,3,4,11,Loyal
735,229,12,1117.6599999999999,3,4,2,9,Regulars
736,93,13,1711.07,4,4,3,11,Loyal
737,101,8,2972.1400000000003,4,2,5,11,Big Spenders
738,744,6,535.51,1,1,1,3,Hibernating
739,71,13,1206.08,4,4,2,10,Loyal
740,191,14,4161.030000000001,3,5,5,13,Big Spenders
741,120,13,6199.31,4,4,5,13,Champions
742,12,10,2187.03,5,3,4,12,Loyal
743,219,10,2994.69,3,3,5,11,Big Spenders
744,205,8,975.6199999999999,3,2,2,7,Regulars
745,547,9,678.61,1,2,1,4,Hibernating
746,23,11,4895.35,5,3,5,13,Loyal
747,38,16,2433.21,5,5,4,14,Champions
748,111,14,3313.7599999999998,4,5,5,14,Champions
749,272,6,1113.81,2,1,2,5,Hibernating
750,959,14,4637.92,1,5,5,11,At Risk
751,331,7,674.14,2,1,1,4,Hibernating
752,213,11,738.7,3,3,1,7,Regulars
753,312,8,731.49,2,2,1,5,Hibernating
754,72,10,787.63,4,3,1,8,Loyal
755,611,11,3657.3199999999997,1,3,5,9,Regulars
756,57,8,1518.9,5,2,3,10,Regulars
757,293,15,2967.3,2,5,5,12,At Risk
758,237,7,859.98,3,1,2,6,Regulars
759,96,8,408.16,4,2,1,7,Regulars
760,117,12,3947.53,4,4,5,13,Champions
761,335,11,870.84,2,3,2,7,Regulars
762,101,15,5417.95,4,5,5,14,Champions
763,40,13,2304.17,5,4,4,13,Champions
764,446,8,1632.2,2,2,3,7,Regulars
765,108,6,808.44,4,1,1,6,Regulars
766,72,11,1540.31,4,3,3,10,Loyal
767,701,5,265.04,1,1,1,3,Hibernating
768,932,7,924.9,1,1,2,4,Hibernating
769,185,14,3675.65,3,5,5,13,Big Spenders
770,580,11,2485.98,1,3,4,8,Regulars
771,52,6,333.56,5,1,1,7,Regulars
772,202,12,2761.41,3,4,5,12,Big Spenders
773,465,7,744.08,1,1,1,3,Hibernating
774,119,10,579.47,4,3,1,8,Loyal
775,48,10,1330.76,5,3,3,11,Loyal
776,587,11,550.09,1,3,1,5,Regulars
777,144,9,1793.37,4,2,4,10,Big Spenders
778,317,12,4300.929999999999,2,4,5,11,At Risk
779,430,14,2866.41,2,5,5,12,At Risk
780,806,9,2150.31,1,2,4,7,Regulars
781,352,10,744.6700000000001,2,3,1,6,Regulars
782,161,11,1401.54,3,3,3,9,Regulars
783,21,12,2408.9900000000002,5,4,4,13,Champions
784,244,8,550.0,3,2,1,6,Regulars
785,43,8,1048.18,5,2,2,9,Regulars
786,774,10,2182.31,1,3,4,8,Regulars
787,52,10,1495.72,5,3,3,11,Loyal
788,391,10,920.1400000000001,2,3,2,7,Regulars
789,8,14,978.9,5,5,2,12,Loyal
790,6,14,1661.19,5,5,3,13,Loyal
791,15,13,1085.83,5,4,2,11,Loyal
792,372,6,583.71,2,1,1,4,Hibernating
793,297,13,1685.11,2,4,3,9,At Risk
794,184,9,839.3299999999999,3,2,1,6,Regulars
795,184,13,4280.280000000001,3,4,5,12,Big Spenders
796,12,14,1198.61,5,5,2,12,Loyal
797,873,5,1605.52,1,1,3,5,Regulars
798,232,8,674.71,3,2,1,6,Regulars
799,343,4,578.11,2,1,1,4,Hibernating
800,7,11,1288.54,5,3,3,11,Loyal
801,411,8,619.01,2,2,1,5,Hibernating
802,132,12,1444.38,4,4,3,11,Loyal
803,231,7,396.97,3,1,1,5,Regulars
804,6,8,955.29,5,2,2,9,Regulars
805,207,12,4444.15,3,4,5,12,Big Spenders
806,326,10,2613.42,2,3,5,10,Regulars
807,43,9,701.25,5,2,1,8,Regulars
808,305,5,1601.87,2,1,3,6,Regulars
809,57,9,680.47,5,2,1,8,Regulars
810,222,7,1468.36,3,1,3,7,Regulars
811,103,15,3355.39,4,5,5,14,Champions
812,65,22,11764.289999999999,5,5,5,15,Champions
813,202,9,792.9200000000001,3,2,1,6,Regulars
814,237,8,729.7,3,2,1,6,Regulars
815,128,13,2777.09,4,4,5,13,Champions
816,25,6,632.64,5,1,1,7,Regulars
817,53,9,3724.1600000000003,5,2,5,12,Big Spenders
818,474,13,1500.43,1,4,3,8,At Risk
819,343,12,1147.45,2,4,2,8,At Risk
820,213,10,2732.07,3,3,5,11,Big Spenders
821,333,10,766.94,2,3,1,6,Regulars
822,100,14,1932.31,4,5,4,13,Champions
823,567,6,537.47,1,1,1,3,Hibernating
824,45,8,1049.23,5,2,2,9,Regulars
825,30,15,857.73,5,5,2,12,Loyal
826,3,16,3803.97,5,5,5,15,Champions
827,299,7,1759.84,2,1,4,7,Regulars
828,9,12,3124.81,5,4,5,14,Champions
829,50,12,3805.59,5,4,5,14,Champions
830,435,6,794.22,2,1,1,4,Hibernating
831,164,11,1120.44,3,3,2,8,Regulars
832,318,9,3547.92,2,2,5,9,Regulars
833,140,8,1824.16,4,2,4,10,Big Spenders
834,103,8,1199.3400000000001,4,2,2,8,Regulars
835,389,12,2669.76,2,4,5,11,At Risk
836,142,14,2134.26,4,5,4,13,Champions
837,415,8,1875.68,2,2,4,8,Regulars
838,1548,5,437.16,1,1,1,3,Hibernating
839,68,13,3028.78,4,4,5,13,Champions
840,91,14,4101.8,4,5,5,14,Champions
841,275,14,5040.85,2,5,5,12,At Risk
842,93,13,1187.06,4,4,2,10,Loyal
843,160,6,1862.1399999999999,3,1,4,8,Big Spenders
844,13,11,922.65,5,3,2,10,Loyal
845,16,11,2756.85,5,3,5,13,Loyal
846,733,9,740.0,1,2,1,4,Hibernating
847,31,11,2264.4,5,3,4,12,Loyal
848,17,18,2145.36,5,5,4,14,Champions
849,19,12,2135.41,5,4,4,13,Champions
850,156,9,1258.99,3,2,3,8,Regulars
851,271,7,835.37,2,1,1,4,Hibernating
852,733,5,1298.34,1,1,3,5,Regulars
853,94,10,2053.55,4,3,4,11,Loyal
854,22,15,4711.09,5,5,5,15,Champions
855,60,16,2701.5600000000004,5,5,5,15,Champions
856,198,13,1651.27,3,4,3,10,Regulars
857,1245,4,799.29,1,1,1,3,Hibernating
858,973,5,583.5,1,1,1,3,Hibernating
859,174,16,2800.6400000000003,3,5,5,13,Big Spenders
860,211,15,3179.21,3,5,5,13,Big Spenders
861,68,14,3107.87,4,5,5,14,Champions
862,132,13,1723.57,4,4,3,11,Loyal
863,570,12,4029.04,1,4,5,10,At Risk
864,1186,5,992.2199999999999,1,1,2,4,Hibernating
865,412,5,461.13,2,1,1,4,Hibernating
866,263,7,982.05,2,1,2,5,Hibernating
867,671,13,2893.71,1,4,5,10,At Risk
868,202,15,1871.45,3,5,4,12,Big Spenders
869,34,10,2285.67,5,3,4,12,Loyal
870,595,8,291.72,1,2,1,4,Hibernating
871,412,7,1071.1399999999999,2,1,2,5,Hibernating
872,718,12,872.92,1,4,2,7,At Risk
873,355,11,1256.7,2,3,3,8,Regulars
874,684,7,802.41,1,1,1,3,Hibernating
875,159,18,3516.05,3,5,5,13,Big Spenders
876,99,13,1806.87,4,4,4,12,Champions
877,346,11,2333.7400000000002,2,3,4,9,Regulars
878,15,10,1666.01,5,3,3,11,Loyal
879,127,11,2637.09,4,3,5,12,Loyal
880,180,12,1454.71,3,4,3,10,Regulars
881,231,11,910.75,3,3,2,8,Regulars
882,172,12,2165.89,3,4,4,11,Big Spenders
883,70,12,2662.21,4,4,5,13,Champions
884,518,15,3318.73,1,5,5,11,At Risk
885,368,4,597.43,2,1,1,4,Hibernating
886,278,8,934.81,2,2,2,6,Hibernating
887,692,8,891.64,1,2,2,5,Hibernating
888,203,8,420.83,3,2,1,6,Regulars
889,402,15,6347.75,2,5,5,12,At Risk
890,48,17,4216.76,5,5,5,15,Champions
891,375,12,3550.41,2,4,5,11,At Risk
892,411,13,1810.89,2,4,4,10,At Risk
893,395,7,457.02,2,1,1,4,Hibernating
894,858,8,1103.91,1,2,2,5,Hibernating
895,455,12,2642.54,2,4,5,11,At Risk
896,531,8,955.05,1,2,2,5,Hibernating
897,280,9,779.03,2,2,1,5,Hibernating
898,92,11,2744.9100000000003,4,3,5,12,Loyal
899,180,13,2538.15,3,4,4,11,Big Spenders
900,356,6,688.79,2,1,1,4,Hibernating
901,160,11,2011.42,3,3,4,10,Big Spenders
902,372,8,1154.56,2,2,2,6,Hibernating
903,20,7,876.22,5,1,2,8,Regulars
904,49,10,1428.9900000000002,5,3,3,11,Loyal
905,464,13,1316.54,1,4,3,8,At Risk
906,558,8,935.46,1,2,2,5,Hibernating
907,523,10,1425.58,1,3,3,7,Regulars
908,546,14,1603.3500000000001,1,5,3,9,At Risk
909,333,10,635.19,2,3,1,6,Regulars
910,111,9,2738.46,4,2,5,11,Big Spenders
911,70,8,403.37,4,2,1,7,Regulars
912,188,13,1489.43,3,4,3,10,Regulars
913,335,5,622.67,2,1,1,4,Hibernating
914,99,14,1685.8100000000002,4,5,3,12,Loyal
915,43,7,647.51,5,1,1,7,Regulars
916,409,5,451.42,2,1,1,4,Hibernating
917,69,14,1307.44,4,5,3,12,Loyal
918,75,14,1644.11,4,5,3,12,Loyal
919,27,10,3817.87,5,3,5,13,Loyal
920,221,10,1041.89,3,3,2,8,Regulars
921,282,7,1450.35,2,1,3,6,Regulars
922,471,14,1462.99,1,5,3,9,At Risk
923,45,9,990.15,5,2,2,9,Regulars
924,23,16,2604.1099999999997,5,5,5,15,Champions
925,8,9,503.97,5,2,1,8,Regulars
926,382,12,1189.19,2,4,2,8,At Risk
927,22,10,644.8,5,3,1,9,Loyal
928,225,11,745.0,3,3,1,7,Regulars
929,52,17,1420.8,5,5,3,13,Loyal
930,66,14,1362.5700000000002,4,5,3,12,Loyal
931,702,8,1936.88,1,2,4,7,Regulars
932,172,9,1130.44,3,2,2,7,Regulars
933,164,7,2330.22,3,1,4,8,Big Spenders
934,122,15,1431.06,4,5,3,12,Loyal
935,191,7,653.88,3,1,1,5,Regulars
936,610,12,773.0899999999999,1,4,1,6,At Risk
937,246,8,1123.82,3,2,2,7,Regulars
938,108,13,607.4,4,4,1,9,Loyal
939,1188,6,756.5,1,1,1,3,Hibernating
940,140,10,765.08,4,3,1,8,Loyal
941,189,11,2979.9300000000003,3,3,5,11,Big Spenders
942,250,4,526.53,2,1,1,4,Hibernating
943,73,12,2555.4900000000002,4,4,4,12,Champions
944,581,10,2294.1400000000003,1,3,4,8,Regulars
945,236,8,514.95,3,2,1,6,Regulars
946,82,9,1645.31,4,2,3,9,Regulars
947,361,11,1422.1100000000001,2,3,3,8,Regulars
948,392,10,1091.8600000000001,2,3,2,7,Regulars
949,163,9,2509.4,3,2,4,9,Big Spenders
950,288,13,3437.08,2,4,5,11,At Risk
951,64,10,802.6,5,3,1,9,Loyal
952,11,9,2339.05,5,2,4,11,Big Spenders
953,165,9,2725.59,3,2,5,10,Big Spenders
954,126,9,1908.48,4,2,4,10,Big Spenders
955,612,10,4586.59,1,3,5,9,Regulars
956,525,8,551.7,1,2,1,4,Hibernating
957,584,9,685.8199999999999,1,2,1,4,Hibernating
958,657,10,729.51,1,3,1,5,Regulars
959,499,7,541.56,1,1,1,3,Hibernating
960,173,10,1083.51,3,3,2,8,Regulars
961,119,10,1513.78,4,3,3,10,Loyal
962,41,15,2110.2,5,5,4,14,Champions
963,26,13,2108.26,5,4,4,13,Champions
964,90,6,1710.39,4,1,3,8,Regulars
965,81,7,609.26,4,1,1,6,Regulars
966,131,13,1495.61,4,4,3,11,Loyal
967,110,10,1409.95,4,3,3,10,Loyal
968,166,15,2822.29,3,5,5,13,Big Spenders
969,98,13,1577.65,4,4,3,11,Loyal
970,246,5,1071.42,3,1,2,6,Regulars
971,165,8,1494.7399999999998,3,2,3,8,Regulars
972,72,12,2638.51,4,4,5,13,Champions
973,468,7,2859.28,1,1,5,7,Regulars
974,194,9,1138.3200000000002,3,2,2,7,Regulars
975,125,9,2946.91,4,2,5,11,Big Spenders
976,72,14,1267.35,4,5,3,12,Loyal
977,430,11,1005.28,2,3,2,7,Regulars
978,15,12,6600.67,5,4,5,14,Champions
979,259,6,435.83,2,1,1,4,Hibernating
980,392,9,1829.46,2,2,4,8,Regulars
981,139,11,2363.29,4,3,4,11,Loyal
982,29,8,713.35,5,2,1,8,Regulars
983,213,14,1212.56,3,5,2,10,Regulars
984,144,10,1140.4199999999998,4,3,2,9,Loyal
985,131,10,1346.43,4,3,3,10,Loyal
986,166,13,3930.3,3,4,5,12,Big Spenders
987,82,9,1584.46,4,2,3,9,Regulars
988,186,8,985.39,3,2,2,7,Regulars
989,258,7,1013.57,2,1,2,5,Hibernating
990,532,8,2197.67,1,2,4,7,Regulars
991,452,5,375.75,2,1,1,4,Hibernating
992,1,10,1212.0500000000002,5,3,2,10,Loyal
993,7,8,583.75,5,2,1,8,Regulars
994,705,9,581.36,1,2,1,4,Hibernating
995,10,14,1147.64,5,5,2,12,Loyal
996,236,11,1690.63,3,3,3,9,Regulars
997,794,6,722.56,1,1,1,3,Hibernating
998,408,6,886.16,2,1,2,5,Hibernating
999,784,10,1471.8500000000001,1,3,3,7,Regulars
1000,97,8,899.54,4,2,2,8,Regulars
1001,561,8,936.16,1,2,2,5,Hibernating
1002,35,4,1420.24,5,1,3,9,Regulars
1003,792,8,3876.39,1,2,5,8,Regulars
1004,367,7,447.71,2,1,1,4,Hibernating
1005,41,11,736.6800000000001,5,3,1,9,Loyal
1006,128,12,1739.4099999999999,4,4,4,12,Champions
1007,289,13,4013.8900000000003,2,4,5,11,At Risk
1008,903,7,373.8,1,1,1,3,Hibernating
1009,167,15,1797.4199999999998,3,5,4,12,Big Spenders
1010,52,8,1013.5899999999999,5,2,2,9,Regulars
1011,125,8,984.01,4,2,2,8,Regulars
1012,156,13,1998.27,3,4,4,11,Big Spenders
1013,192,9,1502.4099999999999,3,2,3,8,Regulars
1014,534,7,452.42,1,1,1,3,Hibernating
1015,278,10,1194.3899999999999,2,3,2,7,Regulars
1016,304,7,2661.9600000000005,2,1,5,8,Regulars
1017,1026,7,843.93,1,1,1,3,Hibernating
1018,776,7,898.93,1,1,2,4,Hibernating
1019,1244,12,820.38,1,4,1,6,At Risk
1020,18,11,2058.21,5,3,4,12,Loyal
1021,224,7,763.45,3,1,1,5,Regulars
1022,110,10,1408.2500000000002,4,3,3,10,Loyal
1023,144,5,1057.76,4,1,2,7,Regulars
1024,215,7,1586.9199999999998,3,1,3,7,Regulars
1025,333,13,3332.36,2,4,5,11,At Risk
1026,36,14,2044.67,5,5,4,14,Champions
1027,99,10,3129.7799999999997,4,3,5,12,Loyal
1028,69,9,1683.8899999999999,4,2,3,9,Regulars
1029,194,13,1385.94,3,4,3,10,Regulars
1030,83,7,825.39,4,1,1,6,Regulars
1031,55,10,1384.01,5,3,3,11,Loyal
1032,823,12,2983.21,1,4,5,10,At Risk
1033,96,13,1967.1200000000001,4,4,4,12,Champions
1034,48,6,498.5,5,1,1,7,Regulars
1035,740,9,503.2,1,2,1,4,Hibernating
1036,6,11,1313.07,5,3,3,11,Loyal
1037,123,13,1319.76,4,4,3,11,Loyal
1038,113,10,1482.92,4,3,3,10,Loyal
1039,110,9,1099.63,4,2,2,8,Regulars
1040,376,10,1218.63,2,3,2,7,Regulars
1041,1109,5,363.81,1,1,1,3,Hibernating
1042,148,12,813.22,3,4,1,8,Regulars
1043,709,14,1856.82,1,5,4,10,At Risk
1044,699,11,749.6,1,3,1,5,Regulars
1045,63,8,2973.89,5,2,5,12,Big Spenders
1046,49,12,1066.92,5,4,2,11,Loyal
1047,293,9,1011.36,2,2,2,6,Hibernating
1048,113,11,1138.58,4,3,2,9,Loyal
1049,407,7,567.56,2,1,1,4,Hibernating
1050,921,11,834.35,1,3,1,5,Regulars
1051,210,10,2901.7299999999996,3,3,5,11,Big Spenders
1052,56,14,2911.86,5,5,5,15,Champions
1053,56,13,871.88,5,4,2,11,Loyal
1054,30,3,454.74000000000007,5,1,1,7,Regulars
1055,186,11,2696.1600000000003,3,3,5,11,Big Spenders
1056,43,8,440.03,5,2,1,8,Regulars
1057,103,17,4834.12,4,5,5,14,Champions
1058,338,7,1118.27,2,1,2,5,Hibernating
1059,438,8,799.4499999999999,2,2,1,5,Hibernating
1060,124,9,678.6,4,2,1,7,Regulars
1061,701,8,507.43,1,2,1,4,Hibernating
1062,119,13,860.73,4,4,2,10,Loyal
1063,43,10,1758.99,5,3,4,12,Loyal
1064,385,9,1227.93,2,2,2,6,Hibernating
1065,207,10,1766.73,3,3,4,10,Big Spenders
1066,68,11,1567.62,4,3,3,10,Loyal
1067,408,9,1771.3000000000002,2,2,4,8,Regulars
1068,482,13,1995.55,1,4,4,9,At Risk
1069,254,6,834.29,2,1,1,4,Hibernating
1070,603,9,1184.98,1,2,2,5,Hibernating
1071,152,13,3459.98,3,4,5,12,Big Spenders
1072,88,6,335.45,4,1,1,6,Regulars
1073,257,10,1086.8899999999999,2,3,2,7,Regulars
1074,173,9,1820.2900000000002,3,2,4,9,Big Spenders
1075,309,6,1870.09,2,1,4,7,Regulars
1076,478,8,1184.69,1,2,2,5,Hibernating
1077,178,5,789.8400000000001,3,1,1,5,Regulars
1078,470,6,531.65,1,1,1,3,Hibernating
1079,107,13,2004.27,4,4,4,12,Champions
1080,45,11,2098.54,5,3,4,12,Loyal
1081,39,9,2412.1,5,2,4,11,Big Spenders
1082,294,12,1946.06,2,4,4,10,At Risk
1083,175,6,2988.1,3,1,5,9,Big Spenders
1084,126,8,931.39,4,2,2,8,Regulars
1085,502,6,592.76,1,1,1,3,Hibernating
1086,1114,8,649.37,1,2,1,4,Hibernating
1087,32,7,1066.1,5,1,2,8,Regulars
1088,190,12,1109.97,3,4,2,9,Regulars
1089,520,10,1243.98,1,3,3,7,Regulars
1090,455,11,1964.44,2,3,4,9,Regulars
1091,174,17,1609.99,3,5,3,11,Regulars
1092,267,9,785.87,2,2,1,5,Hibernating
1093,120,18,2359.1,4,5,4,13,Champions
1094,461,13,1844.8,1,4,4,9,At Risk
1095,92,9,2862.3799999999997,4,2,5,11,Big Spenders
1096,61,12,4560.650000000001,5,4,5,14,Champions
1097,7,13,1980.46,5,4,4,13,Champions
1098,284,16,1350.12,2,5,3,10,At Risk
1099,475,11,1890.83,1,3,4,8,Regulars
1100,311,8,4040.1099999999997,2,2,5,9,Regulars
1101,313,8,764.64,2,2,1,5,Hibernating
1102,288,10,599.8,2,3,1,6,Regulars
1103,233,14,2442.27,3,5,4,12,Big Spenders
1104,305,18,5103.17,2,5,5,12,At Risk
1105,60,9,2588.09,5,2,5,12,Big Spenders
1106,82,7,684.91,4,1,1,6,Regulars
1107,80,7,1327.25,4,1,3,8,Regulars
1108,15,8,1372.44,5,2,3,10,Regulars
1109,20,11,3114.44,5,3,5,13,Loyal
1110,169,10,889.64,3,3,2,8,Regulars
1111,228,9,1170.1,3,2,2,7,Regulars
1112,287,10,1925.4599999999998,2,3,4,9,Regulars
1113,52,11,2145.87,5,3,4,12,Loyal
1114,50,11,735.8499999999999,5,3,1,9,Loyal
1115,36,6,1363.66,5,1,3,9,Regulars
1116,31,7,665.12,5,1,1,7,Regulars
1117,284,9,1292.98,2,2,3,7,Regulars
1118,88,14,973.99,4,5,2,11,Loyal
1119,44,9,3028.2400000000002,5,2,5,12,Big Spenders
1120,227,8,3933.33,3,2,5,10,Big Spenders
1121,31,12,914.42,5,4,2,11,Loyal
1122,621,16,2630.84,1,5,5,11,At Risk
1123,346,11,3356.25,2,3,5,10,Regulars
1124,592,5,733.96,1,1,1,3,Hibernating
1125,1735,6,482.1,1,1,1,3,Hibernating
1126,15,15,5078.82,5,5,5,15,Champions
1127,598,10,1266.58,1,3,3,7,Regulars
1128,1074,11,1600.63,1,3,3,7,Regulars
1129,212,12,2990.2999999999997,3,4,5,12,Big Spenders
1130,58,11,3425.92,5,3,5,13,Loyal
1131,416,14,2010.54,2,5,4,11,At Risk
1132,75,12,1492.77,4,4,3,11,Loyal
1133,899,10,740.31,1,3,1,5,Regulars
1134,150,8,636.69,3,2,1,6,Regulars
1135,527,11,1211.44,1,3,2,6,Regulars
1136,161,10,726.6800000000001,3,3,1,7,Regulars
1137,79,12,973.26,4,4,2,10,Loyal
1138,247,10,1002.52,3,3,2,8,Regulars
1139,206,11,1256.3999999999999,3,3,3,9,Regulars
1140,145,14,1053.4,4,5,2,11,Loyal
1141,584,7,1528.35,1,1,3,5,Regulars
1142,193,12,3213.73,3,4,5,12,Big Spenders
1143,198,7,3114.83,3,1,5,9,Big Spenders
1144,117,16,3375.0899999999997,4,5,5,14,Champions
1145,949,6,1872.93,1,1,4,6,Regulars
1146,96,13,2752.7,4,4,5,13,Champions
1147,26,11,2059.9300000000003,5,3,4,12,Loyal
1148,213,8,1534.28,3,2,3,8,Regulars
1149,21,13,2583.4,5,4,5,14,Champions
1150,103,9,934.7,4,2,2,8,Regulars
1151,92,10,1594.0,4,3,3,10,Loyal
1152,58,3,251.07,5,1,1,7,Regulars
1153,155,9,1100.01,3,2,2,7,Regulars
1154,15,11,2846.13,5,3,5,13,Loyal
1155,77,13,3020.23,4,4,5,13,Champions
1156,168,10,618.29,3,3,1,7,Regulars
1157,333,11,1630.91,2,3,3,8,Regulars
1158,33,11,1179.95,5,3,2,10,Loyal
1159,35,7,554.59,5,1,1,7,Regulars
1160,24,13,4972.99,5,4,5,14,Champions
1161,543,8,1632.3200000000002,1,2,3,6,Regulars
1162,184,10,2031.7400000000002,3,3,4,10,Big Spenders
1163,163,11,1334.76,3,3,3,9,Regulars
1164,111,10,2148.35,4,3,4,11,Loyal
1165,46,15,3785.77,5,5,5,15,Champions
1166,106,7,3437.2599999999998,4,1,5,10,Big Spenders
1167,334,2,168.4,2,1,1,4,Hibernating
1168,703,9,1869.01,1,2,4,7,Regulars
1169,6,7,1016.8599999999999,5,1,2,8,Regulars
1170,34,9,379.94,5,2,1,8,Regulars
1171,472,9,672.83,1,2,1,4,Hibernating
1172,245,11,3096.23,3,3,5,11,Big Spenders
1173,216,8,2928.71,3,2,5,10,Big Spenders
1174,116,12,2340.9399999999996,4,4,4,12,Champions
1175,172,8,582.96,3,2,1,6,Regulars
1176,35,7,583.28,5,1,1,7,Regulars
1177,58,9,1274.8,5,2,3,10,Regulars
1178,408,10,1332.98,2,3,3,8,Regulars
1179,21,9,1605.3500000000001,5,2,3,10,Regulars
1180,58,7,457.99,5,1,1,7,Regulars
1181,89,13,2822.7,4,4,5,13,Champions
1182,551,5,524.15,1,1,1,3,Hibernating
1183,28,10,3396.88,5,3,5,13,Loyal
1184,17,15,1396.78,5,5,3,13,Loyal
1185,455,10,1071.05,2,3,2,7,Regulars
1186,474,6,439.26,1,1,1,3,Hibernating
1187,195,11,1158.2,3,3,2,8,Regulars
1188,527,11,1367.47,1,3,3,7,Regulars
1189,275,13,3527.22,2,4,5,11,At Risk
1190,209,8,1057.09,3,2,2,7,Regulars
1191,984,8,2317.74,1,2,4,7,Regulars
1192,409,13,3042.7200000000003,2,4,5,11,At Risk
1193,382,16,1739.86,2,5,4,11,At Risk
1194,211,12,2787.1099999999997,3,4,5,12,Big Spenders
1195,362,12,3691.17,2,4,5,11,At Risk
1196,89,8,1910.26,4,2,4,10,Big Spenders
1197,101,13,2740.87,4,4,5,13,Champions
1198,226,16,1314.35,3,5,3,11,Regulars
1199,170,6,840.44,3,1,1,5,Regulars
1200,133,7,2297.59,4,1,4,9,Big Spenders
1201,15,15,4685.05,5,5,5,15,Champions
1202,187,11,3079.59,3,3,5,11,Big Spenders
1203,118,16,1524.46,4,5,3,12,Loyal
1204,35,12,1792.67,5,4,4,13,Champions
1205,130,10,976.87,4,3,2,9,Loyal
1206,29,15,3532.7299999999996,5,5,5,15,Champions
1207,810,7,3306.63,1,1,5,7,Regulars
1208,625,8,2080.83,1,2,4,7,Regulars
1209,306,9,1650.1100000000001,2,2,3,7,Regulars
1210,635,10,1567.5500000000002,1,3,3,7,Regulars
1211,213,9,965.71,3,2,2,7,Regulars
1212,3,9,1745.6200000000001,5,2,4,11,Big Spenders
1213,10,7,749.64,5,1,1,7,Regulars
1214,54,10,1993.17,5,3,4,12,Loyal
1215,490,13,2672.69,1,4,5,10,At Risk
1216,104,10,555.12,4,3,1,8,Loyal
1217,69,8,1391.53,4,2,3,9,Regulars
1218,90,15,2677.7999999999997,4,5,5,14,Champions
1219,591,10,3231.7200000000003,1,3,5,9,Regulars
1220,146,12,1617.9,4,4,3,11,Loyal
1221,488,8,671.51,1,2,1,4,Hibernating
1222,425,12,1984.8600000000001,2,4,4,10,At Risk
1223,173,6,1995.67,3,1,4,8,Big Spenders
1224,387,11,978.4200000000001,2,3,2,7,Regulars
1225,51,9,1083.19,5,2,2,9,Regulars
1226,63,14,2155.21,5,5,4,14,Champions
1227,565,7,987.1100000000001,1,1,2,4,Hibernating
1228,124,4,1681.12,4,1,3,8,Regulars
1229,485,9,1984.63,1,2,4,7,Regulars
1230,243,11,1687.9,3,3,3,9,Regulars
1231,108,12,873.64,4,4,2,10,Loyal
1232,84,12,1628.14,4,4,3,11,Loyal
1233,262,14,3041.95,2,5,5,12,At Risk
1234,505,14,3382.85,1,5,5,11,At Risk
1235,129,10,3314.0999999999995,4,3,5,12,Loyal
1236,606,10,1045.55,1,3,2,6,Regulars
1237,285,14,1387.52,2,5,3,10,At Risk
1238,617,8,1388.8400000000001,1,2,3,6,Regulars
1239,78,7,462.26,4,1,1,6,Regulars
1240,117,11,1466.82,4,3,3,10,Loyal
1241,174,8,576.19,3,2,1,6,Regulars
1242,118,15,1730.83,4,5,4,13,Champions
1243,272,9,614.33,2,2,1,5,Hibernating
1244,206,10,567.85,3,3,1,7,Regulars
1245,899,8,800.94,1,2,1,4,Hibernating
1246,230,10,1365.32,3,3,3,9,Regulars
1247,11,15,1448.6,5,5,3,13,Loyal
1248,433,8,2265.7799999999997,2,2,4,8,Regulars
1249,171,15,1582.31,3,5,3,11,Regulars
1250,192,7,877.42,3,1,2,6,Regulars
1251,124,9,637.2099999999999,4,2,1,7,Regulars
1252,651,2,423.1700000000001,1,1,1,3,Hibernating
1253,436,20,2549.27,2,5,4,11,At Risk
1254,407,11,3172.3100000000004,2,3,5,10,Regulars
1255,2310,1,40.65,1,1,1,3,Hibernating
1256,300,11,2271.63,2,3,4,9,Regulars
1257,91,15,1588.51,4,5,3,12,Loyal
1258,68,6,2213.64,4,1,4,9,Big Spenders
1259,165,10,3182.09,3,3,5,11,Big Spenders
1260,47,22,3212.86,5,5,5,15,Champions
1261,115,9,2788.68,4,2,5,11,Big Spenders
1262,54,18,2252.9,5,5,4,14,Champions
1263,194,14,2241.23,3,5,4,12,Big Spenders
1264,122,5,1359.8700000000001,4,1,3,8,Regulars
1265,171,16,2773.1,3,5,5,13,Big Spenders
1266,216,12,1314.75,3,4,3,10,Regulars
1267,787,10,1315.55,1,3,3,7,Regulars
1268,230,10,1472.2,3,3,3,9,Regulars
1269,104,8,2896.4199999999996,4,2,5,11,Big Spenders
1270,82,5,549.37,4,1,1,6,Regulars
1271,125,9,2322.58,4,2,4,10,Big Spenders
1272,85,13,690.84,4,4,1,9,Loyal
1273,18,15,4685.08,5,5,5,15,Champions
1274,72,9,2344.7,4,2,4,10,Big Spenders
1275,65,10,1364.68,5,3,3,11,Loyal
1276,742,4,402.49,1,1,1,3,Hibernating
1277,17,16,4136.81,5,5,5,15,Champions
1278,105,7,1154.3600000000001,4,1,2,7,Regulars
1279,1356,10,2693.76,1,3,5,9,Regulars
1280,382,11,2328.36,2,3,4,9,Regulars
1281,361,5,456.38,2,1,1,4,Hibernating
1282,67,12,1854.86,4,4,4,12,Champions
1283,129,10,3512.95,4,3,5,12,Loyal
1284,161,7,846.43,3,1,2,6,Regulars
1285,183,7,377.38,3,1,1,5,Regulars
1286,651,7,858.4300000000001,1,1,2,4,Hibernating
1287,286,7,523.74,2,1,1,4,Hibernating
1288,213,12,4958.99,3,4,5,12,Big Spenders
1289,76,13,3324.37,4,4,5,13,Champions
1290,131,13,2759.0,4,4,5,13,Champions
1291,866,8,1830.5,1,2,4,7,Regulars
1292,116,11,2569.96,4,3,4,11,Loyal
1293,448,14,3740.16,2,5,5,12,At Risk
1294,23,20,2005.83,5,5,4,14,Champions
1295,358,7,1093.7,2,1,2,5,Hibernating
1296,90,12,3038.9700000000003,4,4,5,13,Champions
1297,531,8,2752.62,1,2,5,8,Regulars
1298,183,5,742.51,3,1,1,5,Regulars
1299,55,13,1903.44,5,4,4,13,Champions
1300,259,8,946.46,2,2,2,6,Hibernating
1301,73,8,521.9,4,2,1,7,Regulars
1302,225,7,807.9300000000001,3,1,1,5,Regulars
1303,145,3,701.53,4,1,1,6,Regulars
1304,87,15,3846.56,4,5,5,14,Champions
1305,731,8,474.91,1,2,1,4,Hibernating
1306,145,6,927.64,4,1,2,7,Regulars
1307,22,10,1080.25,5,3,2,10,Loyal
1308,35,7,286.9,5,1,1,7,Regulars
1309,63,8,301.66,5,2,1,8,Regulars
1310,237,8,949.44,3,2,2,7,Regulars
1311,97,12,1915.44,4,4,4,12,Champions
1312,24,9,515.65,5,2,1,8,Regulars
1313,32,10,1170.46,5,3,2,10,Loyal
1314,513,8,2361.42,1,2,4,7,Regulars
1315,60,13,1057.12,5,4,2,11,Loyal
1316,303,14,2531.92,2,5,4,11,At Risk
1317,163,8,1345.32,3,2,3,8,Regulars
1318,85,18,2633.02,4,5,5,14,Champions
1319,197,14,1673.8700000000001,3,5,3,11,Regulars
1320,196,8,609.72,3,2,1,6,Regulars
1321,235,17,1870.3500000000001,3,5,4,12,Big Spenders
1322,458,11,1716.8,2,3,3,8,Regulars
1323,427,9,790.05,2,2,1,5,Hibernating
1324,86,10,1652.15,4,3,3,10,Loyal
1325,184,9,1209.5,3,2,2,7,Regulars
1326,118,14,2059.59,4,5,4,13,Champions
1327,247,10,955.18,3,3,2,8,Regulars
1328,786,5,525.31,1,1,1,3,Hibernating
1329,275,11,1557.4199999999998,2,3,3,8,Regulars
1330,15,7,861.3499999999999,5,1,2,8,Regulars
1331,424,12,1625.92,2,4,3,9,At Risk
1332,129,17,2548.24,4,5,4,13,Champions
1333,44,11,1485.43,5,3,3,11,Loyal
1334,119,7,1834.3799999999999,4,1,4,9,Big Spenders
1335,143,8,700.58,4,2,1,7,Regulars
1336,44,10,1624.98,5,3,3,11,Loyal
1337,124,8,997.72,4,2,2,8,Regulars
1338,171,12,1492.86,3,4,3,10,Regulars
1339,145,8,490.31,4,2,1,7,Regulars
1340,93,13,1635.39,4,4,3,11,Loyal
1341,67,18,3459.02,4,5,5,14,Champions
1342,23,12,1129.98,5,4,2,11,Loyal
1343,549,6,1249.93,1,1,3,5,Regulars
1344,399,16,1719.08,2,5,3,10,At Risk
1345,379,8,925.69,2,2,2,6,Hibernating
1346,515,11,2809.61,1,3,5,9,Regulars
1347,194,15,3518.06,3,5,5,13,Big Spenders
1348,382,12,1167.51,2,4,2,8,At Risk
1349,42,12,819.16,5,4,1,10,Loyal
1350,67,12,3060.33,4,4,5,13,Champions
1351,403,9,1248.07,2,2,3,7,Regulars
1352,180,14,1252.87,3,5,3,11,Regulars
1353,0,13,2968.49,5,4,5,14,Champions
1354,207,10,4851.22,3,3,5,11,Big Spenders
1355,180,11,2470.25,3,3,4,10,Big Spenders
1356,361,16,1856.8600000000001,2,5,4,11,At Risk
1357,49,10,1547.51,5,3,3,11,Loyal
1358,583,13,1604.11,1,4,3,8,At Risk
1359,86,9,577.53,4,2,1,7,Regulars
1360,85,12,1390.28,4,4,3,11,Loyal
1361,754,10,3537.41,1,3,5,9,Regulars
1362,209,7,637.37,3,1,1,5,Regulars
1363,12,9,942.64,5,2,2,9,Regulars
1364,79,17,2459.25,4,5,4,13,Champions
1365,454,10,1522.62,2,3,3,8,Regulars
1366,498,12,3182.25,1,4,5,10,At Risk
1367,457,8,2169.95,2,2,4,8,Regulars
1368,109,11,5025.04,4,3,5,12,Loyal
1369,310,9,1068.71,2,2,2,6,Hibernating
1370,260,13,1549.17,2,4,3,9,At Risk
1371,615,13,3130.56,1,4,5,10,At Risk
1372,1312,6,2156.86,1,1,4,6,Regulars
1373,154,7,749.48,3,1,1,5,Regulars
1374,337,7,547.81,2,1,1,4,Hibernating
1375,260,13,2181.44,2,4,4,10,At Risk
1376,28,14,2119.55,5,5,4,14,Champions
1377,266,11,2222.2000000000003,2,3,4,9,Regulars
1378,504,6,1235.17,1,1,2,4,Hibernating
1379,431,15,1391.26,2,5,3,10,At Risk
1380,48,17,1756.8700000000001,5,5,4,14,Champions
1381,855,8,853.41,1,2,2,5,Hibernating
1382,600,11,2525.4700000000003,1,3,4,8,Regulars
1383,526,8,1690.92,1,2,3,6,Regulars
1384,163,10,2355.16,3,3,4,10,Big Spenders
1385,104,15,2574.73,4,5,5,14,Champions
1386,681,8,5800.76,1,2,5,8,Regulars
1387,99,18,2292.13,4,5,4,13,Champions
1388,154,6,944.45,3,1,2,6,Regulars
1389,617,13,1984.91,1,4,4,9,At Risk
1390,141,13,2376.38,4,4,4,12,Champions
1391,383,10,2967.1299999999997,2,3,5,10,Regulars
1392,368,6,1047.3600000000001,2,1,2,5,Hibernating
1393,36,15,4046.76,5,5,5,15,Champions
1394,587,7,2058.06,1,1,4,6,Regulars
1395,239,9,840.5600000000001,3,2,1,6,Regulars
1396,1,10,734.03,5,3,1,9,Loyal
1397,264,9,2720.81,2,2,5,9,Regulars
1398,302,13,1394.09,2,4,3,9,At Risk
1399,662,8,1134.14,1,2,2,5,Hibernating
1400,320,12,1983.59,2,4,4,10,At Risk
1401,186,8,1567.19,3,2,3,8,Regulars
1402,258,19,2805.44,2,5,5,12,At Risk
1403,154,10,1983.7099999999998,3,3,4,10,Big Spenders
1404,127,10,2195.73,4,3,4,11,Loyal
1405,50,9,1611.69,5,2,3,10,Regulars
1406,277,9,2723.8,2,2,5,9,Regulars
1407,778,8,607.59,1,2,1,4,Hibernating
1408,38,15,1861.63,5,5,4,14,Champions
1409,33,8,1340.29,5,2,3,10,Regulars
1410,481,11,1348.75,1,3,3,7,Regulars
1411,14,7,1008.19,5,1,2,8,Regulars
1412,326,6,2654.17,2,1,5,8,Regulars
1413,45,12,2560.7200000000003,5,4,4,13,Champions
1414,225,14,1390.14,3,5,3,11,Regulars
1415,111,13,1201.43,4,4,2,10,Loyal
1416,145,17,3325.11,4,5,5,14,Champions
1417,208,13,4080.15,3,4,5,12,Big Spenders
1418,126,11,1180.16,4,3,2,9,Loyal
1419,60,13,1151.15,5,4,2,11,Loyal
1420,20,10,1673.5,5,3,3,11,Loyal
1421,144,10,1588.2799999999997,4,3,3,10,Loyal
1422,83,5,817.86,4,1,1,6,Regulars
1423,381,5,864.7800000000001,2,1,2,5,Hibernating
1424,909,6,4049.8500000000004,1,1,5,7,Regulars
1425,127,15,1143.0,4,5,2,11,Loyal
1426,261,8,818.4,2,2,1,5,Hibernating
1427,122,11,854.99,4,3,2,9,Loyal
1428,61,11,2852.4500000000003,5,3,5,13,Loyal
1429,273,11,890.9599999999999,2,3,2,7,Regulars
1430,130,13,2035.1000000000001,4,4,4,12,Champions
1431,207,12,962.8399999999999,3,4,2,9,Regulars
1432,227,7,300.78,3,1,1,5,Regulars
1433,689,8,2764.3,1,2,5,8,Regulars
1434,1,9,662.6,5,2,1,8,Regulars
1435,236,6,757.6,3,1,1,5,Regulars
1436,187,11,2436.19,3,3,4,10,Big Spenders
1437,436,10,1526.0300000000002,2,3,3,8,Regulars
1438,253,12,2646.91,2,4,5,11,At Risk
1439,742,7,418.43000000000006,1,1,1,3,Hibernating
1440,108,10,2137.81,4,3,4,11,Loyal
1441,214,9,1245.6100000000001,3,2,3,8,Regulars
1442,184,8,635.0,3,2,1,6,Regulars
1443,226,14,1868.04,3,5,4,12,Big Spenders
1444,288,12,2544.91,2,4,4,10,At Risk
1445,6,18,1968.02,5,5,4,14,Champions
1446,22,15,1794.63,5,5,4,14,Champions
1447,212,17,2174.64,3,5,4,12,Big Spenders
1448,57,13,884.9100000000001,5,4,2,11,Loyal
1449,496,8,1517.3400000000001,1,2,3,6,Regulars
1450,99,10,735.42,4,3,1,8,Loyal
1451,230,10,3245.81,3,3,5,11,Big Spenders
1452,226,8,1013.08,3,2,2,7,Regulars
1453,563,12,2353.37,1,4,4,9,At Risk
1454,227,6,1369.1,3,1,3,7,Regulars
1455,198,9,1587.66,3,2,3,8,Regulars
1456,239,10,1729.1799999999998,3,3,4,10,Big Spenders
1457,234,8,1129.3899999999999,3,2,2,7,Regulars
1458,111,11,1181.6000000000001,4,3,2,9,Loyal
1459,2,14,4292.08,5,5,5,15,Champions
1460,55,9,2783.83,5,2,5,12,Big Spenders
1461,1266,5,335.71000000000004,1,1,1,3,Hibernating
1462,713,5,327.37,1,1,1,3,Hibernating
1463,98,4,892.1,4,1,2,7,Regulars
1464,160,9,1059.24,3,2,2,7,Regulars
1465,22,7,875.9200000000001,5,1,2,8,Regulars
1466,1083,11,716.49,1,3,1,5,Regulars
1467,53,10,1218.05,5,3,2,10,Loyal
1468,460,12,1816.0,1,4,4,9,At Risk
1469,10,10,2936.4199999999996,5,3,5,13,Loyal
1470,495,9,1053.41,1,2,2,5,Hibernating
1471,135,9,1199.54,4,2,2,8,Regulars
1472,565,10,2169.65,1,3,4,8,Regulars
1473,654,5,1218.4899999999998,1,1,2,4,Hibernating
1474,175,13,1432.46,3,4,3,10,Regulars
1475,214,13,2317.91,3,4,4,11,Big Spenders
1476,83,12,1535.52,4,4,3,11,Loyal
1477,285,9,1355.77,2,2,3,7,Regulars
1478,400,9,2625.58,2,2,5,9,Regulars
1479,794,10,3002.6000000000004,1,3,5,9,Regulars
1480,40,9,2006.0800000000002,5,2,4,11,Big Spenders
1481,79,14,1934.74,4,5,4,13,Champions
1482,26,17,2325.9,5,5,4,14,Champions
1483,99,15,3714.57,4,5,5,14,Champions
1484,373,8,3127.84,2,2,5,9,Regulars
1485,34,11,3384.2999999999997,5,3,5,13,Loyal
1486,167,8,2266.06,3,2,4,9,Big Spenders
1487,103,11,2438.67,4,3,4,11,Loyal
1488,293,6,412.67,2,1,1,4,Hibernating
1489,73,13,3117.5899999999997,4,4,5,13,Champions
1490,60,12,1454.4099999999999,5,4,3,12,Loyal
1491,78,6,1505.2600000000002,4,1,3,8,Regulars
1492,466,9,1285.3400000000001,1,2,3,6,Regulars
1493,197,8,2096.6800000000003,3,2,4,9,Big Spenders
1494,299,8,598.44,2,2,1,5,Hibernating
1495,1020,4,939.2000000000002,1,1,2,4,Hibernating
1496,577,12,1165.24,1,4,2,7,At Risk
1497,129,15,4716.95,4,5,5,14,Champions
1498,502,9,557.83,1,2,1,4,Hibernating
1499,88,7,786.0,4,1,1,6,Regulars
1500,294,12,3357.37,2,4,5,11,At Risk
1501,958,6,1891.1799999999998,1,1,4,6,Regulars
1502,80,6,1325.45,4,1,3,8,Regulars
1503,53,18,3915.86,5,5,5,15,Champions
1504,90,8,1344.01,4,2,3,9,Regulars
1505,540,14,1908.6599999999999,1,5,4,10,At Risk
1506,11,9,1291.43,5,2,3,10,Regulars
1507,585,4,669.94,1,1,1,3,Hibernating
1508,8,12,2918.23,5,4,5,14,Champions
1509,198,11,715.62,3,3,1,7,Regulars
1510,118,16,2949.5699999999997,4,5,5,14,Champions
1511,503,10,1407.58,1,3,3,7,Regulars
1512,38,16,1653.17,5,5,3,13,Loyal
1513,25,10,1085.23,5,3,2,10,Loyal
1514,292,13,993.36,2,4,2,8,At Risk
1515,366,8,598.9,2,2,1,5,Hibernating
1516,147,10,3269.8799999999997,4,3,5,12,Loyal
1517,199,19,3216.67,3,5,5,13,Big Spenders
1518,305,9,1594.65,2,2,3,7,Regulars
1519,49,14,1992.7900000000002,5,5,4,14,Champions
1520,799,8,1890.3300000000002,1,2,4,7,Regulars
1521,297,7,1473.19,2,1,3,6,Regulars
1522,431,11,5987.65,2,3,5,10,Regulars
1523,114,10,1783.1200000000001,4,3,4,11,Loyal
1524,89,15,2253.8199999999997,4,5,4,13,Champions
1525,416,14,1826.44,2,5,4,11,At Risk
1526,367,10,1194.55,2,3,2,7,Regulars
1527,136,12,913.74,4,4,2,10,Loyal
1528,165,9,549.75,3,2,1,6,Regulars
1529,33,11,3999.09,5,3,5,13,Loyal
1530,18,9,1789.67,5,2,4,11,Big Spenders
1531,279,9,810.79,2,2,1,5,Hibernating
1532,44,11,1601.29,5,3,3,11,Loyal
1533,365,13,1491.74,2,4,3,9,At Risk
1534,76,13,2184.1,4,4,4,12,Champions
1535,48,10,809.5,5,3,1,9,Loyal
1536,132,9,1522.91,4,2,3,9,Regulars
1537,325,11,1158.47,2,3,2,7,Regulars
1538,25,12,1283.9,5,4,3,12,Loyal
1539,637,8,675.4,1,2,1,4,Hibernating
1540,377,5,479.16999999999996,2,1,1,4,Hibernating
1541,181,8,1131.79,3,2,2,7,Regulars
1542,1203,7,626.4200000000001,1,1,1,3,Hibernating
1543,13,15,3300.63,5,5,5,15,Champions
1544,517,8,1141.5,1,2,2,5,Hibernating
1545,474,5,862.4799999999999,1,1,2,4,Hibernating
1546,630,5,448.70000000000005,1,1,1,3,Hibernating
1547,185,4,2181.52,3,1,4,8,Big Spenders
1548,104,8,2031.96,4,2,4,10,Big Spenders
1549,1207,8,869.15,1,2,2,5,Hibernating
1550,20,11,2053.06,5,3,4,12,Loyal
1551,135,17,2883.77,4,5,5,14,Champions
1552,355,9,2149.52,2,2,4,8,Regulars
1553,385,4,511.87,2,1,1,4,Hibernating
1554,14,7,663.62,5,1,1,7,Regulars
1555,34,9,690.2600000000001,5,2,1,8,Regulars
1556,322,8,916.41,2,2,2,6,Hibernating
1557,245,10,893.48,3,3,2,8,Regulars
1558,545,10,1064.0900000000001,1,3,2,6,Regulars
1559,10,15,1949.5900000000001,5,5,4,14,Champions
1560,175,6,1978.98,3,1,4,8,Big Spenders
1561,103,9,2887.58,4,2,5,11,Big Spenders
1562,4,12,1837.02,5,4,4,13,Champions
1563,2,14,2399.5,5,5,4,14,Champions
1564,407,7,741.75,2,1,1,4,Hibernating
1565,56,11,642.47,5,3,1,9,Loyal
1566,74,4,750.11,4,1,1,6,Regulars
1567,55,17,4044.9700000000003,5,5,5,15,Champions
1568,626,5,564.85,1,1,1,3,Hibernating
1569,71,9,1337.3,4,2,3,9,Regulars
1570,58,11,2500.1600000000003,5,3,4,12,Loyal
1571,9,11,958.35,5,3,2,10,Loyal
1572,871,8,1451.0,1,2,3,6,Regulars
1573,321,9,2984.8,2,2,5,9,Regulars
1574,71,13,3368.3199999999997,4,4,5,13,Champions
1575,365,11,704.33,2,3,1,6,Regulars
1576,73,8,2011.6200000000001,4,2,4,10,Big Spenders
1577,34,12,1194.38,5,4,2,11,Loyal
1578,154,10,3216.39,3,3,5,11,Big Spenders
1579,235,10,4572.5,3,3,5,11,Big Spenders
1580,11,9,2191.3900000000003,5,2,4,11,Big Spenders
1581,87,9,3124.7400000000002,4,2,5,11,Big Spenders
1582,120,3,745.89,4,1,1,6,Regulars
1583,384,12,3441.4599999999996,2,4,5,11,At Risk
1584,78,10,2189.8,4,3,4,11,Loyal
1585,855,4,255.86,1,1,1,3,Hibernating
1586,245,15,1159.6599999999999,3,5,2,10,Regulars
1587,150,12,2140.39,3,4,4,11,Big Spenders
1588,1137,7,1036.87,1,1,2,4,Hibernating
1589,37,12,3873.82,5,4,5,14,Champions
1590,15,10,2053.5,5,3,4,12,Loyal
1591,7,16,3167.46,5,5,5,15,Champions
1592,211,10,3204.67,3,3,5,11,Big Spenders
1593,171,8,2198.53,3,2,4,9,Big Spenders
1594,564,16,2053.92,1,5,4,10,At Risk
1595,550,6,562.0,1,1,1,3,Hibernating
1596,169,11,1189.31,3,3,2,8,Regulars
1597,291,8,940.03,2,2,2,6,Hibernating
1598,196,6,1281.37,3,1,3,7,Regulars
1599,99,11,2276.43,4,3,4,11,Loyal
1600,393,7,1373.15,2,1,3,6,Regulars
1601,337,19,6261.34,2,5,5,12,At Risk
1602,356,9,1493.99,2,2,3,7,Regulars
1603,128,8,725.03,4,2,1,7,Regulars
1604,196,9,2518.09,3,2,4,9,Big Spenders
1605,99,7,1269.19,4,1,3,8,Regulars
1606,440,14,1599.0800000000002,2,5,3,10,At Risk
1607,687,11,1034.99,1,3,2,6,Regulars
1608,275,11,2074.6600000000003,2,3,4,9,Regulars
1609,95,8,1696.12,4,2,3,9,Regulars
1610,301,8,518.8,2,2,1,5,Hibernating
1611,63,13,1660.7800000000002,5,4,3,12,Loyal
1612,131,7,931.9200000000001,4,1,2,7,Regulars
1613,695,7,1137.41,1,1,2,4,Hibernating
1614,88,4,535.83,4,1,1,6,Regulars
1615,239,15,1560.1299999999999,3,5,3,11,Regulars
1616,723,13,1220.64,1,4,2,7,At Risk
1617,537,5,775.6000000000001,1,1,1,3,Hibernating
1618,567,3,401.58000000000004,1,1,1,3,Hibernating
1619,455,8,3714.4899999999993,2,2,5,9,Regulars
1620,948,8,2779.75,1,2,5,8,Regulars
1621,450,13,930.7,2,4,2,8,At Risk
1622,139,6,285.08,4,1,1,6,Regulars
1623,75,6,454.64,4,1,1,6,Regulars
1624,264,10,1212.1299999999999,2,3,2,7,Regulars
1625,55,11,3134.8399999999997,5,3,5,13,Loyal
1626,701,11,1579.27,1,3,3,7,Regulars
1627,155,10,1671.9,3,3,3,9,Regulars
1628,34,9,1031.99,5,2,2,9,Regulars
1629,10,9,1269.94,5,2,3,10,Regulars
1630,30,12,1045.45,5,4,2,11,Loyal
1631,345,14,2180.9900000000002,2,5,4,11,At Risk
1632,549,5,416.6,1,1,1,3,Hibernating
1633,165,11,1075.6399999999999,3,3,2,8,Regulars
1634,25,8,497.74,5,2,1,8,Regulars
1635,838,8,1328.55,1,2,3,6,Regulars
1636,380,11,1363.08,2,3,3,8,Regulars
1637,124,12,1113.89,4,4,2,10,Loyal
1638,980,8,1043.88,1,2,2,5,Hibernating
1639,126,12,1334.5,4,4,3,11,Loyal
1640,1167,8,1315.2,1,2,3,6,Regulars
1641,345,11,683.62,2,3,1,6,Regulars
1642,41,13,1957.4099999999999,5,4,4,13,Champions
1643,204,5,817.99,3,1,1,5,Regulars
1644,222,11,1035.02,3,3,2,8,Regulars
1645,31,8,1596.27,5,2,3,10,Regulars
1646,37,7,614.71,5,1,1,7,Regulars
1647,67,16,1974.4399999999998,4,5,4,13,Champions
1648,159,6,328.33,3,1,1,5,Regulars
1649,686,10,603.84,1,3,1,5,Regulars
1650,133,11,3379.56,4,3,5,12,Loyal
1651,81,13,3654.5299999999997,4,4,5,13,Champions
1652,243,9,1340.97,3,2,3,8,Regulars
1653,497,10,1192.4600000000003,1,3,2,6,Regulars
1654,309,9,1626.8799999999997,2,2,3,7,Regulars
1655,243,7,740.0400000000001,3,1,1,5,Regulars
1656,542,9,2223.83,1,2,4,7,Regulars
1657,424,14,2901.3999999999996,2,5,5,12,At Risk
1658,332,7,1419.78,2,1,3,6,Regulars
1659,441,11,1545.98,2,3,3,8,Regulars
1660,631,8,817.26,1,2,1,4,Hibernating
1661,218,13,2129.21,3,4,4,11,Big Spenders
1662,330,13,3683.8300000000004,2,4,5,11,At Risk
1663,222,13,4391.1,3,4,5,12,Big Spenders
1664,168,10,1243.26,3,3,3,9,Regulars
1665,330,10,2225.86,2,3,4,9,Regulars
1666,106,7,537.48,4,1,1,6,Regulars
1667,179,11,1478.71,3,3,3,9,Regulars
1668,946,7,1181.34,1,1,2,4,Hibernating
1669,193,11,1727.86,3,3,4,10,Big Spenders
1670,597,8,1890.0,1,2,4,7,Regulars
1671,644,2,289.15,1,1,1,3,Hibernating
1672,356,14,4494.23,2,5,5,12,At Risk
1673,234,11,1611.4,3,3,3,9,Regulars
1674,314,11,3484.6099999999997,2,3,5,10,Regulars
1675,144,19,2170.4700000000003,4,5,4,13,Champions
1676,6,8,1110.43,5,2,2,9,Regulars
1677,822,9,1684.58,1,2,3,6,Regulars
1678,490,8,991.3,1,2,2,5,Hibernating
1679,562,9,1682.14,1,2,3,6,Regulars
1680,497,5,437.21,1,1,1,3,Hibernating
1681,6,12,1207.87,5,4,2,11,Loyal
1682,379,9,547.65,2,2,1,5,Hibernating
1683,551,6,403.59000000000003,1,1,1,3,Hibernating
1684,602,7,730.38,1,1,1,3,Hibernating
1685,37,13,2157.48,5,4,4,13,Champions
1686,85,10,1232.96,4,3,2,9,Loyal
1687,714,10,2095.83,1,3,4,8,Regulars
1688,195,15,1515.61,3,5,3,11,Regulars
1689,159,10,5409.49,3,3,5,11,Big Spenders
1690,291,21,3866.2599999999998,2,5,5,12,At Risk
1691,200,5,779.3399999999999,3,1,1,5,Regulars
1692,349,7,467.87,2,1,1,4,Hibernating
1693,227,6,2331.45,3,1,4,8,Big Spenders
1694,454,9,980.1800000000001,2,2,2,6,Hibernating
1695,55,21,2434.28,5,5,4,14,Champions
1696,129,13,3206.8199999999997,4,4,5,13,Champions
1697,97,12,1175.89,4,4,2,10,Loyal
1698,116,6,688.6800000000001,4,1,1,6,Regulars
1699,368,10,1235.6100000000001,2,3,2,7,Regulars
1700,454,16,4034.59,2,5,5,12,At Risk
1701,60,20,1515.6399999999999,5,5,3,13,Loyal
1702,369,7,638.6,2,1,1,4,Hibernating
1703,122,17,2231.49,4,5,4,13,Champions
1704,279,10,6238.3,2,3,5,10,Regulars
1705,106,12,1455.43,4,4,3,11,Loyal
1706,312,10,3363.63,2,3,5,10,Regulars
1707,148,12,1475.8899999999999,3,4,3,10,Regulars
1708,138,14,1430.74,4,5,3,12,Loyal
1709,92,7,680.65,4,1,1,6,Regulars
1710,438,15,1945.33,2,5,4,11,At Risk
1711,110,9,1021.39,4,2,2,8,Regulars
1712,1423,5,400.41999999999996,1,1,1,3,Hibernating
1713,569,9,1588.1100000000001,1,2,3,6,Regulars
1714,464,4,901.13,1,1,2,4,Hibernating
1715,74,8,1215.28,4,2,2,8,Regulars
1716,101,10,2774.98,4,3,5,12,Loyal
1717,26,13,2447.99,5,4,4,13,Champions
1718,372,11,757.5400000000001,2,3,1,6,Regulars
1719,328,12,908.06,2,4,2,8,At Risk
1720,274,10,1466.0900000000001,2,3,3,8,Regulars
1721,208,10,526.2,3,3,1,7,Regulars
1722,252,9,796.5699999999999,2,2,1,5,Hibernating
1723,215,12,6096.86,3,4,5,12,Big Spenders
1724,223,12,1596.8899999999999,3,4,3,10,Regulars
1725,6,13,969.43,5,4,2,11,Loyal
1726,38,9,1376.82,5,2,3,10,Regulars
1727,127,13,1903.72,4,4,4,12,Champions
1728,344,8,834.86,2,2,1,5,Hibernating
1729,1024,10,1356.21,1,3,3,7,Regulars
1730,57,9,2212.1099999999997,5,2,4,11,Big Spenders
1731,182,9,2580.77,3,2,5,10,Big Spenders
1732,222,9,787.0,3,2,1,6,Regulars
1733,194,8,1421.93,3,2,3,8,Regulars
1734,684,11,2293.52,1,3,4,8,Regulars
1735,470,8,1923.3700000000001,1,2,4,7,Regulars
1736,787,6,657.62,1,1,1,3,Hibernating
1737,534,8,2410.2000000000003,1,2,4,7,Regulars
1738,155,9,717.22,3,2,1,6,Regulars
1739,430,11,1845.88,2,3,4,9,Regulars
1740,43,10,1438.58,5,3,3,11,Loyal
1741,124,13,1741.55,4,4,4,12,Champions
1742,167,10,857.6500000000001,3,3,2,8,Regulars
1743,616,10,541.34,1,3,1,5,Regulars
1744,770,5,596.2900000000001,1,1,1,3,Hibernating
1745,142,9,1174.67,4,2,2,8,Regulars
1746,388,20,3123.0699999999997,2,5,5,12,At Risk
1747,7,17,2000.96,5,5,4,14,Champions
1748,61,8,1171.42,5,2,2,9,Regulars
1749,122,16,1549.37,4,5,3,12,Loyal
1750,146,14,1813.81,4,5,4,13,Champions
1751,259,10,3186.0200000000004,2,3,5,10,Regulars
1752,806,10,3004.2499999999995,1,3,5,9,Regulars
1753,329,11,1000.36,2,3,2,7,Regulars
1754,99,10,2173.6099999999997,4,3,4,11,Loyal
1755,188,12,5890.48,3,4,5,12,Big Spenders
1756,132,8,1026.68,4,2,2,8,Regulars
1757,455,8,1978.6299999999999,2,2,4,8,Regulars
1758,28,12,924.8100000000001,5,4,2,11,Loyal
1759,446,8,1249.85,2,2,3,7,Regulars
1760,76,12,1442.02,4,4,3,11,Loyal
1761,542,8,773.8,1,2,1,4,Hibernating
1762,820,6,1012.27,1,1,2,4,Hibernating
1763,1180,9,685.79,1,2,1,4,Hibernating
1764,673,9,2891.5099999999998,1,2,5,8,Regulars
1765,191,10,1448.09,3,3,3,9,Regulars
1766,148,13,2103.5,3,4,4,11,Big Spenders
1767,186,20,2681.2,3,5,5,13,Big Spenders
1768,386,15,1639.29,2,5,3,10,At Risk
1769,622,6,2371.5299999999997,1,1,4,6,Regulars
1770,3,10,3272.34,5,3,5,13,Loyal
1771,509,11,1868.76,1,3,4,8,Regulars
1772,64,11,1061.51,5,3,2,10,Loyal
1773,817,8,2394.4599999999996,1,2,4,7,Regulars
1774,288,5,258.07,2,1,1,4,Hibernating
1775,307,11,2105.06,2,3,4,9,Regulars
1776,111,11,1389.68,4,3,3,10,Loyal
1777,10,12,3658.0299999999997,5,4,5,14,Champions
1778,383,16,3712.44,2,5,5,12,At Risk
1779,731,4,884.11,1,1,2,4,Hibernating
1780,384,14,3000.9,2,5,5,12,At Risk
1781,160,8,1003.0699999999999,3,2,2,7,Regulars
1782,147,6,636.37,4,1,1,6,Regulars
1783,152,13,1457.02,3,4,3,10,Regulars
1784,601,5,459.39,1,1,1,3,Hibernating
1785,388,11,2069.95,2,3,4,9,Regulars
1786,127,11,1020.29,4,3,2,9,Loyal
1787,176,10,3876.8,3,3,5,11,Big Spenders
1788,357,9,1851.17,2,2,4,8,Regulars
1789,6,8,3241.81,5,2,5,12,Big Spenders
1790,388,11,1368.81,2,3,3,8,Regulars
1791,21,10,981.98,5,3,2,10,Loyal
1792,41,10,952.88,5,3,2,10,Loyal
1793,221,13,1747.5,3,4,4,11,Big Spenders
1794,202,6,492.17,3,1,1,5,Regulars
1795,941,10,1290.47,1,3,3,7,Regulars
1796,239,13,1853.38,3,4,4,11,Big Spenders
1797,30,16,2197.4,5,5,4,14,Champions
1798,239,15,2045.17,3,5,4,12,Big Spenders
1799,204,7,2720.13,3,1,5,9,Big Spenders
1800,255,11,4803.2699999999995,2,3,5,10,Regulars
1801,276,11,3162.56,2,3,5,10,Regulars
1802,13,7,3403.92,5,1,5,11,Big Spenders
1803,444,6,359.13,2,1,1,4,Hibernating
1804,88,11,2432.77,4,3,4,11,Loyal
1805,464,13,1271.03,1,4,3,8,At Risk
1806,259,10,899.76,2,3,2,7,Regulars
1807,28,8,1219.17,5,2,2,9,Regulars
1808,108,9,981.79,4,2,2,8,Regulars
1809,760,14,3590.3500000000004,1,5,5,11,At Risk
1810,18,11,5957.24,5,3,5,13,Loyal
1811,79,14,2258.35,4,5,4,13,Champions
1812,374,8,809.79,2,2,1,5,Hibernating
1813,237,7,1020.49,3,1,2,6,Regulars
1814,130,9,2118.69,4,2,4,10,Big Spenders
1815,1135,7,411.5,1,1,1,3,Hibernating
1816,181,9,593.1600000000001,3,2,1,6,Regulars
1817,531,7,1191.82,1,1,2,4,Hibernating
1818,30,9,3544.9300000000003,5,2,5,12,Big Spenders
1819,209,5,2219.27,3,1,4,8,Big Spenders
1820,144,8,873.44,4,2,2,8,Regulars
1821,515,17,4006.8999999999996,1,5,5,11,At Risk
1822,524,11,807.78,1,3,1,5,Regulars
1823,324,10,2121.94,2,3,4,9,Regulars
1824,165,12,4258.639999999999,3,4,5,12,Big Spenders
1825,196,9,4531.13,3,2,5,10,Big Spenders
1826,186,10,2759.62,3,3,5,11,Big Spenders
1827,99,11,8016.9800000000005,4,3,5,12,Loyal
1828,87,12,3936.3800000000006,4,4,5,13,Champions
1829,34,14,1889.32,5,5,4,14,Champions
1830,5,15,3377.7200000000003,5,5,5,15,Champions
1831,110,8,847.69,4,2,2,8,Regulars
1832,480,12,2139.43,1,4,4,9,At Risk
1833,173,16,2176.79,3,5,4,12,Big Spenders
1834,22,13,894.87,5,4,2,11,Loyal
1835,614,4,200.92000000000002,1,1,1,3,Hibernating
1836,238,10,674.47,3,3,1,7,Regulars
1837,190,7,1715.7699999999998,3,1,3,7,Regulars
1838,175,12,1547.06,3,4,3,10,Regulars
1839,424,11,753.4399999999999,2,3,1,6,Regulars
1840,116,15,770.88,4,5,1,10,Loyal
1841,302,5,899.44,2,1,2,5,Hibernating
1842,568,9,1480.8400000000001,1,2,3,6,Regulars
1843,302,12,2973.36,2,4,5,11,At Risk
1844,260,8,1558.57,2,2,3,7,Regulars
1845,106,12,5017.96,4,4,5,13,Champions
1846,407,12,885.49,2,4,2,8,At Risk
1847,52,7,2641.73,5,1,5,11,Big Spenders
1848,370,11,1167.8700000000001,2,3,2,7,Regulars
1849,28,9,643.04,5,2,1,8,Regulars
1850,146,17,2928.52,4,5,5,14,Champions
1851,79,11,1858.6599999999999,4,3,4,11,Loyal
1852,134,13,1857.6899999999998,4,4,4,12,Champions
1853,409,8,1557.3600000000001,2,2,3,7,Regulars
1854,227,5,596.63,3,1,1,5,Regulars
1855,68,10,1206.68,4,3,2,9,Loyal
1856,184,8,1360.9599999999998,3,2,3,8,Regulars
1857,189,21,1464.68,3,5,3,11,Regulars
1858,248,7,456.64,2,1,1,4,Hibernating
1859,108,13,2080.9300000000003,4,4,4,12,Champions
1860,278,14,2669.88,2,5,5,12,At Risk
1861,171,10,895.3399999999999,3,3,2,8,Regulars
1862,204,14,2645.0800000000004,3,5,5,13,Big Spenders
1863,52,12,1645.45,5,4,3,12,Loyal
1864,93,12,7719.25,4,4,5,13,Champions
1865,404,8,2431.42,2,2,4,8,Regulars
1866,274,14,2323.34,2,5,4,11,At Risk
1867,267,10,2457.18,2,3,4,9,Regulars
1868,177,11,3818.46,3,3,5,11,Big Spenders
1869,146,16,5001.59,4,5,5,14,Champions
1870,716,8,707.72,1,2,1,4,Hibernating
1871,468,9,971.86,1,2,2,5,Hibernating
1872,695,6,1058.85,1,1,2,4,Hibernating
1873,71,10,985.7,4,3,2,9,Loyal
1874,60,7,1093.98,5,1,2,8,Regulars
1875,39,13,1056.43,5,4,2,11,Loyal
1876,228,6,3257.0,3,1,5,9,Big Spenders
1877,864,8,1346.28,1,2,3,6,Regulars
1878,294,12,5278.82,2,4,5,11,At Risk
1879,186,14,6990.66,3,5,5,13,Big Spenders
1880,225,13,5702.38,3,4,5,12,Big Spenders
1881,225,8,2735.42,3,2,5,10,Big Spenders
1882,122,10,942.9000000000001,4,3,2,9,Loyal
1883,285,11,944.74,2,3,2,7,Regulars
1884,31,9,1765.24,5,2,4,11,Big Spenders
1885,135,11,3591.17,4,3,5,12,Loyal
1886,44,7,2020.3600000000001,5,1,4,10,Big Spenders
1887,356,14,1266.24,2,5,3,10,At Risk
1888,627,10,637.71,1,3,1,5,Regulars
1889,49,5,924.34,5,1,2,8,Regulars
1890,465,8,2827.3,1,2,5,8,Regulars
1891,1237,7,3913.4300000000003,1,1,5,7,Regulars
1892,138,8,1898.65,4,2,4,10,Big Spenders
1893,188,12,1310.5,3,4,3,10,Regulars
1894,389,7,1136.56,2,1,2,5,Hibernating
1895,127,16,4550.67,4,5,5,14,Champions
1896,141,18,5462.639999999999,4,5,5,14,Champions
1897,239,8,884.07,3,2,2,7,Regulars
1898,63,9,2707.36,5,2,5,12,Big Spenders
1899,238,11,988.4,3,3,2,8,Regulars
1900,333,7,557.67,2,1,1,4,Hibernating
1901,169,19,4133.15,3,5,5,13,Big Spenders
1902,154,13,1184.85,3,4,2,9,Regulars
1903,739,8,3617.5600000000004,1,2,5,8,Regulars
1904,239,16,3447.1,3,5,5,13,Big Spenders
1905,508,9,937.4300000000001,1,2,2,5,Hibernating
1906,283,10,1627.0300000000002,2,3,3,8,Regulars
1907,882,7,2200.68,1,1,4,6,Regulars
1908,181,11,1951.35,3,3,4,10,Big Spenders
1909,222,10,928.3000000000001,3,3,2,8,Regulars
1910,39,15,3401.73,5,5,5,15,Champions
1911,686,6,1294.0,1,1,3,5,Regulars
1912,95,14,1366.82,4,5,3,12,Loyal
1913,15,6,732.1300000000001,5,1,1,7,Regulars
1914,510,12,3075.78,1,4,5,10,At Risk
1915,175,12,978.24,3,4,2,9,Regulars
1916,215,12,1353.39,3,4,3,10,Regulars
1917,120,10,1025.75,4,3,2,9,Loyal
1918,447,10,1654.18,2,3,3,8,Regulars
1919,346,7,753.98,2,1,1,4,Hibernating
1920,191,7,3758.12,3,1,5,9,Big Spenders
1921,132,12,1218.67,4,4,2,10,Loyal
1922,307,11,1340.99,2,3,3,8,Regulars
1923,256,6,256.58000000000004,2,1,1,4,Hibernating
1924,583,11,865.54,1,3,2,6,Regulars
1925,680,11,1057.1200000000001,1,3,2,6,Regulars
1926,455,7,947.1800000000001,2,1,2,5,Hibernating
1927,111,12,1960.85,4,4,4,12,Champions
1928,183,13,1697.85,3,4,3,10,Regulars
1929,474,9,3795.13,1,2,5,8,Regulars
1930,51,13,2609.3199999999997,5,4,5,14,Champions
1931,186,9,1541.14,3,2,3,8,Regulars
1932,158,8,606.5899999999999,3,2,1,6,Regulars
1933,94,13,3190.3,4,4,5,13,Champions
1934,130,16,1882.47,4,5,4,13,Champions
1935,223,11,912.05,3,3,2,8,Regulars
1936,414,16,1876.59,2,5,4,11,At Risk
1937,129,12,1699.4,4,4,3,11,Loyal
1938,266,9,1849.0,2,2,4,8,Regulars
1939,20,9,783.26,5,2,1,8,Regulars
1940,1265,7,754.07,1,1,1,3,Hibernating
1941,171,10,769.43,3,3,1,7,Regulars
1942,157,11,1806.19,3,3,4,10,Big Spenders
1943,65,15,2114.7200000000003,5,5,4,14,Champions
1944,9,8,2963.98,5,2,5,12,Big Spenders
1945,166,9,2465.91,3,2,4,9,Big Spenders
1946,1153,6,696.48,1,1,1,3,Hibernating
1947,354,6,3157.2,2,1,5,8,Regulars
1948,299,7,594.55,2,1,1,4,Hibernating
1949,196,9,1411.6,3,2,3,8,Regulars
1950,113,20,3251.3,4,5,5,14,Champions
1951,630,7,829.09,1,1,1,3,Hibernating
1952,66,12,2770.18,4,4,5,13,Champions
1953,42,14,2232.38,5,5,4,14,Champions
1954,184,5,720.84,3,1,1,5,Regulars
1955,28,7,1074.8600000000001,5,1,2,8,Regulars
1956,1037,6,504.09000000000003,1,1,1,3,Hibernating
1957,165,15,1952.42,3,5,4,12,Big Spenders
1958,134,14,3929.29,4,5,5,14,Champions
1959,187,12,3229.21,3,4,5,12,Big Spenders
1960,510,9,2876.6500000000005,1,2,5,8,Regulars
1961,580,9,1550.98,1,2,3,6,Regulars
1962,311,10,623.27,2,3,1,6,Regulars
1963,549,8,397.34999999999997,1,2,1,4,Hibernating
1964,457,11,2289.28,2,3,4,9,Regulars
1965,104,12,2580.04,4,4,5,13,Champions
1966,54,16,2127.3,5,5,4,14,Champions
1967,595,11,1153.05,1,3,2,6,Regulars
1968,52,16,1156.7,5,5,2,12,Loyal
1969,199,5,662.5699999999999,3,1,1,5,Regulars
1970,87,10,1427.42,4,3,3,10,Loyal
1971,119,12,828.64,4,4,1,9,Loyal
1972,741,10,1510.23,1,3,3,7,Regulars
1973,74,10,772.24,4,3,1,8,Loyal
1974,53,9,2671.93,5,2,5,12,Big Spenders
1975,5,14,1969.24,5,5,4,14,Champions
1976,67,14,4132.51,4,5,5,14,Champions
1977,85,10,1003.9599999999999,4,3,2,9,Loyal
1978,43,8,895.42,5,2,2,9,Regulars
1979,2,10,839.15,5,3,1,9,Loyal
1980,279,7,2024.2399999999998,2,1,4,7,Regulars
1981,210,13,2320.5299999999997,3,4,4,11,Big Spenders
1982,143,6,579.72,4,1,1,6,Regulars
1983,213,12,1469.81,3,4,3,10,Regulars
1984,223,13,1093.89,3,4,2,9,Regulars
1985,437,13,1653.25,2,4,3,9,At Risk
1986,193,8,588.8100000000001,3,2,1,6,Regulars
1987,28,10,1013.63,5,3,2,10,Loyal
1988,733,7,1294.08,1,1,3,5,Regulars
1989,12,10,1456.33,5,3,3,11,Loyal
1990,33,15,935.53,5,5,2,12,Loyal
1991,542,7,390.54,1,1,1,3,Hibernating
1992,37,8,923.1700000000001,5,2,2,9,Regulars
1993,90,12,2854.68,4,4,5,13,Champions
1994,50,13,1464.97,5,4,3,12,Loyal
1995,171,9,1401.15,3,2,3,8,Regulars
1996,553,9,3915.29,1,2,5,8,Regulars
1997,311,10,1402.0900000000001,2,3,3,8,Regulars
1998,479,10,689.1800000000001,1,3,1,5,Regulars
1999,103,11,515.9300000000001,4,3,1,8,Loyal
2000,424,14,2682.64,2,5,5,12,At Risk
2001,327,7,429.21000000000004,2,1,1,4,Hibernating
2002,12,11,1766.74,5,3,4,12,Loyal
2003,279,6,2033.1599999999996,2,1,4,7,Regulars
2004,259,9,1071.0,2,2,2,6,Hibernating
2005,282,6,1566.63,2,1,3,6,Regulars
2006,111,8,749.8299999999999,4,2,1,7,Regulars
2007,128,11,1170.38,4,3,2,9,Loyal
2008,42,13,1348.08,5,4,3,12,Loyal
2009,48,14,1939.2700000000002,5,5,4,14,Champions
2010,106,15,3849.08,4,5,5,14,Champions
2011,496,8,1106.7,1,2,2,5,Hibernating
2012,273,15,1803.98,2,5,4,11,At Risk
2013,33,12,2139.1,5,4,4,13,Champions
2014,179,15,2202.0,3,5,4,12,Big Spenders
2015,177,12,990.62,3,4,2,9,Regulars
2016,117,7,369.75,4,1,1,6,Regulars
2017,399,10,3986.72,2,3,5,10,Regulars
2018,90,11,1198.04,4,3,2,9,Loyal
2019,237,6,337.49,3,1,1,5,Regulars
2020,90,9,425.59,4,2,1,7,Regulars
2021,171,9,662.54,3,2,1,6,Regulars
2022,52,10,928.81,5,3,2,10,Loyal
2023,84,10,1202.59,4,3,2,9,Loyal
2024,281,12,7701.22,2,4,5,11,At Risk
2025,211,10,1487.6000000000001,3,3,3,9,Regulars
2026,180,14,2478.38,3,5,4,12,Big Spenders
2027,14,12,1711.49,5,4,3,12,Loyal
2028,619,10,1013.48,1,3,2,6,Regulars
2029,162,11,1081.68,3,3,2,8,Regulars
2030,167,14,2395.02,3,5,4,12,Big Spenders
2031,213,10,738.58,3,3,1,7,Regulars
2032,26,10,2058.3,5,3,4,12,Loyal
2033,6,6,606.45,5,1,1,7,Regulars
2034,166,20,4234.08,3,5,5,13,Big Spenders
2035,197,14,1397.56,3,5,3,11,Regulars
2036,128,8,1319.27,4,2,3,9,Regulars
2037,778,6,603.9,1,1,1,3,Hibernating
2038,46,11,1801.99,5,3,4,12,Loyal
2039,122,12,1569.53,4,4,3,11,Loyal
2040,89,10,1975.39,4,3,4,11,Loyal
2041,382,8,723.44,2,2,1,5,Hibernating
2042,187,11,1770.08,3,3,4,10,Big Spenders
2043,82,8,1368.3600000000001,4,2,3,9,Regulars
2044,117,10,1534.67,4,3,3,10,Loyal
2045,698,8,431.66,1,2,1,4,Hibernating
2046,685,9,1677.33,1,2,3,6,Regulars
2047,182,14,2365.58,3,5,4,12,Big Spenders
2048,147,10,4068.6200000000003,4,3,5,12,Loyal
2049,88,9,793.9599999999999,4,2,1,7,Regulars
2050,464,9,1788.53,1,2,4,7,Regulars
2051,269,10,2209.44,2,3,4,9,Regulars
2052,155,11,1972.5,3,3,4,10,Big Spenders
2053,14,8,4292.74,5,2,5,12,Big Spenders
2054,5,13,1058.32,5,4,2,11,Loyal
2055,220,12,1429.85,3,4,3,10,Regulars
2056,322,9,1386.72,2,2,3,7,Regulars
2057,247,10,2018.1699999999998,3,3,4,10,Big Spenders
2058,576,8,578.37,1,2,1,4,Hibernating
2059,172,8,904.4300000000001,3,2,2,7,Regulars
2060,797,6,896.3900000000001,1,1,2,4,Hibernating
2061,104,14,1433.04,4,5,3,12,Loyal
2062,596,8,900.23,1,2,2,5,Hibernating
2063,190,17,3310.51,3,5,5,13,Big Spenders
2064,299,11,1365.96,2,3,3,8,Regulars
2065,135,6,524.74,4,1,1,6,Regulars
2066,126,10,1758.7600000000002,4,3,4,11,Loyal
2067,262,11,1617.48,2,3,3,8,Regulars
2068,14,15,4624.75,5,5,5,15,Champions
2069,1244,5,3511.7599999999998,1,1,5,7,Regulars
2070,493,5,332.96999999999997,1,1,1,3,Hibernating
2071,117,10,2039.1100000000001,4,3,4,11,Loyal
2072,537,7,2122.03,1,1,4,6,Regulars
2073,345,10,1371.2499999999998,2,3,3,8,Regulars
2074,412,12,2739.44,2,4,5,11,At Risk
2075,13,7,708.35,5,1,1,7,Regulars
2076,7,12,1391.67,5,4,3,12,Loyal
2077,104,11,1478.03,4,3,3,10,Loyal
2078,52,14,2300.5299999999997,5,5,4,14,Champions
2079,57,18,3464.31,5,5,5,15,Champions
2080,113,11,1643.48,4,3,3,10,Loyal
2081,84,7,1257.1100000000001,4,1,3,8,Regulars
2082,87,13,2227.48,4,4,4,12,Champions
2083,455,11,1772.71,2,3,4,9,Regulars
2084,81,13,1468.79,4,4,3,11,Loyal
2085,386,8,554.01,2,2,1,5,Hibernating
2086,26,13,2131.02,5,4,4,13,Champions
2087,270,13,2402.63,2,4,4,10,At Risk
2088,70,8,527.19,4,2,1,7,Regulars
2089,628,6,704.84,1,1,1,3,Hibernating
2090,523,12,2641.12,1,4,5,10,At Risk
2091,408,6,1188.02,2,1,2,5,Hibernating
2092,245,14,1913.3899999999999,3,5,4,12,Big Spenders
2093,139,12,1717.52,4,4,3,11,Loyal
2094,34,9,2815.39,5,2,5,12,Big Spenders
2095,85,11,2621.73,4,3,5,12,Loyal
2096,2,8,1218.19,5,2,2,9,Regulars
2097,609,7,558.11,1,1,1,3,Hibernating
2098,92,9,2195.12,4,2,4,10,Big Spenders
2099,747,12,3255.85,1,4,5,10,At Risk
2100,141,14,3645.62,4,5,5,14,Champions
2101,9,8,3874.08,5,2,5,12,Big Spenders
2102,89,11,950.5699999999999,4,3,2,9,Loyal
2103,574,10,942.63,1,3,2,6,Regulars
2104,76,7,778.63,4,1,1,6,Regulars
2105,164,7,783.56,3,1,1,5,Regulars
2106,333,8,311.65,2,2,1,5,Hibernating
2107,167,6,1960.7000000000003,3,1,4,8,Big Spenders
2108,1233,3,645.16,1,1,1,3,Hibernating
2109,67,7,834.9200000000001,4,1,1,6,Regulars
2110,30,9,967.78,5,2,2,9,Regulars
2111,489,9,1256.53,1,2,3,6,Regulars
2112,793,9,987.41,1,2,2,5,Hibernating
2113,130,16,1988.71,4,5,4,13,Champions
2114,440,18,5347.3,2,5,5,12,At Risk
2115,390,10,4270.47,2,3,5,10,Regulars
2116,277,13,788.64,2,4,1,7,At Risk
2117,378,12,2087.43,2,4,4,10,At Risk
2118,973,8,372.25,1,2,1,4,Hibernating
2119,89,14,1753.68,4,5,4,13,Champions
2120,531,10,2532.1800000000003,1,3,4,8,Regulars
2121,143,16,1652.3500000000001,4,5,3,12,Loyal
2122,567,5,311.82,1,1,1,3,Hibernating
2123,34,8,2708.6600000000003,5,2,5,12,Big Spenders
2124,252,9,1090.97,2,2,2,6,Hibernating
2125,314,21,3725.73,2,5,5,12,At Risk
2126,134,11,2594.33,4,3,5,12,Loyal
2127,213,12,962.4200000000001,3,4,2,9,Regulars
2128,149,12,905.8399999999999,3,4,2,9,Regulars
2129,389,13,2670.33,2,4,5,11,At Risk
2130,578,7,599.06,1,1,1,3,Hibernating
2131,82,16,1542.2,4,5,3,12,Loyal
2132,938,7,614.27,1,1,1,3,Hibernating
2133,445,11,914.25,2,3,2,7,Regulars
2134,193,11,1275.1299999999999,3,3,3,9,Regulars
2135,187,10,1495.3200000000002,3,3,3,9,Regulars
2136,124,8,989.8100000000001,4,2,2,8,Regulars
2137,31,6,1228.45,5,1,2,8,Regulars
2138,162,8,1473.51,3,2,3,8,Regulars
2139,309,8,725.11,2,2,1,5,Hibernating
2140,84,11,3253.58,4,3,5,12,Loyal
2141,5,9,1663.31,5,2,3,10,Regulars
2142,26,13,2771.34,5,4,5,14,Champions
2143,471,11,1538.99,1,3,3,7,Regulars
2144,654,9,1373.77,1,2,3,6,Regulars
2145,165,12,1511.71,3,4,3,10,Regulars
2146,211,11,2756.31,3,3,5,11,Big Spenders
2147,138,10,1057.82,4,3,2,9,Loyal
2148,78,8,786.4399999999999,4,2,1,7,Regulars
2149,64,6,706.8500000000001,5,1,1,7,Regulars
2150,162,10,1741.34,3,3,4,10,Big Spenders
2151,26,4,588.1700000000001,5,1,1,7,Regulars
2152,340,9,3031.71,2,2,5,9,Regulars
2153,209,5,1122.03,3,1,2,6,Regulars
2154,813,5,977.55,1,1,2,4,Hibernating
2155,124,9,1670.77,4,2,3,9,Regulars
2156,668,11,1033.6299999999999,1,3,2,6,Regulars
2157,266,16,2202.89,2,5,4,11,At Risk
2158,132,8,463.40999999999997,4,2,1,7,Regulars
2159,312,6,292.07,2,1,1,4,Hibernating
2160,770,13,3703.8799999999997,1,4,5,10,At Risk
2161,595,9,1046.54,1,2,2,5,Hibernating
2162,295,12,2199.0800000000004,2,4,4,10,At Risk
2163,925,5,196.37,1,1,1,3,Hibernating
2164,85,10,1813.3,4,3,4,11,Loyal
2165,391,5,972.03,2,1,2,5,Hibernating
2166,132,6,574.56,4,1,1,6,Regulars
2167,161,9,943.14,3,2,2,7,Regulars
2168,164,12,1794.28,3,4,4,11,Big Spenders
2169,397,9,705.5999999999999,2,2,1,5,Hibernating
2170,60,10,975.3900000000001,5,3,2,10,Loyal
2171,63,13,2677.2400000000002,5,4,5,14,Champions
2172,601,10,3357.01,1,3,5,9,Regulars
2173,755,6,948.04,1,1,2,4,Hibernating
2174,734,7,1523.71,1,1,3,5,Regulars
2175,170,6,787.72,3,1,1,5,Regulars
2176,65,14,1222.96,5,5,2,12,Loyal
2177,45,11,1438.6799999999998,5,3,3,11,Loyal
2178,416,9,1498.52,2,2,3,7,Regulars
2179,239,13,3067.26,3,4,5,12,Big Spenders
2180,121,12,1977.1499999999999,4,4,4,12,Champions
2181,6,11,4966.120000000001,5,3,5,13,Loyal
2182,155,12,1529.77,3,4,3,10,Regulars
2183,365,15,4306.400000000001,2,5,5,12,At Risk
2184,92,14,1381.27,4,5,3,12,Loyal
2185,258,5,1296.93,2,1,3,6,Regulars
2186,612,7,1103.74,1,1,2,4,Hibernating
2187,238,10,963.76,3,3,2,8,Regulars
2188,200,6,819.49,3,1,1,5,Regulars
2189,648,7,2253.5,1,1,4,6,Regulars
2190,105,9,724.52,4,2,1,7,Regulars
2191,164,10,4626.84,3,3,5,11,Big Spenders
2192,900,11,2327.06,1,3,4,8,Regulars
2193,165,11,1575.83,3,3,3,9,Regulars
2194,146,14,3022.14,4,5,5,14,Champions
2195,453,12,2261.47,2,4,4,10,At Risk
2196,553,10,1731.91,1,3,4,8,Regulars
2197,104,15,2650.37,4,5,5,14,Champions
2198,26,12,1924.78,5,4,4,13,Champions
2199,560,13,1041.73,1,4,2,7,At Risk
2200,278,9,3917.96,2,2,5,9,Regulars
2201,40,12,1944.6,5,4,4,13,Champions
2202,304,5,557.19,2,1,1,4,Hibernating
2203,11,10,1364.4199999999998,5,3,3,11,Loyal
2204,347,11,988.0,2,3,2,7,Regulars
2205,762,11,2154.59,1,3,4,8,Regulars
2206,212,10,1248.45,3,3,3,9,Regulars
2207,63,19,1823.25,5,5,4,14,Champions
2208,95,7,480.46,4,1,1,6,Regulars
2209,1107,7,667.69,1,1,1,3,Hibernating
2210,108,8,947.6700000000001,4,2,2,8,Regulars
2211,272,13,4127.05,2,4,5,11,At Risk
2212,134,10,754.6,4,3,1,8,Loyal
2213,266,6,1036.28,2,1,2,5,Hibernating
2214,176,10,3344.9300000000003,3,3,5,11,Big Spenders
2215,101,13,5459.52,4,4,5,13,Champions
2216,50,13,4577.78,5,4,5,14,Champions
2217,571,6,1349.41,1,1,3,5,Regulars
2218,78,10,1947.3899999999999,4,3,4,11,Loyal
2219,108,10,2017.9500000000003,4,3,4,11,Loyal
2220,195,13,1715.1599999999999,3,4,3,10,Regulars
2221,334,7,938.69,2,1,2,5,Hibernating
2222,110,10,1204.78,4,3,2,9,Loyal
2223,8,7,700.98,5,1,1,7,Regulars
2224,49,8,1930.77,5,2,4,11,Big Spenders
2225,133,9,740.74,4,2,1,7,Regulars
2226,15,14,2020.74,5,5,4,14,Champions
2227,611,7,340.89,1,1,1,3,Hibernating
2228,281,9,354.44,2,2,1,5,Hibernating
2229,132,7,506.74,4,1,1,6,Regulars
2230,1142,8,465.51,1,2,1,4,Hibernating
2231,383,11,4172.67,2,3,5,10,Regulars
2232,798,9,1682.6399999999999,1,2,3,6,Regulars
2233,590,13,1514.24,1,4,3,8,At Risk
2234,495,11,2327.0299999999997,1,3,4,8,Regulars
2235,11,11,1396.64,5,3,3,11,Loyal
2236,309,10,4818.57,2,3,5,10,Regulars
2237,228,14,2290.41,3,5,4,12,Big Spenders
2238,65,11,1124.5,5,3,2,10,Loyal
2239,98,14,2836.7999999999997,4,5,5,14,Champions
2240,148,6,608.77,3,1,1,5,Regulars
2241,152,8,1774.85,3,2,4,9,Big Spenders
2242,840,7,1168.15,1,1,2,4,Hibernating
2243,40,11,3314.3199999999997,5,3,5,13,Loyal
2244,278,11,853.86,2,3,2,7,Regulars
2245,252,8,417.31,2,2,1,5,Hibernating
2246,39,9,610.12,5,2,1,8,Regulars
2247,110,7,805.5400000000001,4,1,1,6,Regulars
2248,1283,5,479.55,1,1,1,3,Hibernating
2249,42,14,1198.13,5,5,2,12,Loyal
2250,429,9,1708.9399999999998,2,2,3,7,Regulars
2251,16,15,924.9399999999999,5,5,2,12,Loyal
2252,176,13,7472.41,3,4,5,12,Big Spenders
2253,0,12,1512.17,5,4,3,12,Loyal
2254,208,4,913.88,3,1,2,6,Regulars
2255,84,14,3496.58,4,5,5,14,Champions
2256,347,8,802.4000000000001,2,2,1,5,Hibernating
2257,578,10,2722.77,1,3,5,9,Regulars
2258,151,8,823.69,3,2,1,6,Regulars
2259,320,8,1404.44,2,2,3,7,Regulars
2260,434,7,1728.9199999999998,2,1,4,7,Regulars
2261,81,13,1253.95,4,4,3,11,Loyal
2262,534,12,1048.33,1,4,2,7,At Risk
2263,75,8,1043.69,4,2,2,8,Regulars
2264,156,6,815.8,3,1,1,5,Regulars
2265,277,11,880.5899999999999,2,3,2,7,Regulars
2266,394,16,2745.1800000000003,2,5,5,12,At Risk
2267,16,11,958.36,5,3,2,10,Loyal
2268,253,9,944.2,2,2,2,6,Hibernating
2269,180,14,3464.58,3,5,5,13,Big Spenders
2270,16,10,808.77,5,3,1,9,Loyal
2271,527,4,1210.95,1,1,2,4,Hibernating
2272,37,15,2948.21,5,5,5,15,Champions
2273,437,5,666.1700000000001,2,1,1,4,Hibernating
2274,36,9,4590.7,5,2,5,12,Big Spenders
2275,793,9,454.96,1,2,1,4,Hibernating
2276,140,14,1201.31,4,5,2,11,Loyal
2277,139,9,1017.04,4,2,2,8,Regulars
2278,550,16,3787.57,1,5,5,11,At Risk
2279,377,6,369.73,2,1,1,4,Hibernating
2280,5,14,2478.39,5,5,4,14,Champions
2281,428,10,1577.72,2,3,3,8,Regulars
2282,41,14,1479.34,5,5,3,13,Loyal
2283,2,9,1694.24,5,2,3,10,Regulars
2284,206,13,1141.48,3,4,2,9,Regulars
2285,165,11,2220.03,3,3,4,10,Big Spenders
2286,127,12,1220.43,4,4,2,10,Loyal
2287,174,11,2969.49,3,3,5,11,Big Spenders
2288,206,9,620.9,3,2,1,6,Regulars
2289,323,8,2316.01,2,2,4,8,Regulars
2290,290,10,1728.87,2,3,4,9,Regulars
2291,497,10,1192.26,1,3,2,6,Regulars
2292,9,16,2263.1,5,5,4,14,Champions
2293,41,13,4127.1,5,4,5,14,Champions
2294,219,11,965.45,3,3,2,8,Regulars
2295,207,11,2666.37,3,3,5,11,Big Spenders
2296,186,6,389.36,3,1,1,5,Regulars
2297,0,15,5829.85,5,5,5,15,Champions
2298,84,6,752.02,4,1,1,6,Regulars
2299,349,12,1850.78,2,4,4,10,At Risk
2300,95,11,1302.86,4,3,3,10,Loyal
2301,632,5,977.5600000000001,1,1,2,4,Hibernating
2302,768,8,1568.25,1,2,3,6,Regulars
2303,6,9,1561.2,5,2,3,10,Regulars
2304,38,16,3194.2599999999998,5,5,5,15,Champions
2305,269,11,2283.0,2,3,4,9,Regulars
2306,428,9,4453.97,2,2,5,9,Regulars
2307,447,5,213.71,2,1,1,4,Hibernating
2308,352,8,694.06,2,2,1,5,Hibernating
2309,0,8,2132.88,5,2,4,11,Big Spenders
2310,233,11,857.71,3,3,2,8,Regulars
2311,101,12,2616.08,4,4,5,13,Champions
2312,673,8,1174.95,1,2,2,5,Hibernating
2313,834,13,1177.91,1,4,2,7,At Risk
2314,321,12,2540.67,2,4,4,10,At Risk
2315,221,8,1213.01,3,2,2,7,Regulars
2316,175,9,1696.4499999999998,3,2,3,8,Regulars
2317,233,11,3394.42,3,3,5,11,Big Spenders
2318,7,8,834.1999999999999,5,2,1,8,Regulars
2319,203,13,1990.15,3,4,4,11,Big Spenders
2320,1101,7,1489.74,1,1,3,5,Regulars
2321,923,10,1325.32,1,3,3,7,Regulars
2322,1471,4,587.14,1,1,1,3,Hibernating
2323,31,14,2189.42,5,5,4,14,Champions
2324,68,11,1396.31,4,3,3,10,Loyal
2325,222,10,3572.0200000000004,3,3,5,11,Big Spenders
2326,19,17,2067.7200000000003,5,5,4,14,Champions
2327,17,10,863.2,5,3,2,10,Loyal
2328,57,13,2368.29,5,4,4,13,Champions
2329,328,12,1532.47,2,4,3,9,At Risk
2330,62,9,3859.74,5,2,5,12,Big Spenders
2331,21,11,1181.97,5,3,2,10,Loyal
2332,213,9,2495.07,3,2,4,9,Big Spenders
2333,182,9,4262.48,3,2,5,10,Big Spenders
2334,258,9,2585.01,2,2,5,9,Regulars
2335,98,13,4223.94,4,4,5,13,Champions
2336,402,10,5421.17,2,3,5,10,Regulars
2337,60,15,2870.2200000000003,5,5,5,15,Champions
2338,134,10,1172.06,4,3,2,9,Loyal
2339,823,5,589.01,1,1,1,3,Hibernating
2340,522,9,1062.69,1,2,2,5,Hibernating
2341,530,10,2373.85,1,3,4,8,Regulars
2342,673,12,2213.7799999999997,1,4,4,9,At Risk
2343,96,9,876.99,4,2,2,8,Regulars
2344,209,11,1530.8600000000001,3,3,3,9,Regulars
2345,24,11,4176.110000000001,5,3,5,13,Loyal
2346,187,7,537.4100000000001,3,1,1,5,Regulars
2347,106,8,1212.04,4,2,2,8,Regulars
2348,35,11,2520.99,5,3,4,12,Loyal
2349,21,7,1790.9899999999998,5,1,4,10,Big Spenders
2350,68,21,2359.55,4,5,4,13,Champions
2351,441,8,1084.58,2,2,2,6,Hibernating
2352,140,12,1515.75,4,4,3,11,Loyal
2353,165,9,2705.96,3,2,5,10,Big Spenders
2354,397,7,457.19,2,1,1,4,Hibernating
2355,174,17,2869.43,3,5,5,13,Big Spenders
2356,125,14,3357.59,4,5,5,14,Champions
2357,156,9,2798.73,3,2,5,10,Big Spenders
2358,155,9,371.35999999999996,3,2,1,6,Regulars
2359,288,8,1022.04,2,2,2,6,Hibernating
2360,9,10,2587.26,5,3,5,13,Loyal
2361,640,9,3842.52,1,2,5,8,Regulars
2362,84,11,2840.9700000000003,4,3,5,12,Loyal
2363,103,9,1001.4499999999999,4,2,2,8,Regulars
2364,185,9,1879.6200000000001,3,2,4,9,Big Spenders
2365,251,7,844.8399999999999,2,1,2,5,Hibernating
2366,506,8,922.35,1,2,2,5,Hibernating
2367,125,7,2237.49,4,1,4,9,Big Spenders
2368,700,9,546.14,1,2,1,4,Hibernating
2369,14,8,1984.8200000000002,5,2,4,11,Big Spenders
2370,209,15,1434.4099999999999,3,5,3,11,Regulars
2371,351,4,348.7,2,1,1,4,Hibernating
2372,274,7,2740.6,2,1,5,8,Regulars
2373,11,13,1441.62,5,4,3,12,Loyal
2374,149,12,1092.41,3,4,2,9,Regulars
2375,17,13,1831.43,5,4,4,13,Champions
2376,912,5,415.26,1,1,1,3,Hibernating
2377,70,13,1818.54,4,4,4,12,Champions
2378,510,7,1635.58,1,1,3,5,Regulars
2379,53,5,920.29,5,1,2,8,Regulars
2380,573,11,3164.01,1,3,5,9,Regulars
2381,404,12,3362.21,2,4,5,11,At Risk
2382,139,8,1014.3,4,2,2,8,Regulars
2383,178,15,1088.88,3,5,2,10,Regulars
2384,235,12,3122.37,3,4,5,12,Big Spenders
2385,130,8,1399.89,4,2,3,9,Regulars
2386,212,14,2209.23,3,5,4,12,Big Spenders
2387,725,4,1460.9100000000003,1,1,3,5,Regulars
2388,369,5,760.1700000000001,2,1,1,4,Hibernating
2389,82,6,372.9,4,1,1,6,Regulars
2390,142,9,1188.3600000000001,4,2,2,8,Regulars
2391,5,7,1823.19,5,1,4,10,Big Spenders
2392,463,6,542.22,1,1,1,3,Hibernating
2393,190,17,3212.62,3,5,5,13,Big Spenders
2394,219,8,1663.51,3,2,3,8,Regulars
2395,45,17,1857.92,5,5,4,14,Champions
2396,183,8,1291.97,3,2,3,8,Regulars
2397,354,17,2051.56,2,5,4,11,At Risk
2398,142,12,1185.68,4,4,2,10,Loyal
2399,714,11,2290.5,1,3,4,8,Regulars
2400,33,5,2719.1499999999996,5,1,5,11,Big Spenders
2401,316,12,1318.0,2,4,3,9,At Risk
2402,155,8,527.83,3,2,1,6,Regulars
2403,74,14,4329.83,4,5,5,14,Champions
2404,70,9,772.5100000000001,4,2,1,7,Regulars
2405,13,8,740.14,5,2,1,8,Regulars
2406,444,13,1658.34,2,4,3,9,At Risk
2407,47,6,598.72,5,1,1,7,Regulars
2408,358,12,1629.68,2,4,3,9,At Risk
2409,99,13,1607.95,4,4,3,11,Loyal
2410,872,6,1256.1499999999999,1,1,3,5,Regulars
2411,904,11,1615.1,1,3,3,7,Regulars
2412,191,13,2001.2600000000002,3,4,4,11,Big Spenders
2413,50,10,1255.27,5,3,3,11,Loyal
2414,240,13,3550.3399999999997,3,4,5,12,Big Spenders
2415,290,5,719.3299999999999,2,1,1,4,Hibernating
2416,58,11,5914.45,5,3,5,13,Loyal
2417,385,8,2506.1,2,2,4,8,Regulars
2418,263,7,1335.6,2,1,3,6,Regulars
2419,154,10,4801.19,3,3,5,11,Big Spenders
2420,101,17,2998.89,4,5,5,14,Champions
2421,73,16,4513.599999999999,4,5,5,14,Champions
2422,202,12,1165.95,3,4,2,9,Regulars
2423,842,7,707.04,1,1,1,3,Hibernating
2424,586,14,1187.6,1,5,2,8,At Risk
2425,124,10,783.23,4,3,1,8,Loyal
2426,32,10,972.44,5,3,2,10,Loyal
2427,199,11,1464.1399999999999,3,3,3,9,Regulars
2428,107,11,2251.07,4,3,4,11,Loyal
2429,660,17,3458.91,1,5,5,11,At Risk
2430,34,15,2432.53,5,5,4,14,Champions
2431,261,12,2238.74,2,4,4,10,At Risk
2432,517,5,1527.8300000000002,1,1,3,5,Regulars
2433,318,8,1355.54,2,2,3,7,Regulars
2434,140,11,4337.73,4,3,5,12,Loyal
2435,418,11,1028.55,2,3,2,7,Regulars
2436,196,8,561.86,3,2,1,6,Regulars
2437,320,14,1684.74,2,5,3,10,At Risk
2438,208,13,1410.51,3,4,3,10,Regulars
2439,536,6,1321.47,1,1,3,5,Regulars
2440,556,9,362.14,1,2,1,4,Hibernating
2441,100,12,1298.65,4,4,3,11,Loyal
2442,70,9,3244.2299999999996,4,2,5,11,Big Spenders
2443,169,6,798.2,3,1,1,5,Regulars
2444,50,6,2157.83,5,1,4,10,Big Spenders
2445,900,7,355.41,1,1,1,3,Hibernating
2446,238,10,2919.21,3,3,5,11,Big Spenders
2447,214,10,1706.8799999999999,3,3,3,9,Regulars
2448,189,13,1842.9299999999998,3,4,4,11,Big Spenders
2449,161,9,1979.56,3,2,4,9,Big Spenders
2450,128,14,8062.19,4,5,5,14,Champions
2451,1500,5,1469.0,1,1,3,5,Regulars
2452,212,15,3751.18,3,5,5,13,Big Spenders
2453,47,11,921.65,5,3,2,10,Loyal
2454,12,15,4017.41,5,5,5,15,Champions
2455,1077,8,828.91,1,2,1,4,Hibernating
2456,682,10,1719.76,1,3,3,7,Regulars
2457,674,9,947.48,1,2,2,5,Hibernating
2458,350,10,570.73,2,3,1,6,Regulars
2459,148,8,1396.13,3,2,3,8,Regulars
2460,18,17,5516.24,5,5,5,15,Champions
2461,2,14,1864.4099999999999,5,5,4,14,Champions
2462,4,11,1337.77,5,3,3,11,Loyal
2463,220,6,674.6899999999999,3,1,1,5,Regulars
2464,142,7,1278.97,4,1,3,8,Regulars
2465,229,8,768.4000000000001,3,2,1,6,Regulars
2466,174,9,2600.31,3,2,5,10,Big Spenders
2467,393,9,1453.6200000000001,2,2,3,7,Regulars
2468,12,14,2861.0299999999997,5,5,5,15,Champions
2469,152,13,863.33,3,4,2,9,Regulars
2470,317,11,1146.51,2,3,2,7,Regulars
2471,290,6,691.52,2,1,1,4,Hibernating
2472,665,15,1778.26,1,5,4,10,At Risk
2473,985,6,2573.22,1,1,4,6,Regulars
2474,129,10,1304.99,4,3,3,10,Loyal
2475,67,10,1286.16,4,3,3,10,Loyal
2476,316,8,988.4499999999999,2,2,2,6,Hibernating
2477,297,8,588.9200000000001,2,2,1,5,Hibernating
2478,387,7,464.57,2,1,1,4,Hibernating
2479,144,9,3083.4700000000003,4,2,5,11,Big Spenders
2480,274,7,1172.15,2,1,2,5,Hibernating
2481,85,11,3509.99,4,3,5,12,Loyal
2482,139,7,778.7,4,1,1,6,Regulars
2483,195,13,2132.0,3,4,4,11,Big Spenders
2484,465,12,3639.12,1,4,5,10,At Risk
2485,479,6,1060.97,1,1,2,4,Hibernating
2486,495,10,2463.4100000000003,1,3,4,8,Regulars
2487,126,19,4310.52,4,5,5,14,Champions
2488,278,10,1359.9,2,3,3,8,Regulars
2489,119,8,737.3000000000001,4,2,1,7,Regulars
2490,25,12,732.0999999999999,5,4,1,10,Loyal
2491,173,11,931.31,3,3,2,8,Regulars
2492,329,15,2370.82,2,5,4,11,At Risk
2493,376,11,2888.47,2,3,5,10,Regulars
2494,553,10,1056.23,1,3,2,6,Regulars
2495,428,8,1160.79,2,2,2,6,Hibernating
2496,35,15,1816.94,5,5,4,14,Champions
2497,18,10,2596.6099999999997,5,3,5,13,Loyal
2498,278,8,1542.46,2,2,3,7,Regulars
2499,1374,6,836.99,1,1,1,3,Hibernating
2500,41,11,685.52,5,3,1,9,Loyal
2501,12,8,2534.55,5,2,4,11,Big Spenders
2502,192,17,2477.68,3,5,4,12,Big Spenders
2503,111,7,4230.4800000000005,4,1,5,10,Big Spenders
2504,154,14,2291.2400000000002,3,5,4,12,Big Spenders
2505,1210,7,708.0799999999999,1,1,1,3,Hibernating
2506,216,7,931.2299999999999,3,1,2,6,Regulars
2507,197,12,1865.88,3,4,4,11,Big Spenders
2508,50,12,3330.91,5,4,5,14,Champions
2509,73,3,577.75,4,1,1,6,Regulars
2510,789,8,856.59,1,2,2,5,Hibernating
2511,415,10,763.81,2,3,1,6,Regulars
2512,12,12,2034.43,5,4,4,13,Champions
2513,13,10,1359.27,5,3,3,11,Loyal
2514,852,5,5531.629999999999,1,1,5,7,Regulars
2515,630,7,544.86,1,1,1,3,Hibernating
2516,187,13,1802.81,3,4,4,11,Big Spenders
2517,43,8,500.11,5,2,1,8,Regulars
2518,375,10,2135.17,2,3,4,9,Regulars
2519,430,6,1401.47,2,1,3,6,Regulars
2520,1004,10,1516.9099999999999,1,3,3,7,Regulars
2521,1397,5,342.63,1,1,1,3,Hibernating
2522,31,9,857.2799999999999,5,2,2,9,Regulars
2523,85,11,1498.49,4,3,3,10,Loyal
2524,206,8,679.98,3,2,1,6,Regulars
2525,284,9,2127.1,2,2,4,8,Regulars
2526,864,10,1993.7099999999998,1,3,4,8,Regulars
2527,97,7,741.25,4,1,1,6,Regulars
2528,103,13,2061.84,4,4,4,12,Champions
2529,625,13,1720.16,1,4,3,8,At Risk
2530,130,6,389.23,4,1,1,6,Regulars
2531,78,15,1553.81,4,5,3,12,Loyal
2532,746,4,1395.2999999999997,1,1,3,5,Regulars
2533,510,11,3410.48,1,3,5,9,Regulars
2534,84,9,977.08,4,2,2,8,Regulars
2535,203,12,1038.65,3,4,2,9,Regulars
2536,283,6,958.29,2,1,2,5,Hibernating
2537,30,15,2292.95,5,5,4,14,Champions
2538,46,14,1902.57,5,5,4,14,Champions
2539,87,10,1245.72,4,3,3,10,Loyal
2540,122,11,1057.3999999999999,4,3,2,9,Loyal
2541,1188,10,776.27,1,3,1,5,Regulars
2542,589,9,1101.06,1,2,2,5,Hibernating
2543,302,11,945.05,2,3,2,7,Regulars
2544,27,10,920.09,5,3,2,10,Loyal
2545,168,13,1645.41,3,4,3,10,Regulars
2546,231,8,1580.59,3,2,3,8,Regulars
2547,42,14,1494.55,5,5,3,13,Loyal
2548,77,8,1003.97,4,2,2,8,Regulars
2549,597,6,1958.4299999999998,1,1,4,6,Regulars
2550,291,15,1378.44,2,5,3,10,At Risk
2551,100,6,2249.4300000000003,4,1,4,9,Big Spenders
2552,109,3,228.8,4,1,1,6,Regulars
2553,190,5,203.43,3,1,1,5,Regulars
2554,541,7,739.24,1,1,1,3,Hibernating
2555,154,8,954.7700000000001,3,2,2,7,Regulars
2556,149,18,3119.16,3,5,5,13,Big Spenders
2557,104,10,1599.0,4,3,3,10,Loyal
2558,252,9,1032.81,2,2,2,6,Hibernating
2559,140,9,482.45,4,2,1,7,Regulars
2560,830,7,1560.2199999999998,1,1,3,5,Regulars
2561,40,9,1194.42,5,2,2,9,Regulars
2562,426,15,3429.7900000000004,2,5,5,12,At Risk
2563,165,12,4492.02,3,4,5,12,Big Spenders
2564,235,8,664.84,3,2,1,6,Regulars
2565,394,7,3196.6,2,1,5,8,Regulars
2566,299,16,1569.77,2,5,3,10,At Risk
2567,990,4,208.85999999999999,1,1,1,3,Hibernating
2568,309,10,1285.19,2,3,3,8,Regulars
2569,789,8,1057.68,1,2,2,5,Hibernating
2570,55,8,1496.54,5,2,3,10,Regulars
2571,110,9,1398.8999999999999,4,2,3,9,Regulars
2572,563,5,695.78,1,1,1,3,Hibernating
2573,414,13,1387.1100000000001,2,4,3,9,At Risk
2574,331,10,2248.58,2,3,4,9,Regulars
2575,185,13,1308.93,3,4,3,10,Regulars
2576,57,16,2514.07,5,5,4,14,Champions
2577,75,8,1104.3799999999999,4,2,2,8,Regulars
2578,297,13,2014.87,2,4,4,10,At Risk
2579,127,11,2908.91,4,3,5,12,Loyal
2580,286,9,1958.3400000000001,2,2,4,8,Regulars
2581,430,12,1586.5,2,4,3,9,At Risk
2582,23,13,3522.16,5,4,5,14,Champions
2583,22,11,2008.1399999999999,5,3,4,12,Loyal
2584,283,10,1228.0700000000002,2,3,2,7,Regulars
2585,197,11,1149.21,3,3,2,8,Regulars
2586,156,8,1114.27,3,2,2,7,Regulars
2587,346,11,692.73,2,3,1,6,Regulars
2588,116,12,2640.3199999999997,4,4,5,13,Champions
2589,191,11,1965.31,3,3,4,10,Big Spenders
2590,6,5,386.31,5,1,1,7,Regulars
2591,16,8,1244.92,5,2,3,10,Regulars
2592,453,14,4655.76,2,5,5,12,At Risk
2593,299,10,3374.97,2,3,5,10,Regulars
2594,230,15,2344.21,3,5,4,12,Big Spenders
2595,58,14,632.24,5,5,1,11,Loyal
2596,421,6,1422.0700000000002,2,1,3,6,Regulars
2597,1,9,1293.2199999999998,5,2,3,10,Regulars
2598,110,12,2804.12,4,4,5,13,Champions
2599,792,13,1698.3,1,4,3,8,At Risk
2600,671,6,318.08,1,1,1,3,Hibernating
2601,132,6,1330.8700000000001,4,1,3,8,Regulars
2602,25,12,1243.4699999999998,5,4,3,12,Loyal
2603,53,6,1586.15,5,1,3,9,Regulars
2604,30,10,1797.6599999999999,5,3,4,12,Loyal
2605,343,14,1343.82,2,5,3,10,At Risk
2606,62,13,1752.24,5,4,4,13,Champions
2607,111,15,1091.06,4,5,2,11,Loyal
2608,109,9,1312.75,4,2,3,9,Regulars
2609,87,20,1998.3,4,5,4,13,Champions
2610,524,7,1242.92,1,1,3,5,Regulars
2611,64,8,1311.93,5,2,3,10,Regulars
2612,285,9,2974.18,2,2,5,9,Regulars
2613,243,13,3267.6,3,4,5,12,Big Spenders
2614,91,5,782.78,4,1,1,6,Regulars
2615,19,14,2233.65,5,5,4,14,Champions
2616,462,9,1185.09,1,2,2,5,Hibernating
2617,153,13,1449.45,3,4,3,10,Regulars
2618,330,11,1209.34,2,3,2,7,Regulars
2619,501,13,3782.7200000000003,1,4,5,10,At Risk
2620,415,7,941.12,2,1,2,5,Hibernating
2621,177,16,3213.69,3,5,5,13,Big Spenders
2622,279,21,2218.62,2,5,4,11,At Risk
2623,153,12,1948.8799999999999,3,4,4,11,Big Spenders
2624,100,14,1806.02,4,5,4,13,Champions
2625,564,14,1408.41,1,5,3,9,At Risk
2626,335,13,1715.3500000000001,2,4,3,9,At Risk
2627,967,8,1252.4299999999998,1,2,3,6,Regulars
2628,255,10,1020.3299999999999,2,3,2,7,Regulars
2629,565,9,802.77,1,2,1,4,Hibernating
2630,279,10,870.28,2,3,2,7,Regulars
2631,404,7,818.54,2,1,1,4,Hibernating
2632,39,14,1875.05,5,5,4,14,Champions
2633,238,9,1241.56,3,2,3,8,Regulars
2634,190,7,2382.02,3,1,4,8,Big Spenders
2635,196,7,734.89,3,1,1,5,Regulars
2636,275,6,353.93999999999994,2,1,1,4,Hibernating
2637,424,12,3666.3600000000006,2,4,5,11,At Risk
2638,553,6,1727.5000000000002,1,1,4,6,Regulars
2639,108,12,3771.76,4,4,5,13,Champions
2640,56,6,1049.8899999999999,5,1,2,8,Regulars
2641,50,10,2753.13,5,3,5,13,Loyal
2642,658,11,3308.4700000000003,1,3,5,9,Regulars
2643,19,15,2411.28,5,5,4,14,Champions
2644,894,12,7304.870000000001,1,4,5,10,At Risk
2645,76,8,753.29,4,2,1,7,Regulars
2646,464,6,488.32,1,1,1,3,Hibernating
2647,109,8,876.86,4,2,2,8,Regulars
2648,101,8,872.33,4,2,2,8,Regulars
2649,101,6,1017.8199999999999,4,1,2,7,Regulars
2650,201,17,3696.1600000000003,3,5,5,13,Big Spenders
2651,968,5,568.55,1,1,1,3,Hibernating
2652,166,7,1518.4,3,1,3,7,Regulars
2653,704,8,845.4300000000001,1,2,2,5,Hibernating
2654,96,7,664.03,4,1,1,6,Regulars
2655,23,11,2428.13,5,3,4,12,Loyal
2656,446,18,3380.61,2,5,5,12,At Risk
2657,351,9,755.46,2,2,1,5,Hibernating
2658,661,7,951.45,1,1,2,4,Hibernating
2659,3,14,1527.44,5,5,3,13,Loyal
2660,577,6,323.40000000000003,1,1,1,3,Hibernating
2661,143,10,1907.87,4,3,4,11,Loyal
2662,42,13,1760.88,5,4,4,13,Champions
2663,322,10,1207.05,2,3,2,7,Regulars
2664,139,8,2438.08,4,2,4,10,Big Spenders
2665,90,5,284.78,4,1,1,6,Regulars
2666,48,12,2379.77,5,4,4,13,Champions
2667,121,14,3424.0600000000004,4,5,5,14,Champions
2668,34,8,944.7,5,2,2,9,Regulars
2669,913,9,703.22,1,2,1,4,Hibernating
2670,90,5,583.48,4,1,1,6,Regulars
2671,132,12,2514.6,4,4,4,12,Champions
2672,495,8,2764.73,1,2,5,8,Regulars
2673,138,13,941.5799999999999,4,4,2,10,Loyal
2674,530,5,663.3700000000001,1,1,1,3,Hibernating
2675,313,11,3457.47,2,3,5,10,Regulars
2676,31,12,1943.44,5,4,4,13,Champions
2677,213,6,1773.12,3,1,4,8,Big Spenders
2678,608,10,1033.68,1,3,2,6,Regulars
2679,131,9,777.15,4,2,1,7,Regulars
2680,215,11,3208.79,3,3,5,11,Big Spenders
2681,825,5,407.05,1,1,1,3,Hibernating
2682,42,11,1314.28,5,3,3,11,Loyal
2683,21,8,1469.82,5,2,3,10,Regulars
2684,508,11,1083.22,1,3,2,6,Regulars
2685,43,14,2369.46,5,5,4,14,Champions
2686,16,14,1165.01,5,5,2,12,Loyal
2687,779,11,1964.26,1,3,4,8,Regulars
2688,33,11,1360.88,5,3,3,11,Loyal
2689,7,9,2117.5899999999997,5,2,4,11,Big Spenders
2690,313,13,1220.25,2,4,2,8,At Risk
2691,10,9,719.5699999999999,5,2,1,8,Regulars
2692,143,7,205.82,4,1,1,6,Regulars
2693,102,13,2905.05,4,4,5,13,Champions
2694,111,11,2645.88,4,3,5,12,Loyal
2695,465,7,1209.41,1,1,2,4,Hibernating
2696,70,12,1807.94,4,4,4,12,Champions
2697,859,6,333.53,1,1,1,3,Hibernating
2698,138,6,388.49,4,1,1,6,Regulars
2699,181,6,840.98,3,1,1,5,Regulars
2700,110,9,705.83,4,2,1,7,Regulars
2701,148,15,4204.72,3,5,5,13,Big Spenders
2702,293,13,847.28,2,4,2,8,At Risk
2703,245,11,1322.11,3,3,3,9,Regulars
2704,362,14,1973.76,2,5,4,11,At Risk
2705,964,9,841.8699999999999,1,2,1,4,Hibernating
2706,681,6,777.48,1,1,1,3,Hibernating
2707,101,7,646.08,4,1,1,6,Regulars
2708,156,11,2336.27,3,3,4,10,Big Spenders
2709,43,10,899.77,5,3,2,10,Loyal
2710,65,8,1411.98,5,2,3,10,Regulars
2711,35,11,845.12,5,3,2,10,Loyal
2712,364,12,3142.65,2,4,5,11,At Risk
2713,457,9,2732.31,2,2,5,9,Regulars
2714,194,11,985.1800000000001,3,3,2,8,Regulars
2715,586,6,361.52,1,1,1,3,Hibernating
2716,20,19,3932.23,5,5,5,15,Champions
2717,595,10,1449.18,1,3,3,7,Regulars
2718,377,13,1421.6599999999999,2,4,3,9,At Risk
2719,187,15,1745.79,3,5,4,12,Big Spenders
2720,22,9,1073.49,5,2,2,9,Regulars
2721,23,8,1270.27,5,2,3,10,Regulars
2722,325,12,1771.17,2,4,4,10,At Risk
2723,564,13,1370.9499999999998,1,4,3,8,At Risk
2724,42,8,526.7,5,2,1,8,Regulars
2725,296,10,526.83,2,3,1,6,Regulars
2726,224,7,2237.04,3,1,4,8,Big Spenders
2727,203,14,6479.5599999999995,3,5,5,13,Big Spenders
2728,54,12,1821.6200000000001,5,4,4,13,Champions
2729,521,8,1712.55,1,2,3,6,Regulars
2730,99,11,1058.7,4,3,2,9,Loyal
2731,220,6,730.1899999999999,3,1,1,5,Regulars
2732,337,12,1897.46,2,4,4,10,At Risk
2733,43,10,2878.19,5,3,5,13,Loyal
2734,509,12,930.18,1,4,2,7,At Risk
2735,422,4,100.26,2,1,1,4,Hibernating
2736,161,14,1802.21,3,5,4,12,Big Spenders
2737,216,12,2033.67,3,4,4,11,Big Spenders
2738,110,12,4428.85,4,4,5,13,Champions
2739,119,17,5840.25,4,5,5,14,Champions
2740,547,11,1791.21,1,3,4,8,Regulars
2741,623,9,865.51,1,2,2,5,Hibernating
2742,1092,10,2022.27,1,3,4,8,Regulars
2743,104,12,1367.64,4,4,3,11,Loyal
2744,22,12,1444.58,5,4,3,12,Loyal
2745,33,6,839.2700000000001,5,1,1,7,Regulars
2746,58,10,938.8800000000001,5,3,2,10,Loyal
2747,252,9,2239.84,2,2,4,8,Regulars
2748,202,13,1254.41,3,4,3,10,Regulars
2749,30,12,1253.44,5,4,3,12,Loyal
2750,124,13,2951.78,4,4,5,13,Champions
2751,78,11,4221.61,4,3,5,12,Loyal
2752,443,8,606.07,2,2,1,5,Hibernating
2753,6,13,6232.67,5,4,5,14,Champions
2754,1345,3,246.82,1,1,1,3,Hibernating
2755,65,16,1465.92,5,5,3,13,Loyal
2756,84,14,1805.3500000000001,4,5,4,13,Champions
2757,213,16,4141.09,3,5,5,13,Big Spenders
2758,266,12,1075.56,2,4,2,8,At Risk
2759,182,7,598.49,3,1,1,5,Regulars
2760,20,8,936.7,5,2,2,9,Regulars
2761,119,6,389.28999999999996,4,1,1,6,Regulars
2762,156,7,806.2900000000001,3,1,1,5,Regulars
2763,144,6,1438.4799999999998,4,1,3,8,Regulars
2764,252,12,1213.1399999999999,2,4,2,8,At Risk
2765,395,11,1551.0,2,3,3,8,Regulars
2766,224,10,2213.78,3,3,4,10,Big Spenders
2767,83,10,2413.7200000000003,4,3,4,11,Loyal
2768,493,9,1431.23,1,2,3,6,Regulars
2769,117,6,665.72,4,1,1,6,Regulars
2770,8,12,1757.2400000000002,5,4,4,13,Champions
2771,244,8,492.57,3,2,1,6,Regulars
2772,58,7,1025.21,5,1,2,8,Regulars
2773,180,8,592.41,3,2,1,6,Regulars
2774,229,13,1548.46,3,4,3,10,Regulars
2775,263,15,3026.22,2,5,5,12,At Risk
2776,211,4,531.47,3,1,1,5,Regulars
2777,65,12,1438.61,5,4,3,12,Loyal
2778,99,11,2584.12,4,3,5,12,Loyal
2779,943,7,624.51,1,1,1,3,Hibernating
2780,192,14,4179.58,3,5,5,13,Big Spenders
2781,691,17,3000.92,1,5,5,11,At Risk
2782,303,14,996.21,2,5,2,9,At Risk
2783,55,10,1836.17,5,3,4,12,Loyal
2784,261,14,1881.28,2,5,4,11,At Risk
2785,234,6,984.19,3,1,2,6,Regulars
2786,383,12,986.38,2,4,2,8,At Risk
2787,45,13,4053.4200000000005,5,4,5,14,Champions
2788,61,14,1912.78,5,5,4,14,Champions
2789,851,11,1048.65,1,3,2,6,Regulars
2790,15,6,2773.35,5,1,5,11,Big Spenders
2791,127,8,3249.36,4,2,5,11,Big Spenders
2792,149,11,975.65,3,3,2,8,Regulars
2793,79,12,1090.53,4,4,2,10,Loyal
2794,484,13,1642.24,1,4,3,8,At Risk
2795,499,9,743.9300000000001,1,2,1,4,Hibernating
2796,263,15,1902.9399999999998,2,5,4,11,At Risk
2797,137,14,2472.28,4,5,4,13,Champions
2798,64,14,1199.82,5,5,2,12,Loyal
2799,90,13,3314.3100000000004,4,4,5,13,Champions
2800,91,14,1531.28,4,5,3,12,Loyal
2801,721,2,171.25,1,1,1,3,Hibernating
2802,44,6,358.58,5,1,1,7,Regulars
2803,167,8,476.44,3,2,1,6,Regulars
2804,13,17,1792.21,5,5,4,14,Champions
2805,1113,9,939.3100000000001,1,2,2,5,Hibernating
2806,341,7,702.91,2,1,1,4,Hibernating
2807,42,20,2442.89,5,5,4,14,Champions
2808,157,10,1868.16,3,3,4,10,Big Spenders
2809,54,15,4984.1,5,5,5,15,Champions
2810,312,11,3080.16,2,3,5,10,Regulars
2811,238,12,909.14,3,4,2,9,Regulars
2812,74,12,1605.24,4,4,3,11,Loyal
2813,966,2,230.67999999999998,1,1,1,3,Hibernating
2814,4,19,2814.18,5,5,5,15,Champions
2815,90,8,1064.99,4,2,2,8,Regulars
2816,30,14,7810.82,5,5,5,15,Champions
2817,263,9,2613.58,2,2,5,9,Regulars
2818,552,17,2292.4700000000003,1,5,4,10,At Risk
2819,377,9,2347.2200000000003,2,2,4,8,Regulars
2820,824,6,658.89,1,1,1,3,Hibernating
2821,75,14,2776.84,4,5,5,14,Champions
2822,834,1,181.89000000000001,1,1,1,3,Hibernating
2823,49,11,1782.24,5,3,4,12,Loyal
2824,117,12,1472.0600000000002,4,4,3,11,Loyal
2825,128,8,1434.69,4,2,3,9,Regulars
2826,1008,5,887.6800000000001,1,1,2,4,Hibernating
2827,514,6,742.2500000000001,1,1,1,3,Hibernating
2828,183,11,1205.03,3,3,2,8,Regulars
2829,77,13,1192.59,4,4,2,10,Loyal
2830,191,9,1082.29,3,2,2,7,Regulars
2831,59,9,1595.9,5,2,3,10,Regulars
2832,437,8,2300.75,2,2,4,8,Regulars
2833,84,13,1599.3700000000001,4,4,3,11,Loyal
2834,156,10,1320.6200000000001,3,3,3,9,Regulars
2835,848,7,1541.3700000000001,1,1,3,5,Regulars
2836,5,10,3172.0400000000004,5,3,5,13,Loyal
2837,201,9,1745.23,3,2,4,9,Big Spenders
2838,226,11,1096.75,3,3,2,8,Regulars
2839,764,10,3593.53,1,3,5,9,Regulars
2840,41,14,2163.1099999999997,5,5,4,14,Champions
2841,246,9,1823.2,3,2,4,9,Big Spenders
2842,189,12,1163.35,3,4,2,9,Regulars
2843,423,10,3066.8,2,3,5,10,Regulars
2844,328,5,746.9200000000001,2,1,1,4,Hibernating
2845,155,8,483.11,3,2,1,6,Regulars
2846,255,8,1739.38,2,2,4,8,Regulars
2847,710,6,846.6399999999999,1,1,2,4,Hibernating
2848,519,15,1494.35,1,5,3,9,At Risk
2849,144,14,1584.9099999999999,4,5,3,12,Loyal
2850,754,8,846.66,1,2,2,5,Hibernating
2851,263,13,1114.74,2,4,2,8,At Risk
2852,260,10,1966.28,2,3,4,9,Regulars
2853,198,11,2170.48,3,3,4,10,Big Spenders
2854,742,11,1841.23,1,3,4,8,Regulars
2855,441,12,1618.5,2,4,3,9,At Risk
2856,46,10,1484.91,5,3,3,11,Loyal
2857,138,12,2554.48,4,4,4,12,Champions
2858,198,9,1413.67,3,2,3,8,Regulars
2859,205,11,3113.33,3,3,5,11,Big Spenders
2860,1026,9,1119.27,1,2,2,5,Hibernating
2861,823,15,3144.75,1,5,5,11,At Risk
2862,339,9,5955.29,2,2,5,9,Regulars
2863,618,14,804.01,1,5,1,7,At Risk
2864,34,9,4441.54,5,2,5,12,Big Spenders
2865,721,7,796.59,1,1,1,3,Hibernating
2866,575,14,1058.4,1,5,2,8,At Risk
2867,199,10,1233.99,3,3,2,8,Regulars
2868,117,8,1299.31,4,2,3,9,Regulars
2869,504,10,1150.5,1,3,2,6,Regulars
2870,57,15,2427.0,5,5,4,14,Champions
2871,722,11,6539.09,1,3,5,9,Regulars
2872,407,9,821.57,2,2,1,5,Hibernating
2873,214,11,1220.86,3,3,2,8,Regulars
2874,678,7,958.8900000000001,1,1,2,4,Hibernating
2875,193,12,973.46,3,4,2,9,Regulars
2876,174,10,1380.02,3,3,3,9,Regulars
2877,707,10,994.28,1,3,2,6,Regulars
2878,429,6,1542.96,2,1,3,6,Regulars
2879,166,12,3189.0,3,4,5,12,Big Spenders
2880,105,8,816.53,4,2,1,7,Regulars
2881,51,10,745.98,5,3,1,9,Loyal
2882,101,16,4762.81,4,5,5,14,Champions
2883,116,9,897.77,4,2,2,8,Regulars
2884,88,11,1930.3899999999999,4,3,4,11,Loyal
2885,486,10,2344.3900000000003,1,3,4,8,Regulars
2886,16,8,3006.0,5,2,5,12,Big Spenders
2887,750,11,3418.35,1,3,5,9,Regulars
2888,650,11,826.4599999999999,1,3,1,5,Regulars
2889,768,6,1739.45,1,1,4,6,Regulars
2890,184,13,3629.5,3,4,5,12,Big Spenders
2891,582,11,1273.6,1,3,3,7,Regulars
2892,312,7,914.54,2,1,2,5,Hibernating
2893,635,10,2726.9300000000003,1,3,5,9,Regulars
2894,33,12,1515.47,5,4,3,12,Loyal
2895,460,6,1435.3,1,1,3,5,Regulars
2896,122,20,3761.02,4,5,5,14,Champions
2897,387,6,687.52,2,1,1,4,Hibernating
2898,188,6,875.6800000000001,3,1,2,6,Regulars
2899,65,13,3844.3900000000003,5,4,5,14,Champions
2900,100,11,1193.66,4,3,2,9,Loyal
2901,126,6,364.27,4,1,1,6,Regulars
2902,50,13,2355.49,5,4,4,13,Champions
2903,527,10,949.02,1,3,2,6,Regulars
2904,110,8,1633.96,4,2,3,9,Regulars
2905,24,11,2207.87,5,3,4,12,Loyal
2906,276,11,1063.1599999999999,2,3,2,7,Regulars
2907,36,6,2081.94,5,1,4,10,Big Spenders
2908,385,6,548.06,2,1,1,4,Hibernating
2909,29,8,2162.13,5,2,4,11,Big Spenders
2910,170,10,3374.63,3,3,5,11,Big Spenders
2911,662,10,758.65,1,3,1,5,Regulars
2912,12,6,551.24,5,1,1,7,Regulars
2913,140,5,843.51,4,1,1,6,Regulars
2914,287,7,2743.77,2,1,5,8,Regulars
2915,171,8,1320.97,3,2,3,8,Regulars
2916,265,8,3697.9,2,2,5,9,Regulars
2917,147,15,4116.34,4,5,5,14,Champions
2918,82,9,660.52,4,2,1,7,Regulars
2919,188,9,984.79,3,2,2,7,Regulars
2920,535,7,1005.6899999999999,1,1,2,4,Hibernating
2921,393,9,3512.5499999999997,2,2,5,9,Regulars
2922,272,7,767.15,2,1,1,4,Hibernating
2923,30,13,1485.25,5,4,3,12,Loyal
2924,331,10,2196.86,2,3,4,9,Regulars
2925,89,12,1814.54,4,4,4,12,Champions
2926,91,12,1050.08,4,4,2,10,Loyal
2927,185,8,2672.29,3,2,5,10,Big Spenders
2928,823,5,1043.28,1,1,2,4,Hibernating
2929,135,8,653.02,4,2,1,7,Regulars
2930,195,7,2415.34,3,1,4,8,Big Spenders
2931,589,6,938.55,1,1,2,4,Hibernating
2932,233,10,888.85,3,3,2,8,Regulars
2933,90,9,1427.77,4,2,3,9,Regulars
2934,15,10,2003.4999999999998,5,3,4,12,Loyal
2935,20,7,866.4,5,1,2,8,Regulars
2936,146,11,2267.9500000000003,4,3,4,11,Loyal
2937,349,10,3621.6299999999997,2,3,5,10,Regulars
2938,205,9,1271.51,3,2,3,8,Regulars
2939,83,10,1151.79,4,3,2,9,Loyal
2940,266,8,1274.27,2,2,3,7,Regulars
2941,127,15,2064.77,4,5,4,13,Champions
2942,615,6,547.36,1,1,1,3,Hibernating
2943,78,8,908.97,4,2,2,8,Regulars
2944,46,6,770.75,5,1,1,7,Regulars
2945,284,11,1420.49,2,3,3,8,Regulars
2946,975,7,1038.53,1,1,2,4,Hibernating
2947,35,13,3569.56,5,4,5,14,Champions
2948,88,12,2017.24,4,4,4,12,Champions
2949,31,17,2346.4700000000003,5,5,4,14,Champions
2950,243,9,1727.59,3,2,4,9,Big Spenders
2951,155,12,1569.73,3,4,3,10,Regulars
2952,207,19,2289.4700000000003,3,5,4,12,Big Spenders
2953,64,11,1967.0800000000002,5,3,4,12,Loyal
2954,160,15,2281.59,3,5,4,12,Big Spenders
2955,169,11,1052.78,3,3,2,8,Regulars
2956,368,12,2128.05,2,4,4,10,At Risk
2957,152,13,1128.66,3,4,2,9,Regulars
2958,107,10,1230.22,4,3,2,9,Loyal
2959,44,11,662.6,5,3,1,9,Loyal
2960,561,10,2629.81,1,3,5,9,Regulars
2961,121,11,1800.3799999999999,4,3,4,11,Loyal
2962,258,12,3847.96,2,4,5,11,At Risk
2963,280,11,1300.4499999999998,2,3,3,8,Regulars
2964,121,15,9184.51,4,5,5,14,Champions
2965,159,8,1467.02,3,2,3,8,Regulars
2966,724,8,1126.11,1,2,2,5,Hibernating
2967,77,11,1141.11,4,3,2,9,Loyal
2968,41,6,564.3,5,1,1,7,Regulars
2969,139,9,1044.05,4,2,2,8,Regulars
2970,441,11,1613.3700000000001,2,3,3,8,Regulars
2971,33,17,1384.14,5,5,3,13,Loyal
2972,540,5,441.84,1,1,1,3,Hibernating
2973,42,16,2346.33,5,5,4,14,Champions
2974,5,7,629.52,5,1,1,7,Regulars
2975,348,13,2844.73,2,4,5,11,At Risk
2976,40,12,2307.75,5,4,4,13,Champions
2977,134,8,1018.42,4,2,2,8,Regulars
2978,99,12,1269.62,4,4,3,11,Loyal
2979,147,8,884.21,4,2,2,8,Regulars
2980,325,10,790.92,2,3,1,6,Regulars
2981,149,13,2168.72,3,4,4,11,Big Spenders
2982,93,8,1282.99,4,2,3,9,Regulars
2983,1109,7,4003.23,1,1,5,7,Regulars
2984,135,7,1319.0700000000002,4,1,3,8,Regulars
2985,365,12,2165.8399999999997,2,4,4,10,At Risk
2986,328,15,1617.04,2,5,3,10,At Risk
2987,348,11,2418.97,2,3,4,9,Regulars
2988,77,4,295.4,4,1,1,6,Regulars
2989,520,8,1551.95,1,2,3,6,Regulars
2990,901,5,367.94,1,1,1,3,Hibernating
2991,756,4,1106.3400000000001,1,1,2,4,Hibernating
2992,65,14,1518.97,5,5,3,13,Loyal
2993,38,14,7021.68,5,5,5,15,Champions
2994,350,16,4483.04,2,5,5,12,At Risk
2995,238,12,3544.3399999999997,3,4,5,12,Big Spenders
2996,101,11,1928.25,4,3,4,11,Loyal
2997,91,11,1668.43,4,3,3,10,Loyal
2998,83,8,1320.19,4,2,3,9,Regulars
2999,204,12,1983.58,3,4,4,11,Big Spenders
3000,5,18,3336.16,5,5,5,15,Champions
3001,78,8,613.72,4,2,1,7,Regulars
3002,200,8,489.74,3,2,1,6,Regulars
3003,40,10,1232.42,5,3,2,10,Loyal
3004,549,7,1102.0700000000002,1,1,2,4,Hibernating
3005,374,6,647.03,2,1,1,4,Hibernating
3006,277,9,1181.8,2,2,2,6,Hibernating
3007,67,9,628.9100000000001,4,2,1,7,Regulars
3008,0,13,1184.6100000000001,5,4,2,11,Loyal
3009,683,7,738.9200000000001,1,1,1,3,Hibernating
3010,38,11,1778.8200000000002,5,3,4,12,Loyal
3011,114,10,5018.12,4,3,5,12,Loyal
3012,211,12,1049.23,3,4,2,9,Regulars
3013,85,7,887.3499999999999,4,1,2,7,Regulars
3014,630,7,406.77,1,1,1,3,Hibernating
3015,439,11,1832.19,2,3,4,9,Regulars
3016,58,11,3183.39,5,3,5,13,Loyal
3017,738,10,1726.47,1,3,4,8,Regulars
3018,42,9,585.24,5,2,1,8,Regulars
3019,14,9,2313.26,5,2,4,11,Big Spenders
3020,146,16,3138.9700000000003,4,5,5,14,Champions
3021,21,12,2691.92,5,4,5,14,Champions
3022,165,6,1792.97,3,1,4,8,Big Spenders
3023,152,12,2235.97,3,4,4,11,Big Spenders
3024,53,9,1069.3,5,2,2,9,Regulars
3025,515,13,1451.13,1,4,3,8,At Risk
3026,60,7,918.4100000000001,5,1,2,8,Regulars
3027,497,5,964.2600000000001,1,1,2,4,Hibernating
3028,195,13,2447.03,3,4,4,11,Big Spenders
3029,442,11,1089.85,2,3,2,7,Regulars
3030,33,10,691.21,5,3,1,9,Loyal
3031,211,15,2671.15,3,5,5,13,Big Spenders
3032,726,7,1718.91,1,1,3,5,Regulars
3033,55,11,3533.41,5,3,5,13,Loyal
3034,347,10,985.1899999999999,2,3,2,7,Regulars
3035,2,12,1159.7,5,4,2,11,Loyal
3036,350,4,905.6699999999998,2,1,2,5,Hibernating
3037,81,9,989.9,4,2,2,8,Regulars
3038,38,6,460.05,5,1,1,7,Regulars
3039,249,8,1203.91,2,2,2,6,Hibernating
3040,300,9,2010.78,2,2,4,8,Regulars
3041,959,10,1665.03,1,3,3,7,Regulars
3042,332,12,1540.4700000000003,2,4,3,9,At Risk
3043,16,4,1183.77,5,1,2,8,Regulars
3044,35,9,804.93,5,2,1,8,Regulars
3045,103,7,949.23,4,1,2,7,Regulars
3046,64,6,796.03,5,1,1,7,Regulars
3047,28,9,919.9300000000001,5,2,2,9,Regulars
3048,278,15,3573.64,2,5,5,12,At Risk
3049,201,14,1997.92,3,5,4,12,Big Spenders
3050,175,15,2742.17,3,5,5,13,Big Spenders
3051,728,5,419.63000000000005,1,1,1,3,Hibernating
3052,90,11,3117.16,4,3,5,12,Loyal
3053,81,18,5124.0,4,5,5,14,Champions
3054,158,8,1484.1399999999999,3,2,3,8,Regulars
3055,308,10,1095.9699999999998,2,3,2,7,Regulars
3056,90,11,3357.8100000000004,4,3,5,12,Loyal
3057,46,9,968.89,5,2,2,9,Regulars
3058,172,12,1398.69,3,4,3,10,Regulars
3059,421,14,2502.71,2,5,4,11,At Risk
3060,1160,5,862.8000000000001,1,1,2,4,Hibernating
3061,332,13,1336.31,2,4,3,9,At Risk
3062,21,6,1265.54,5,1,3,9,Regulars
3063,30,9,678.03,5,2,1,8,Regulars
3064,104,9,796.64,4,2,1,7,Regulars
3065,210,10,1103.14,3,3,2,8,Regulars
3066,105,13,3017.19,4,4,5,13,Champions
3067,47,10,1143.0900000000001,5,3,2,10,Loyal
3068,737,7,1454.9399999999998,1,1,3,5,Regulars
3069,30,6,2381.89,5,1,4,10,Big Spenders
3070,506,8,1567.04,1,2,3,6,Regulars
3071,1082,6,792.37,1,1,1,3,Hibernating
3072,125,12,1305.38,4,4,3,11,Loyal
3073,661,9,1168.65,1,2,2,5,Hibernating
3074,438,8,1301.55,2,2,3,7,Regulars
3075,140,10,874.89,4,3,2,9,Loyal
3076,181,21,2212.03,3,5,4,12,Big Spenders
3077,52,16,2000.91,5,5,4,14,Champions
3078,442,12,924.7400000000001,2,4,2,8,At Risk
3079,144,13,3451.84,4,4,5,13,Champions
3080,275,9,2142.55,2,2,4,8,Regulars
3081,1406,5,404.89,1,1,1,3,Hibernating
3082,373,6,1326.29,2,1,3,6,Regulars
3083,189,10,2528.87,3,3,4,10,Big Spenders
3084,553,15,1379.91,1,5,3,9,At Risk
3085,591,12,1256.95,1,4,3,8,At Risk
3086,141,9,1746.3300000000002,4,2,4,10,Big Spenders
3087,510,7,1009.34,1,1,2,4,Hibernating
3088,347,6,345.57,2,1,1,4,Hibernating
3089,165,8,404.44000000000005,3,2,1,6,Regulars
3090,195,10,925.68,3,3,2,8,Regulars
3091,82,12,3347.1,4,4,5,13,Champions
3092,270,8,854.28,2,2,2,6,Hibernating
3093,140,10,3295.62,4,3,5,12,Loyal
3094,131,14,1322.85,4,5,3,12,Loyal
3095,235,11,2626.74,3,3,5,11,Big Spenders
3096,7,6,485.65999999999997,5,1,1,7,Regulars
3097,105,9,1666.9299999999998,4,2,3,9,Regulars
3098,691,9,1227.2600000000002,1,2,2,5,Hibernating
3099,188,9,788.65,3,2,1,6,Regulars
3100,531,8,1203.31,1,2,2,5,Hibernating
3101,840,6,468.51,1,1,1,3,Hibernating
3102,583,11,2756.12,1,3,5,9,Regulars
3103,207,10,1193.51,3,3,2,8,Regulars
3104,129,10,1272.63,4,3,3,10,Loyal
3105,6,15,1972.81,5,5,4,14,Champions
3106,347,9,3525.3300000000004,2,2,5,9,Regulars
3107,196,8,2366.49,3,2,4,9,Big Spenders
3108,176,18,2228.77,3,5,4,12,Big Spenders
3109,246,13,2561.78,3,4,4,11,Big Spenders
3110,1014,7,667.9200000000001,1,1,1,3,Hibernating
3111,0,10,1311.79,5,3,3,11,Loyal
3112,3,8,4131.3,5,2,5,12,Big Spenders
3113,29,13,2148.0,5,4,4,13,Champions
3114,104,10,1871.9,4,3,4,11,Loyal
3115,266,10,2204.13,2,3,4,9,Regulars
3116,210,13,1038.51,3,4,2,9,Regulars
3117,64,21,4440.650000000001,5,5,5,15,Champions
3118,510,9,2406.54,1,2,4,7,Regulars
3119,672,7,842.0300000000001,1,1,1,3,Hibernating
3120,190,9,669.6,3,2,1,6,Regulars
3121,178,11,1359.95,3,3,3,9,Regulars
3122,91,7,735.57,4,1,1,6,Regulars
3123,1032,8,704.15,1,2,1,4,Hibernating
3124,363,7,4815.53,2,1,5,8,Regulars
3125,35,13,5166.76,5,4,5,14,Champions
3126,93,8,898.44,4,2,2,8,Regulars
3127,744,7,1549.21,1,1,3,5,Regulars
3128,82,12,4083.97,4,4,5,13,Champions
3129,128,12,1472.1399999999999,4,4,3,11,Loyal
3130,126,17,5472.0199999999995,4,5,5,14,Champions
3131,124,10,1494.7,4,3,3,10,Loyal
3132,881,10,1592.48,1,3,3,7,Regulars
3133,382,10,892.88,2,3,2,7,Regulars
3134,49,15,2566.79,5,5,4,14,Champions
3135,152,15,1973.0,3,5,4,12,Big Spenders
3136,153,11,2248.2200000000003,3,3,4,10,Big Spenders
3137,172,11,820.2,3,3,1,7,Regulars
3138,145,8,2299.45,4,2,4,10,Big Spenders
3139,855,10,1168.96,1,3,2,6,Regulars
3140,93,14,2452.5,4,5,4,13,Champions
3141,129,11,599.42,4,3,1,8,Loyal
3142,58,16,2875.6,5,5,5,15,Champions
3143,316,8,419.77,2,2,1,5,Hibernating
3144,708,8,633.57,1,2,1,4,Hibernating
3145,374,10,1340.69,2,3,3,8,Regulars
3146,126,7,1592.0700000000002,4,1,3,8,Regulars
3147,691,9,4310.14,1,2,5,8,Regulars
3148,138,12,2906.93,4,4,5,13,Champions
3149,197,14,2438.4,3,5,4,12,Big Spenders
3150,12,10,6097.54,5,3,5,13,Loyal
3151,259,11,3312.5,2,3,5,10,Regulars
3152,834,5,2543.1800000000003,1,1,4,6,Regulars
3153,1099,5,312.75,1,1,1,3,Hibernating
3154,88,20,2123.04,4,5,4,13,Champions
3155,90,12,2989.19,4,4,5,13,Champions
3156,23,13,3715.37,5,4,5,14,Champions
3157,1603,3,363.01,1,1,1,3,Hibernating
3158,441,7,3449.4500000000003,2,1,5,8,Regulars
3159,141,7,3036.41,4,1,5,10,Big Spenders
3160,253,10,880.94,2,3,2,7,Regulars
3161,155,12,668.12,3,4,1,8,Regulars
3162,42,11,1150.56,5,3,2,10,Loyal
3163,209,11,1809.58,3,3,4,10,Big Spenders
3164,36,12,2144.76,5,4,4,13,Champions
3165,195,11,1343.31,3,3,3,9,Regulars
3166,233,19,2597.77,3,5,5,13,Big Spenders
3167,134,10,2040.85,4,3,4,11,Loyal
3168,72,13,1465.18,4,4,3,11,Loyal
3169,327,8,1256.89,2,2,3,7,Regulars
3170,120,13,1624.56,4,4,3,11,Loyal
3171,30,14,2363.35,5,5,4,14,Champions
3172,116,8,1617.79,4,2,3,9,Regulars
3173,122,12,1149.31,4,4,2,10,Loyal
3174,175,3,396.24,3,1,1,5,Regulars
3175,147,12,2270.6,4,4,4,12,Champions
3176,198,9,936.38,3,2,2,7,Regulars
3177,22,15,1388.81,5,5,3,13,Loyal
3178,344,11,901.89,2,3,2,7,Regulars
3179,333,9,2191.03,2,2,4,8,Regulars
3180,18,9,3957.32,5,2,5,12,Big Spenders
3181,132,15,3451.89,4,5,5,14,Champions
3182,183,15,1989.52,3,5,4,12,Big Spenders
3183,208,14,4663.01,3,5,5,13,Big Spenders
3184,151,11,1468.3,3,3,3,9,Regulars
3185,115,10,839.1,4,3,1,8,Loyal
3186,442,9,1048.8799999999999,2,2,2,6,Hibernating
3187,93,11,1104.96,4,3,2,9,Loyal
3188,21,9,714.7,5,2,1,8,Regulars
3189,262,7,737.96,2,1,1,4,Hibernating
3190,195,8,4283.759999999999,3,2,5,10,Big Spenders
3191,180,10,3568.94,3,3,5,11,Big Spenders
3192,108,14,1206.63,4,5,2,11,Loyal
3193,672,5,752.83,1,1,1,3,Hibernating
3194,271,9,868.89,2,2,2,6,Hibernating
3195,600,10,3159.21,1,3,5,9,Regulars
3196,887,11,4660.78,1,3,5,9,Regulars
3197,73,17,2109.63,4,5,4,13,Champions
3198,272,9,735.08,2,2,1,5,Hibernating
3199,610,5,788.54,1,1,1,3,Hibernating
3200,128,9,1826.6399999999999,4,2,4,10,Big Spenders
3201,89,8,599.52,4,2,1,7,Regulars
3202,305,8,1534.6499999999999,2,2,3,7,Regulars
3203,254,14,2867.59,2,5,5,12,At Risk
3204,268,15,1677.81,2,5,3,10,At Risk
3205,105,9,1000.9100000000001,4,2,2,8,Regulars
3206,64,13,1347.16,5,4,3,12,Loyal
3207,292,11,3404.77,2,3,5,10,Regulars
3208,9,6,697.95,5,1,1,7,Regulars
3209,123,8,699.1,4,2,1,7,Regulars
3210,265,13,1535.97,2,4,3,9,At Risk
3211,52,13,4764.4,5,4,5,14,Champions
3212,59,18,2129.24,5,5,4,14,Champions
3213,356,9,1074.07,2,2,2,6,Hibernating
3214,224,12,1818.5500000000002,3,4,4,11,Big Spenders
3215,128,12,1361.35,4,4,3,11,Loyal
3216,395,12,2230.74,2,4,4,10,At Risk
3217,6,9,637.93,5,2,1,8,Regulars
3218,445,11,727.45,2,3,1,6,Regulars
3219,325,8,1229.45,2,2,2,6,Hibernating
3220,315,8,1302.56,2,2,3,7,Regulars
3221,271,12,4505.429999999999,2,4,5,11,At Risk
3222,57,15,1944.06,5,5,4,14,Champions
3223,578,7,595.16,1,1,1,3,Hibernating
3224,245,9,2925.05,3,2,5,10,Big Spenders
3225,228,8,841.95,3,2,1,6,Regulars
3226,81,10,1196.58,4,3,2,9,Loyal
3227,220,12,1563.04,3,4,3,10,Regulars
3228,103,16,5106.32,4,5,5,14,Champions
3229,233,8,955.86,3,2,2,7,Regulars
3230,481,10,868.78,1,3,2,6,Regulars
3231,255,7,2207.51,2,1,4,7,Regulars
3232,803,7,2789.7799999999997,1,1,5,7,Regulars
3233,89,9,429.93,4,2,1,7,Regulars
3234,54,12,1585.68,5,4,3,12,Loyal
3235,237,6,615.31,3,1,1,5,Regulars
3236,42,13,2341.12,5,4,4,13,Champions
3237,286,5,314.54999999999995,2,1,1,4,Hibernating
3238,19,14,1150.85,5,5,2,12,Loyal
3239,139,12,1259.94,4,4,3,11,Loyal
3240,543,10,1202.1100000000001,1,3,2,6,Regulars
3241,54,15,1617.64,5,5,3,13,Loyal
3242,495,9,993.6,1,2,2,5,Hibernating
3243,122,8,1780.58,4,2,4,10,Big Spenders
3244,262,10,919.3199999999999,2,3,2,7,Regulars
3245,128,8,932.22,4,2,2,8,Regulars
3246,487,16,2556.06,1,5,4,10,At Risk
3247,30,10,2066.1000000000004,5,3,4,12,Loyal
3248,230,10,2234.41,3,3,4,10,Big Spenders
3249,703,10,2804.64,1,3,5,9,Regulars
3250,185,16,1548.4,3,5,3,11,Regulars
3251,57,12,1747.76,5,4,4,13,Champions
3252,1180,10,1161.26,1,3,2,6,Regulars
3253,71,7,3939.41,4,1,5,10,Big Spenders
3254,65,8,723.8,5,2,1,8,Regulars
3255,417,11,1138.71,2,3,2,7,Regulars
3256,64,14,1264.8500000000001,5,5,3,13,Loyal
3257,1077,6,719.52,1,1,1,3,Hibernating
3258,85,10,2228.75,4,3,4,11,Loyal
3259,12,11,1314.05,5,3,3,11,Loyal
3260,111,12,1323.85,4,4,3,11,Loyal
3261,944,10,1923.03,1,3,4,8,Regulars
3262,214,9,1258.92,3,2,3,8,Regulars
3263,18,10,1754.69,5,3,4,12,Loyal
3264,22,12,970.77,5,4,2,11,Loyal
3265,22,11,801.29,5,3,1,9,Loyal
3266,225,6,196.79,3,1,1,5,Regulars
3267,292,11,2534.3199999999997,2,3,4,9,Regulars
3268,375,7,1158.8799999999999,2,1,2,5,Hibernating
3269,19,9,2492.7799999999997,5,2,4,11,Big Spenders
3270,77,15,3395.7,4,5,5,14,Champions
3271,199,10,1066.45,3,3,2,8,Regulars
3272,120,6,672.87,4,1,1,6,Regulars
3273,183,12,1937.78,3,4,4,11,Big Spenders
3274,93,9,1296.39,4,2,3,9,Regulars
3275,231,7,1275.17,3,1,3,7,Regulars
3276,74,16,1100.5900000000001,4,5,2,11,Loyal
3277,102,13,1985.0700000000002,4,4,4,12,Champions
3278,154,10,1111.59,3,3,2,8,Regulars
3279,122,11,3682.68,4,3,5,12,Loyal
3280,72,12,1416.44,4,4,3,11,Loyal
3281,291,9,1255.52,2,2,3,7,Regulars
3282,382,10,792.78,2,3,1,6,Regulars
3283,99,12,1871.9099999999999,4,4,4,12,Champions
3284,645,7,489.82000000000005,1,1,1,3,Hibernating
3285,8,12,2574.62,5,4,5,14,Champions
3286,332,8,1075.3799999999999,2,2,2,6,Hibernating
3287,266,10,1518.3300000000002,2,3,3,8,Regulars
3288,266,10,2709.17,2,3,5,10,Regulars
3289,152,12,1676.95,3,4,3,10,Regulars
3290,653,6,367.86,1,1,1,3,Hibernating
3291,426,8,945.8100000000001,2,2,2,6,Hibernating
3292,80,14,3641.33,4,5,5,14,Champions
3293,150,8,947.88,3,2,2,7,Regulars
3294,174,13,5512.51,3,4,5,12,Big Spenders
3295,499,9,781.12,1,2,1,4,Hibernating
3296,19,6,796.37,5,1,1,7,Regulars
3297,19,16,3354.37,5,5,5,15,Champions
3298,30,18,3482.18,5,5,5,15,Champions
3299,223,20,7701.87,3,5,5,13,Big Spenders
3300,261,10,1180.08,2,3,2,7,Regulars
3301,321,12,1009.94,2,4,2,8,At Risk
3302,400,13,5323.16,2,4,5,11,At Risk
3303,378,12,1980.36,2,4,4,10,At Risk
3304,30,11,2488.8599999999997,5,3,4,12,Loyal
3305,172,10,2497.29,3,3,4,10,Big Spenders
3306,91,9,685.24,4,2,1,7,Regulars
3307,281,8,854.21,2,2,2,6,Hibernating
3308,59,10,861.94,5,3,2,10,Loyal
3309,455,13,1713.2599999999998,2,4,3,9,At Risk
3310,71,12,1458.73,4,4,3,11,Loyal
3311,167,5,222.19,3,1,1,5,Regulars
3312,216,9,2635.32,3,2,5,10,Big Spenders
3313,243,15,1012.11,3,5,2,10,Regulars
3314,250,11,2515.74,2,3,4,9,Regulars
3315,135,10,376.57,4,3,1,8,Loyal
3316,571,7,1230.66,1,1,2,4,Hibernating
3317,235,3,485.69,3,1,1,5,Regulars
3318,82,12,2756.96,4,4,5,13,Champions
3319,68,2,259.26,4,1,1,6,Regulars
3320,7,9,740.28,5,2,1,8,Regulars
3321,99,7,511.77,4,1,1,6,Regulars
3322,56,13,1676.61,5,4,3,12,Loyal
3323,419,6,620.4300000000001,2,1,1,4,Hibernating
3324,897,12,2040.81,1,4,4,9,At Risk
3325,192,15,3024.34,3,5,5,13,Big Spenders
3326,151,11,1393.95,3,3,3,9,Regulars
3327,972,7,2836.5400000000004,1,1,5,7,Regulars
3328,168,7,877.4000000000001,3,1,2,6,Regulars
3329,186,11,2655.18,3,3,5,11,Big Spenders
3330,251,5,408.46000000000004,2,1,1,4,Hibernating
3331,469,6,1230.08,1,1,2,4,Hibernating
3332,289,15,2687.79,2,5,5,12,At Risk
3333,552,8,1054.48,1,2,2,5,Hibernating
3334,627,2,114.04,1,1,1,3,Hibernating
3335,277,11,3180.2200000000003,2,3,5,10,Regulars
3336,108,5,3876.0600000000004,4,1,5,10,Big Spenders
3337,75,12,1529.28,4,4,3,11,Loyal
3338,196,8,1396.98,3,2,3,8,Regulars
3339,119,14,2912.05,4,5,5,14,Champions
3340,322,6,808.6200000000001,2,1,1,4,Hibernating
3341,39,6,1428.19,5,1,3,9,Regulars
3342,301,12,1580.1399999999999,2,4,3,9,At Risk
3343,73,11,639.24,4,3,1,8,Loyal
3344,99,12,864.5,4,4,2,10,Loyal
3345,575,11,679.09,1,3,1,5,Regulars
3346,132,16,2953.3,4,5,5,14,Champions
3347,217,8,1227.88,3,2,2,7,Regulars
3348,230,14,2142.17,3,5,4,12,Big Spenders
3349,701,6,308.46,1,1,1,3,Hibernating
3350,369,8,1274.97,2,2,3,7,Regulars
3351,129,14,1148.76,4,5,2,11,Loyal
3352,1176,10,969.27,1,3,2,6,Regulars
3353,269,15,4755.78,2,5,5,12,At Risk
3354,129,6,592.53,4,1,1,6,Regulars
3355,114,6,658.06,4,1,1,6,Regulars
3356,112,12,1177.2199999999998,4,4,2,10,Loyal
3357,23,13,2059.82,5,4,4,13,Champions
3358,21,10,1609.74,5,3,3,11,Loyal
3359,79,9,2017.42,4,2,4,10,Big Spenders
3360,75,15,1543.02,4,5,3,12,Loyal
3361,44,5,258.42,5,1,1,7,Regulars
3362,357,12,3104.92,2,4,5,11,At Risk
3363,88,11,2410.55,4,3,4,11,Loyal
3364,15,9,645.51,5,2,1,8,Regulars
3365,818,6,2597.59,1,1,5,7,Regulars
3366,30,10,899.56,5,3,2,10,Loyal
3367,209,15,2727.15,3,5,5,13,Big Spenders
3368,74,13,1032.74,4,4,2,10,Loyal
3369,258,10,991.88,2,3,2,7,Regulars
3370,440,12,2072.1800000000003,2,4,4,10,At Risk
3371,886,6,966.6800000000001,1,1,2,4,Hibernating
3372,98,8,1186.52,4,2,2,8,Regulars
3373,346,15,1901.66,2,5,4,11,At Risk
3374,196,16,1508.85,3,5,3,11,Regulars
3375,391,11,1641.27,2,3,3,8,Regulars
3376,185,11,866.02,3,3,2,8,Regulars
3377,246,14,2848.5699999999997,3,5,5,13,Big Spenders
3378,220,11,1056.06,3,3,2,8,Regulars
3379,148,10,1422.05,3,3,3,9,Regulars
3380,642,3,58.41,1,1,1,3,Hibernating
3381,185,14,1622.42,3,5,3,11,Regulars
3382,67,15,3172.9300000000003,4,5,5,14,Champions
3383,26,11,3107.5499999999997,5,3,5,13,Loyal
3384,93,5,206.98,4,1,1,6,Regulars
3385,479,14,1604.75,1,5,3,9,At Risk
3386,343,14,1140.24,2,5,2,9,At Risk
3387,1186,5,353.24,1,1,1,3,Hibernating
3388,166,12,1450.3200000000002,3,4,3,10,Regulars
3389,593,10,1049.99,1,3,2,6,Regulars
3390,3,11,703.39,5,3,1,9,Loyal
3391,168,10,1101.65,3,3,2,8,Regulars
3392,22,10,3760.75,5,3,5,13,Loyal
3393,152,10,1463.49,3,3,3,9,Regulars
3394,292,13,939.95,2,4,2,8,At Risk
3395,181,10,1282.4299999999998,3,3,3,9,Regulars
3396,49,7,363.87,5,1,1,7,Regulars
3397,28,7,1052.38,5,1,2,8,Regulars
3398,476,7,554.8199999999999,1,1,1,3,Hibernating
3399,510,18,3413.92,1,5,5,11,At Risk
3400,708,9,814.89,1,2,1,4,Hibernating
3401,154,11,1005.0,3,3,2,8,Regulars
3402,15,17,1608.64,5,5,3,13,Loyal
3403,82,7,258.39,4,1,1,6,Regulars
3404,1020,10,827.4399999999999,1,3,1,5,Regulars
3405,516,7,1155.49,1,1,2,4,Hibernating
3406,92,8,1474.01,4,2,3,9,Regulars
3407,312,14,2820.27,2,5,5,12,At Risk
3408,217,8,2209.2200000000003,3,2,4,9,Big Spenders
3409,49,11,4484.0,5,3,5,13,Loyal
3410,1080,7,738.9200000000001,1,1,1,3,Hibernating
3411,147,11,1145.9099999999999,4,3,2,9,Loyal
3412,1295,4,2317.4700000000003,1,1,4,6,Regulars
3413,569,11,4710.16,1,3,5,9,Regulars
3414,1638,6,638.74,1,1,1,3,Hibernating
3415,22,14,4183.6,5,5,5,15,Champions
3416,151,16,1969.3600000000001,3,5,4,12,Big Spenders
3417,47,15,2398.9900000000002,5,5,4,14,Champions
3418,425,10,1718.14,2,3,3,8,Regulars
3419,221,7,3194.6000000000004,3,1,5,9,Big Spenders
3420,349,11,1496.8899999999999,2,3,3,8,Regulars
3421,31,10,3259.8,5,3,5,13,Loyal
3422,382,6,700.15,2,1,1,4,Hibernating
3423,132,14,1344.14,4,5,3,12,Loyal
3424,398,12,3069.6099999999997,2,4,5,11,At Risk
3425,153,11,789.88,3,3,1,7,Regulars
3426,445,6,3253.26,2,1,5,8,Regulars
3427,113,10,1996.5800000000002,4,3,4,11,Loyal
3428,212,10,4309.51,3,3,5,11,Big Spenders
3429,85,7,1469.99,4,1,3,8,Regulars
3430,246,11,1250.03,3,3,3,9,Regulars
3431,67,13,3379.5099999999998,4,4,5,13,Champions
3432,58,14,3108.71,5,5,5,15,Champions
3433,16,12,3530.53,5,4,5,14,Champions
3434,66,12,3681.34,4,4,5,13,Champions
3435,264,8,749.45,2,2,1,5,Hibernating
3436,870,11,2239.55,1,3,4,8,Regulars
3437,545,4,297.54,1,1,1,3,Hibernating
3438,295,8,3025.7500000000005,2,2,5,9,Regulars
3439,138,14,1229.33,4,5,2,11,Loyal
3440,470,14,1909.77,1,5,4,10,At Risk
3441,142,9,1376.28,4,2,3,9,Regulars
3442,75,16,2308.67,4,5,4,13,Champions
3443,198,11,1172.26,3,3,2,8,Regulars
3444,41,9,5243.11,5,2,5,12,Big Spenders
3445,583,13,1243.47,1,4,3,8,At Risk
3446,156,14,1358.77,3,5,3,11,Regulars
3447,287,11,750.84,2,3,1,6,Regulars
3448,473,4,279.92,1,1,1,3,Hibernating
3449,165,8,905.3199999999999,3,2,2,7,Regulars
3450,172,15,951.24,3,5,2,10,Regulars
3451,89,14,1621.37,4,5,3,12,Loyal
3452,392,8,1738.2,2,2,4,8,Regulars
3453,365,15,4565.6,2,5,5,12,At Risk
3454,286,8,1115.73,2,2,2,6,Hibernating
3455,31,10,1876.75,5,3,4,12,Loyal
3456,281,8,610.49,2,2,1,5,Hibernating
3457,290,10,2171.97,2,3,4,9,Regulars
3458,84,10,1690.3400000000001,4,3,3,10,Loyal
3459,271,6,553.1800000000001,2,1,1,4,Hibernating
3460,97,10,1069.8,4,3,2,9,Loyal
3461,309,6,2773.85,2,1,5,8,Regulars
3462,10,13,1018.37,5,4,2,11,Loyal
3463,421,7,1814.3700000000001,2,1,4,7,Regulars
3464,34,10,1548.55,5,3,3,11,Loyal
3465,470,10,3696.3599999999997,1,3,5,9,Regulars
3466,41,10,2266.06,5,3,4,12,Loyal
3467,16,13,1329.56,5,4,3,12,Loyal
3468,191,12,1264.44,3,4,3,10,Regulars
3469,42,17,5203.28,5,5,5,15,Champions
3470,621,12,1570.45,1,4,3,8,At Risk
3471,1453,5,346.90999999999997,1,1,1,3,Hibernating
3472,286,6,1605.8300000000002,2,1,3,6,Regulars
3473,357,7,3082.72,2,1,5,8,Regulars
3474,175,9,741.23,3,2,1,6,Regulars
3475,337,7,3291.14,2,1,5,8,Regulars
3476,21,11,1872.77,5,3,4,12,Loyal
3477,162,10,1974.33,3,3,4,10,Big Spenders
3478,56,11,1265.53,5,3,3,11,Loyal
3479,293,12,1516.2,2,4,3,9,At Risk
3480,74,9,1311.54,4,2,3,9,Regulars
3481,764,12,1366.05,1,4,3,8,At Risk
3482,46,9,3711.75,5,2,5,12,Big Spenders
3483,101,14,5239.9400000000005,4,5,5,14,Champions
3484,191,9,1055.42,3,2,2,7,Regulars
3485,317,9,1036.42,2,2,2,6,Hibernating
3486,910,14,1746.02,1,5,4,10,At Risk
3487,150,13,864.38,3,4,2,9,Regulars
3488,208,13,3508.03,3,4,5,12,Big Spenders
3489,152,12,1525.93,3,4,3,10,Regulars
3490,151,11,2350.16,3,3,4,10,Big Spenders
3491,218,12,1256.21,3,4,3,10,Regulars
3492,1022,4,425.46,1,1,1,3,Hibernating
3493,415,8,1385.02,2,2,3,7,Regulars
3494,208,15,3592.0699999999997,3,5,5,13,Big Spenders
3495,50,7,739.3299999999999,5,1,1,7,Regulars
3496,524,10,1578.51,1,3,3,7,Regulars
3497,82,15,3592.3900000000003,4,5,5,14,Champions
3498,665,9,3231.09,1,2,5,8,Regulars
3499,200,16,1632.81,3,5,3,11,Regulars
3500,4,14,1246.9099999999999,5,5,3,13,Loyal
3501,148,9,438.09999999999997,3,2,1,6,Regulars
3502,14,9,1068.25,5,2,2,9,Regulars
3503,478,12,1342.07,1,4,3,8,At Risk
3504,134,13,1905.12,4,4,4,12,Champions
3505,299,14,1598.97,2,5,3,10,At Risk
3506,163,11,1605.81,3,3,3,9,Regulars
3507,509,8,1034.19,1,2,2,5,Hibernating
3508,216,11,1966.4099999999999,3,3,4,10,Big Spenders
3509,150,11,3238.01,3,3,5,11,Big Spenders
3510,40,14,1540.72,5,5,3,13,Loyal
3511,26,15,1507.13,5,5,3,13,Loyal
3512,560,5,466.69,1,1,1,3,Hibernating
3513,90,10,2453.44,4,3,4,11,Loyal
3514,50,7,1332.14,5,1,3,9,Regulars
3515,504,10,2702.4,1,3,5,9,Regulars
3516,209,14,3997.4299999999994,3,5,5,13,Big Spenders
3517,811,14,685.98,1,5,1,7,At Risk
3518,32,21,2087.09,5,5,4,14,Champions
3519,492,6,534.22,1,1,1,3,Hibernating
3520,424,12,1254.25,2,4,3,9,At Risk
3521,61,11,1672.22,5,3,3,11,Loyal
3522,168,8,758.38,3,2,1,6,Regulars
3523,207,16,4464.58,3,5,5,13,Big Spenders
3524,528,8,3148.89,1,2,5,8,Regulars
3525,37,7,1980.1000000000001,5,1,4,10,Big Spenders
3526,668,10,780.98,1,3,1,5,Regulars
3527,739,9,3188.03,1,2,5,8,Regulars
3528,546,12,2599.0699999999997,1,4,5,10,At Risk
3529,513,13,2013.0699999999997,1,4,4,9,At Risk
3530,157,12,1458.49,3,4,3,10,Regulars
3531,290,9,1141.91,2,2,2,6,Hibernating
3532,106,12,1944.0500000000002,4,4,4,12,Champions
3533,600,7,1136.92,1,1,2,4,Hibernating
3534,0,6,1334.12,5,1,3,9,Regulars
3535,344,9,3031.79,2,2,5,9,Regulars
3536,83,11,3160.5800000000004,4,3,5,12,Loyal
3537,705,4,872.59,1,1,2,4,Hibernating
3538,64,10,1183.48,5,3,2,10,Loyal
3539,5,10,852.54,5,3,2,10,Loyal
3540,91,13,1719.7599999999998,4,4,3,11,Loyal
3541,30,5,3042.26,5,1,5,11,Big Spenders
3542,232,12,1999.3,3,4,4,11,Big Spenders
3543,21,11,1703.36,5,3,3,11,Loyal
3544,142,8,251.9,4,2,1,7,Regulars
3545,427,6,664.56,2,1,1,4,Hibernating
3546,168,6,579.87,3,1,1,5,Regulars
3547,23,21,4828.32,5,5,5,15,Champions
3548,83,9,1407.65,4,2,3,9,Regulars
3549,417,14,2467.72,2,5,4,11,At Risk
3550,159,9,784.63,3,2,1,6,Regulars
3551,522,5,698.99,1,1,1,3,Hibernating
3552,482,10,1112.67,1,3,2,6,Regulars
3553,100,12,1445.1599999999999,4,4,3,11,Loyal
3554,1475,3,1077.6,1,1,2,4,Hibernating
3555,477,17,1940.55,1,5,4,10,At Risk
3556,348,9,1239.16,2,2,2,6,Hibernating
3557,431,10,1443.94,2,3,3,8,Regulars
3558,262,6,1913.9699999999998,2,1,4,7,Regulars
3559,160,11,1312.17,3,3,3,9,Regulars
3560,363,9,514.66,2,2,1,5,Hibernating
3561,131,16,2332.52,4,5,4,13,Champions
3562,189,12,1256.36,3,4,3,10,Regulars
3563,23,7,987.7700000000001,5,1,2,8,Regulars
3564,649,8,810.62,1,2,1,4,Hibernating
3565,846,10,1882.2900000000002,1,3,4,8,Regulars
3566,67,9,855.75,4,2,2,8,Regulars
3567,693,8,762.2,1,2,1,4,Hibernating
3568,557,9,462.87,1,2,1,4,Hibernating
3569,806,8,528.46,1,2,1,4,Hibernating
3570,74,13,3373.5099999999998,4,4,5,13,Champions
3571,68,8,581.21,4,2,1,7,Regulars
3572,101,11,1378.32,4,3,3,10,Loyal
3573,694,9,611.38,1,2,1,4,Hibernating
3574,122,13,1485.17,4,4,3,11,Loyal
3575,486,8,1437.1599999999999,1,2,3,6,Regulars
3576,161,11,1886.59,3,3,4,10,Big Spenders
3577,221,16,3361.37,3,5,5,13,Big Spenders
3578,9,16,2816.8300000000004,5,5,5,15,Champions
3579,72,13,2858.66,4,4,5,13,Champions
3580,374,9,1736.4599999999998,2,2,4,8,Regulars
3581,434,7,730.41,2,1,1,4,Hibernating
3582,15,11,1196.99,5,3,2,10,Loyal
3583,141,10,1357.29,4,3,3,10,Loyal
3584,172,9,1835.38,3,2,4,9,Big Spenders
3585,797,12,1978.48,1,4,4,9,At Risk
3586,105,7,725.4300000000001,4,1,1,6,Regulars
3587,4,14,1293.58,5,5,3,13,Loyal
3588,127,11,1149.12,4,3,2,9,Loyal
3589,375,12,1703.94,2,4,3,9,At Risk
3590,202,13,1963.2099999999998,3,4,4,11,Big Spenders
3591,20,11,1185.9499999999998,5,3,2,10,Loyal
3592,705,11,2349.98,1,3,4,8,Regulars
3593,155,14,3540.12,3,5,5,13,Big Spenders
3594,484,9,1997.3999999999999,1,2,4,7,Regulars
3595,197,8,509.09999999999997,3,2,1,6,Regulars
3596,394,14,3314.2000000000003,2,5,5,12,At Risk
3597,129,16,1412.0500000000002,4,5,3,12,Loyal
3598,23,11,1078.25,5,3,2,10,Loyal
3599,120,15,2442.4500000000003,4,5,4,13,Champions
3600,161,13,1131.97,3,4,2,9,Regulars
3601,87,12,3338.9900000000002,4,4,5,13,Champions
3602,52,6,903.4899999999999,5,1,2,8,Regulars
3603,93,10,2078.98,4,3,4,11,Loyal
3604,502,11,3172.6000000000004,1,3,5,9,Regulars
3605,443,10,878.2,2,3,2,7,Regulars
3606,262,10,1661.8100000000002,2,3,3,8,Regulars
3607,119,9,2096.3799999999997,4,2,4,10,Big Spenders
3608,55,15,2641.87,5,5,5,15,Champions
3609,745,3,478.79999999999995,1,1,1,3,Hibernating
3610,66,9,2172.22,4,2,4,10,Big Spenders
3611,284,13,1012.17,2,4,2,8,At Risk
3612,4,9,1756.9199999999998,5,2,4,11,Big Spenders
3613,6,10,2506.65,5,3,4,12,Loyal
3614,135,16,1642.48,4,5,3,12,Loyal
3615,443,13,1085.83,2,4,2,8,At Risk
3616,1,7,1156.01,5,1,2,8,Regulars
3617,561,4,212.82999999999998,1,1,1,3,Hibernating
3618,16,9,1237.44,5,2,2,9,Regulars
3619,1226,8,1047.62,1,2,2,5,Hibernating
3620,419,7,595.69,2,1,1,4,Hibernating
3621,459,8,1168.52,2,2,2,6,Hibernating
3622,145,6,985.0200000000001,4,1,2,7,Regulars
3623,568,10,1093.55,1,3,2,6,Regulars
3624,137,11,3695.36,4,3,5,12,Loyal
3625,684,10,1421.13,1,3,3,7,Regulars
3626,2,9,3283.3999999999996,5,2,5,12,Big Spenders
3627,267,11,1733.19,2,3,4,9,Regulars
3628,910,7,854.18,1,1,2,4,Hibernating
3629,207,9,751.84,3,2,1,6,Regulars
3630,90,6,1064.2,4,1,2,7,Regulars
3631,45,11,2085.94,5,3,4,12,Loyal
3632,262,10,681.94,2,3,1,6,Regulars
3633,251,13,2618.69,2,4,5,11,At Risk
3634,55,10,1598.8,5,3,3,11,Loyal
3635,144,17,3835.25,4,5,5,14,Champions
3636,604,8,2494.26,1,2,4,7,Regulars
3637,148,5,969.9200000000001,3,1,2,6,Regulars
3638,22,8,856.37,5,2,2,9,Regulars
3639,426,5,1574.87,2,1,3,6,Regulars
3640,1256,10,1277.37,1,3,3,7,Regulars
3641,385,11,2072.38,2,3,4,9,Regulars
3642,7,13,1050.26,5,4,2,11,Loyal
3643,113,9,829.94,4,2,1,7,Regulars
3644,23,10,718.93,5,3,1,9,Loyal
3645,193,10,1247.15,3,3,3,9,Regulars
3646,75,12,2412.64,4,4,4,12,Champions
3647,43,12,1585.69,5,4,3,12,Loyal
3648,116,14,2373.5,4,5,4,13,Champions
3649,172,8,1731.8899999999999,3,2,4,9,Big Spenders
3650,52,12,1419.83,5,4,3,12,Loyal
3651,170,9,815.9399999999999,3,2,1,6,Regulars
3652,18,18,3158.38,5,5,5,15,Champions
3653,289,13,2788.16,2,4,5,11,At Risk
3654,315,8,1506.72,2,2,3,7,Regulars
3655,224,11,2487.2400000000002,3,3,4,10,Big Spenders
3656,84,13,1450.45,4,4,3,11,Loyal
3657,791,11,4449.19,1,3,5,9,Regulars
3658,191,11,1200.07,3,3,2,8,Regulars
3659,669,14,3162.93,1,5,5,11,At Risk
3660,373,12,1647.1299999999999,2,4,3,9,At Risk
3661,692,9,1295.96,1,2,3,6,Regulars
3662,329,9,2105.1400000000003,2,2,4,8,Regulars
3663,566,4,546.73,1,1,1,3,Hibernating
3664,156,13,2242.45,3,4,4,11,Big Spenders
3665,208,7,1028.8799999999999,3,1,2,6,Regulars
3666,79,11,1458.76,4,3,3,10,Loyal
3667,193,8,1528.2,3,2,3,8,Regulars
3668,274,4,326.52000000000004,2,1,1,4,Hibernating
3669,255,8,386.85,2,2,1,5,Hibernating
3670,289,11,2070.31,2,3,4,9,Regulars
3671,127,12,2028.42,4,4,4,12,Champions
3672,65,11,2588.34,5,3,5,13,Loyal
3673,1115,9,3182.6200000000003,1,2,5,8,Regulars
3674,474,11,654.27,1,3,1,5,Regulars
3675,158,10,1345.48,3,3,3,9,Regulars
3676,11,7,1025.46,5,1,2,8,Regulars
3677,198,16,6614.26,3,5,5,13,Big Spenders
3678,186,12,3281.0099999999998,3,4,5,12,Big Spenders
3679,1017,7,1193.22,1,1,2,4,Hibernating
3680,680,5,787.5899999999999,1,1,1,3,Hibernating
3681,176,13,2980.82,3,4,5,12,Big Spenders
3682,837,4,379.03999999999996,1,1,1,3,Hibernating
3683,883,7,1029.31,1,1,2,4,Hibernating
3684,440,8,1028.7,2,2,2,6,Hibernating
3685,780,9,1346.28,1,2,3,6,Regulars
3686,82,12,2004.2900000000002,4,4,4,12,Champions
3687,115,14,1487.8899999999999,4,5,3,12,Loyal
3688,793,6,727.19,1,1,1,3,Hibernating
3689,141,11,1327.46,4,3,3,10,Loyal
3690,375,8,455.51,2,2,1,5,Hibernating
3691,74,12,2778.84,4,4,5,13,Champions
3692,203,13,1917.02,3,4,4,11,Big Spenders
3693,80,15,2396.7300000000005,4,5,4,13,Champions
3694,138,9,2262.94,4,2,4,10,Big Spenders
3695,194,12,1439.4499999999998,3,4,3,10,Regulars
3696,244,9,2357.1200000000003,3,2,4,9,Big Spenders
3697,570,5,1302.5,1,1,3,5,Regulars
3698,110,12,3032.08,4,4,5,13,Champions
3699,426,9,1301.6399999999999,2,2,3,7,Regulars
3700,28,9,2920.02,5,2,5,12,Big Spenders
3701,17,12,2577.64,5,4,5,14,Champions
3702,261,8,2147.1,2,2,4,8,Regulars
3703,3,8,1822.77,5,2,4,11,Big Spenders
3704,1058,6,802.97,1,1,1,3,Hibernating
3705,216,15,1219.52,3,5,2,10,Regulars
3706,393,8,904.28,2,2,2,6,Hibernating
3707,451,9,851.13,2,2,2,6,Hibernating
3708,428,14,2350.17,2,5,4,11,At Risk
3709,262,14,1462.1799999999998,2,5,3,10,At Risk
3710,20,16,1724.25,5,5,3,13,Loyal
3711,307,12,2462.8199999999997,2,4,4,10,At Risk
3712,138,11,1622.07,4,3,3,10,Loyal
3713,264,13,5881.06,2,4,5,11,At Risk
3714,548,7,703.15,1,1,1,3,Hibernating
3715,282,6,491.27,2,1,1,4,Hibernating
3716,76,13,1335.39,4,4,3,11,Loyal
3717,745,5,386.24,1,1,1,3,Hibernating
3718,1157,5,446.66,1,1,1,3,Hibernating
3719,279,12,850.73,2,4,2,8,At Risk
3720,208,10,2420.03,3,3,4,10,Big Spenders
3721,358,13,2431.24,2,4,4,10,At Risk
3722,207,9,2614.63,3,2,5,10,Big Spenders
3723,87,10,1302.44,4,3,3,10,Loyal
3724,154,5,419.58000000000004,3,1,1,5,Regulars
3725,44,16,3392.75,5,5,5,15,Champions
3726,233,9,955.6300000000001,3,2,2,7,Regulars
3727,367,14,2485.2,2,5,4,11,At Risk
3728,122,9,1669.99,4,2,3,9,Regulars
3729,119,13,2706.93,4,4,5,13,Champions
3730,127,12,1529.64,4,4,3,11,Loyal
3731,126,16,1653.43,4,5,3,12,Loyal
3732,9,14,2902.46,5,5,5,15,Champions
3733,164,8,3673.0,3,2,5,10,Big Spenders
3734,164,14,1152.52,3,5,2,10,Regulars
3735,97,9,934.1199999999999,4,2,2,8,Regulars
3736,9,7,585.87,5,1,1,7,Regulars
3737,54,14,2497.78,5,5,4,14,Champions
3738,15,10,611.49,5,3,1,9,Loyal
3739,937,13,3224.28,1,4,5,10,At Risk
3740,19,6,982.2499999999999,5,1,2,8,Regulars
3741,742,14,3369.33,1,5,5,11,At Risk
3742,271,7,2320.36,2,1,4,7,Regulars
3743,0,14,2182.48,5,5,4,14,Champions
3744,33,10,686.1700000000001,5,3,1,9,Loyal
3745,324,10,2718.43,2,3,5,10,Regulars
3746,237,16,1473.58,3,5,3,11,Regulars
3747,570,8,940.21,1,2,2,5,Hibernating
3748,113,12,1677.29,4,4,3,11,Loyal
3749,303,12,1316.87,2,4,3,9,At Risk
3750,23,14,1600.3799999999999,5,5,3,13,Loyal
3751,15,14,1536.06,5,5,3,13,Loyal
3752,182,10,1369.52,3,3,3,9,Regulars
3753,580,6,332.12,1,1,1,3,Hibernating
3754,34,11,770.35,5,3,1,9,Loyal
3755,364,9,810.09,2,2,1,5,Hibernating
3756,22,10,2982.4,5,3,5,13,Loyal
3757,145,7,969.18,4,1,2,7,Regulars
3758,156,7,654.37,3,1,1,5,Regulars
3759,23,14,2564.24,5,5,4,14,Champions
3760,1062,10,1660.31,1,3,3,7,Regulars
3761,210,11,1991.42,3,3,4,10,Big Spenders
3762,116,8,3625.1400000000003,4,2,5,11,Big Spenders
3763,229,20,6241.07,3,5,5,13,Big Spenders
3764,21,7,655.38,5,1,1,7,Regulars
3765,454,6,452.96,2,1,1,4,Hibernating
3766,68,9,1384.37,4,2,3,9,Regulars
3767,110,14,4016.36,4,5,5,14,Champions
3768,184,12,870.9399999999999,3,4,2,9,Regulars
3769,175,9,1530.28,3,2,3,8,Regulars
3770,154,19,1739.1699999999998,3,5,4,12,Big Spenders
3771,95,11,3978.81,4,3,5,12,Loyal
3772,64,13,1941.02,5,4,4,13,Champions
3773,126,7,1570.1000000000001,4,1,3,8,Regulars
3774,272,9,884.26,2,2,2,6,Hibernating
3775,0,11,1118.45,5,3,2,10,Loyal
3776,85,7,2071.11,4,1,4,9,Big Spenders
3777,85,12,2151.62,4,4,4,12,Champions
3778,1482,6,555.86,1,1,1,3,Hibernating
3779,409,8,2925.55,2,2,5,9,Regulars
3780,69,10,1543.3899999999999,4,3,3,10,Loyal
3781,165,10,1182.93,3,3,2,8,Regulars
3782,360,6,706.7700000000001,2,1,1,4,Hibernating
3783,290,10,2067.84,2,3,4,9,Regulars
3784,229,8,765.04,3,2,1,6,Regulars
3785,1103,8,1571.08,1,2,3,6,Regulars
3786,141,7,681.7900000000001,4,1,1,6,Regulars
3787,314,3,444.49999999999994,2,1,1,4,Hibernating
3788,358,15,1698.82,2,5,3,10,At Risk
3789,453,14,997.7900000000001,2,5,2,9,At Risk
3790,23,8,876.65,5,2,2,9,Regulars
3791,380,6,3278.05,2,1,5,8,Regulars
3792,571,4,1482.21,1,1,3,5,Regulars
3793,260,13,836.67,2,4,1,7,At Risk
3794,30,13,1791.56,5,4,4,13,Champions
3795,498,6,969.6000000000001,1,1,2,4,Hibernating
3796,27,8,604.76,5,2,1,8,Regulars
3797,88,13,4237.52,4,4,5,13,Champions
3798,33,11,1462.98,5,3,3,11,Loyal
3799,614,10,893.5799999999999,1,3,2,6,Regulars
3800,1147,5,927.3,1,1,2,4,Hibernating
3801,694,7,2425.35,1,1,4,6,Regulars
3802,196,5,572.36,3,1,1,5,Regulars
3803,445,9,801.9,2,2,1,5,Hibernating
3804,28,7,458.11,5,1,1,7,Regulars
3805,333,13,1741.82,2,4,4,10,At Risk
3806,537,11,1510.58,1,3,3,7,Regulars
3807,286,8,1547.51,2,2,3,7,Regulars
3808,124,11,882.93,4,3,2,9,Loyal
3809,170,15,1317.03,3,5,3,11,Regulars
3810,11,10,745.58,5,3,1,9,Loyal
3811,175,6,1015.91,3,1,2,6,Regulars
3812,49,16,2674.62,5,5,5,15,Champions
3813,333,14,1755.66,2,5,4,11,At Risk
3814,1623,2,169.49,1,1,1,3,Hibernating
3815,2,11,5657.81,5,3,5,13,Loyal
3816,322,13,1260.15,2,4,3,9,At Risk
3817,437,8,1298.2,2,2,3,7,Regulars
3818,601,11,1672.53,1,3,3,7,Regulars
3819,890,5,497.7,1,1,1,3,Hibernating
3820,36,10,1275.77,5,3,3,11,Loyal
3821,120,12,2384.48,4,4,4,12,Champions
3822,831,4,828.3399999999999,1,1,1,3,Hibernating
3823,24,13,3036.25,5,4,5,14,Champions
3824,225,9,741.78,3,2,1,6,Regulars
3825,255,5,251.45,2,1,1,4,Hibernating
3826,346,7,934.45,2,1,2,5,Hibernating
3827,93,10,590.0400000000001,4,3,1,8,Loyal
3828,711,5,2125.4499999999994,1,1,4,6,Regulars
3829,98,7,501.02,4,1,1,6,Regulars
3830,583,6,2195.53,1,1,4,6,Regulars
3831,102,12,1243.06,4,4,3,11,Loyal
3832,53,10,1877.9,5,3,4,12,Loyal
3833,399,12,1254.09,2,4,3,9,At Risk
3834,216,7,2158.57,3,1,4,8,Big Spenders
3835,170,11,921.4399999999999,3,3,2,8,Regulars
3836,188,12,801.99,3,4,1,8,Regulars
3837,457,10,721.54,2,3,1,6,Regulars
3838,440,15,1284.67,2,5,3,10,At Risk
3839,607,4,1188.19,1,1,2,4,Hibernating
3840,29,18,1965.5700000000002,5,5,4,14,Champions
3841,505,8,1014.97,1,2,2,5,Hibernating
3842,460,6,462.24,1,1,1,3,Hibernating
3843,204,16,3690.6,3,5,5,13,Big Spenders
3844,246,9,764.81,3,2,1,6,Regulars
3845,34,10,703.31,5,3,1,9,Loyal
3846,525,6,325.52,1,1,1,3,Hibernating
3847,153,14,2119.21,3,5,4,12,Big Spenders
3848,141,12,1341.9,4,4,3,11,Loyal
3849,226,6,827.23,3,1,1,5,Regulars
3850,2043,3,512.59,1,1,1,3,Hibernating
3851,401,11,985.8199999999999,2,3,2,7,Regulars
3852,246,11,2051.9,3,3,4,10,Big Spenders
3853,211,11,1914.03,3,3,4,10,Big Spenders
3854,77,11,2027.86,4,3,4,11,Loyal
3855,333,8,685.3299999999999,2,2,1,5,Hibernating
3856,56,17,1378.54,5,5,3,13,Loyal
3857,261,10,2522.94,2,3,4,9,Regulars
3858,210,11,3372.6500000000005,3,3,5,11,Big Spenders
3859,101,12,1917.01,4,4,4,12,Champions
3860,154,9,800.8900000000001,3,2,1,6,Regulars
3861,112,13,1830.3999999999999,4,4,4,12,Champions
3862,88,9,1491.47,4,2,3,9,Regulars
3863,51,13,2706.03,5,4,5,14,Champions
3864,142,8,772.3199999999999,4,2,1,7,Regulars
3865,231,9,1597.56,3,2,3,8,Regulars
3866,147,13,2934.95,4,4,5,13,Champions
3867,533,6,592.48,1,1,1,3,Hibernating
3868,2,8,1582.69,5,2,3,10,Regulars
3869,322,13,2094.31,2,4,4,10,At Risk
3870,1014,7,642.02,1,1,1,3,Hibernating
3871,805,8,753.02,1,2,1,4,Hibernating
3872,25,8,3083.09,5,2,5,12,Big Spenders
3873,186,10,695.01,3,3,1,7,Regulars
3874,295,5,240.93,2,1,1,4,Hibernating
3875,6,12,1818.12,5,4,4,13,Champions
3876,578,9,1332.51,1,2,3,6,Regulars
3877,99,11,1414.6399999999999,4,3,3,10,Loyal
3878,131,12,1566.33,4,4,3,11,Loyal
3879,1065,9,1559.01,1,2,3,6,Regulars
3880,45,8,1283.8,5,2,3,10,Regulars
3881,180,14,6470.09,3,5,5,13,Big Spenders
3882,241,10,1333.96,3,3,3,9,Regulars
3883,36,11,3669.5800000000004,5,3,5,13,Loyal
3884,615,5,230.08999999999997,1,1,1,3,Hibernating
3885,481,3,200.29000000000002,1,1,1,3,Hibernating
3886,91,9,2136.91,4,2,4,10,Big Spenders
3887,202,6,854.3699999999999,3,1,2,6,Regulars
3888,621,11,1097.8400000000001,1,3,2,6,Regulars
3889,396,12,2630.26,2,4,5,11,At Risk
3890,2,13,2653.7000000000003,5,4,5,14,Champions
3891,884,11,1417.46,1,3,3,7,Regulars
3892,1277,9,945.05,1,2,2,5,Hibernating
3893,1142,10,1834.6799999999998,1,3,4,8,Regulars
3894,96,11,1463.1000000000001,4,3,3,10,Loyal
3895,278,9,900.0,2,2,2,6,Hibernating
3896,46,11,1807.91,5,3,4,12,Loyal
3897,58,15,1127.91,5,5,2,12,Loyal
3898,65,12,1516.81,5,4,3,12,Loyal
3899,178,12,1352.43,3,4,3,10,Regulars
3900,778,9,1377.6100000000001,1,2,3,6,Regulars
3901,299,15,3159.61,2,5,5,12,At Risk
3902,732,6,476.24,1,1,1,3,Hibernating
3903,414,8,3008.45,2,2,5,9,Regulars
3904,252,12,2887.2499999999995,2,4,5,11,At Risk
3905,225,12,1440.35,3,4,3,10,Regulars
3906,181,11,1525.03,3,3,3,9,Regulars
3907,138,14,3851.24,4,5,5,14,Champions
3908,121,11,913.63,4,3,2,9,Loyal
3909,117,12,1084.37,4,4,2,10,Loyal
3910,483,10,1812.83,1,3,4,8,Regulars
3911,230,5,389.87,3,1,1,5,Regulars
3912,124,8,2150.5,4,2,4,10,Big Spenders
3913,492,5,1030.37,1,1,2,4,Hibernating
3914,1139,6,1011.46,1,1,2,4,Hibernating
3915,1026,8,1210.8400000000001,1,2,2,5,Hibernating
3916,72,13,2660.57,4,4,5,13,Champions
3917,443,8,1112.6599999999999,2,2,2,6,Hibernating
3918,208,12,3719.13,3,4,5,12,Big Spenders
3919,220,7,972.29,3,1,2,6,Regulars
3920,61,2,1644.12,5,1,3,9,Regulars
3921,145,10,654.88,4,3,1,8,Loyal
3922,164,10,3856.86,3,3,5,11,Big Spenders
3923,242,9,891.52,3,2,2,7,Regulars
3924,159,13,4481.46,3,4,5,12,Big Spenders
3925,309,6,553.48,2,1,1,4,Hibernating
3926,655,9,1467.99,1,2,3,6,Regulars
3927,56,18,3014.32,5,5,5,15,Champions
3928,72,13,3541.91,4,4,5,13,Champions
3929,490,14,2507.67,1,5,4,10,At Risk
3930,32,11,2345.88,5,3,4,12,Loyal
3931,29,7,406.99,5,1,1,7,Regulars
3932,125,12,1200.2,4,4,2,10,Loyal
3933,156,11,1527.76,3,3,3,9,Regulars
3934,126,11,1166.19,4,3,2,9,Loyal
3935,73,9,1397.5,4,2,3,9,Regulars
3936,42,11,1743.73,5,3,4,12,Loyal
3937,425,9,1865.62,2,2,4,8,Regulars
3938,227,8,1268.42,3,2,3,8,Regulars
3939,159,11,1270.31,3,3,3,9,Regulars
3940,41,11,3884.9599999999996,5,3,5,13,Loyal
3941,209,11,2426.6,3,3,4,10,Big Spenders
3942,264,11,1311.82,2,3,3,8,Regulars
3943,4,14,2545.8100000000004,5,5,4,14,Champions
3944,959,11,2353.95,1,3,4,8,Regulars
3945,262,6,2668.52,2,1,5,8,Regulars
3946,418,7,1167.08,2,1,2,5,Hibernating
3947,1099,5,987.71,1,1,2,4,Hibernating
3948,128,13,1218.31,4,4,2,10,Loyal
3949,580,11,1602.01,1,3,3,7,Regulars
3950,101,15,2817.25,4,5,5,14,Champions
3951,392,10,1684.92,2,3,3,8,Regulars
3952,41,16,1284.95,5,5,3,13,Loyal
3953,48,8,1021.0,5,2,2,9,Regulars
3954,23,8,396.57,5,2,1,8,Regulars
3955,121,10,810.02,4,3,1,8,Loyal
3956,218,10,1309.4099999999999,3,3,3,9,Regulars
3957,85,10,2541.7400000000002,4,3,4,11,Loyal
3958,469,8,795.56,1,2,1,4,Hibernating
3959,285,7,895.0,2,1,2,5,Hibernating
3960,22,10,629.85,5,3,1,9,Loyal
3961,91,8,766.27,4,2,1,7,Regulars
3962,138,9,1333.8,4,2,3,9,Regulars
3963,39,12,1113.07,5,4,2,11,Loyal
3964,243,13,6016.490000000001,3,4,5,12,Big Spenders
3965,201,7,2768.68,3,1,5,9,Big Spenders
3966,779,9,965.47,1,2,2,5,Hibernating
3967,22,14,2607.59,5,5,5,15,Champions
3968,30,10,1044.57,5,3,2,10,Loyal
3969,138,15,2826.1200000000003,4,5,5,14,Champions
3970,339,11,2117.37,2,3,4,9,Regulars
3971,51,14,2063.85,5,5,4,14,Champions
3972,142,8,2994.2400000000002,4,2,5,11,Big Spenders
3973,1211,5,181.71,1,1,1,3,Hibernating
3974,110,17,1543.56,4,5,3,12,Loyal
3975,37,12,1947.21,5,4,4,13,Champions
3976,260,13,1400.04,2,4,3,9,At Risk
3977,65,8,548.19,5,2,1,8,Regulars
3978,345,9,1635.83,2,2,3,7,Regulars
3979,250,10,1732.8999999999999,2,3,4,9,Regulars
3980,707,6,1370.8000000000002,1,1,3,5,Regulars
3981,624,12,1287.25,1,4,3,8,At Risk
3982,319,9,1276.27,2,2,3,7,Regulars
3983,281,9,2388.9700000000003,2,2,4,8,Regulars
3984,70,6,488.35,4,1,1,6,Regulars
3985,799,12,909.6800000000001,1,4,2,7,At Risk
3986,222,9,2273.37,3,2,4,9,Big Spenders
3987,254,15,1941.29,2,5,4,11,At Risk
3988,71,6,2433.22,4,1,4,9,Big Spenders
3989,386,13,1837.53,2,4,4,10,At Risk
3990,806,8,468.52,1,2,1,4,Hibernating
3991,167,18,5762.96,3,5,5,13,Big Spenders
3992,211,12,3434.0099999999998,3,4,5,12,Big Spenders
3993,15,13,1834.6,5,4,4,13,Champions
3994,80,2,140.68,4,1,1,6,Regulars
3995,790,7,665.64,1,1,1,3,Hibernating
3996,99,7,1092.32,4,1,2,7,Regulars
3997,366,12,1543.66,2,4,3,9,At Risk
3998,336,10,1193.39,2,3,2,7,Regulars
3999,300,14,5502.3,2,5,5,12,At Risk
4000,47,6,935.72,5,1,2,8,Regulars
4001,44,12,1685.86,5,4,3,12,Loyal
4002,318,11,1112.33,2,3,2,7,Regulars
4003,209,7,1313.2700000000002,3,1,3,7,Regulars
4004,119,10,1093.56,4,3,2,9,Loyal
4005,560,13,2523.05,1,4,4,9,At Risk
4006,184,10,3006.98,3,3,5,11,Big Spenders
4007,373,15,2701.5299999999997,2,5,5,12,At Risk
4008,13,10,916.23,5,3,2,10,Loyal
4009,455,11,2150.76,2,3,4,9,Regulars
4010,495,12,1069.68,1,4,2,7,At Risk
4011,796,8,1103.94,1,2,2,5,Hibernating
4012,249,6,344.43,2,1,1,4,Hibernating
4013,604,8,801.45,1,2,1,4,Hibernating
4014,585,8,761.87,1,2,1,4,Hibernating
4015,57,14,750.87,5,5,1,11,Loyal
4016,23,13,1813.66,5,4,4,13,Champions
4017,46,12,2681.45,5,4,5,14,Champions
4018,534,9,2779.51,1,2,5,8,Regulars
4019,154,19,2900.33,3,5,5,13,Big Spenders
4020,439,12,1684.5700000000002,2,4,3,9,At Risk
4021,661,8,748.64,1,2,1,4,Hibernating
4022,132,7,471.34,4,1,1,6,Regulars
4023,90,17,3373.56,4,5,5,14,Champions
4024,278,5,1790.1899999999998,2,1,4,7,Regulars
4025,155,6,441.37,3,1,1,5,Regulars
4026,442,8,685.65,2,2,1,5,Hibernating
4027,659,12,858.99,1,4,2,7,At Risk
4028,93,14,4285.14,4,5,5,14,Champions
4029,454,11,1245.69,2,3,3,8,Regulars
4030,79,5,799.2299999999999,4,1,1,6,Regulars
4031,92,9,1519.6499999999999,4,2,3,9,Regulars
4032,193,11,1126.07,3,3,2,8,Regulars
4033,33,14,1955.01,5,5,4,14,Champions
4034,350,10,2362.96,2,3,4,9,Regulars
4035,536,12,1433.2,1,4,3,8,At Risk
4036,538,7,1064.02,1,1,2,4,Hibernating
4037,412,10,1677.02,2,3,3,8,Regulars
4038,139,14,5352.150000000001,4,5,5,14,Champions
4039,8,14,2282.84,5,5,4,14,Champions
4040,143,17,4161.24,4,5,5,14,Champions
4041,454,13,2202.04,2,4,4,10,At Risk
4042,62,8,1038.31,5,2,2,9,Regulars
4043,124,12,4312.49,4,4,5,13,Champions
4044,91,8,1810.39,4,2,4,10,Big Spenders
4045,503,8,1089.3100000000002,1,2,2,5,Hibernating
4046,268,15,1655.9,2,5,3,10,At Risk
4047,95,7,536.25,4,1,1,6,Regulars
4048,313,11,1306.6399999999999,2,3,3,8,Regulars
4049,523,7,1451.15,1,1,3,5,Regulars
4050,665,11,2359.55,1,3,4,8,Regulars
4051,160,10,1181.91,3,3,2,8,Regulars
4052,597,6,808.23,1,1,1,3,Hibernating
4053,10,13,3266.8399999999997,5,4,5,14,Champions
4054,8,15,2011.84,5,5,4,14,Champions
4055,448,13,1090.83,2,4,2,8,At Risk
4056,324,8,749.59,2,2,1,5,Hibernating
4057,961,7,2663.93,1,1,5,7,Regulars
4058,539,17,2271.88,1,5,4,10,At Risk
4059,753,12,1316.1000000000001,1,4,3,8,At Risk
4060,273,12,938.96,2,4,2,8,At Risk
4061,103,4,1587.8,4,1,3,8,Regulars
4062,531,11,1398.07,1,3,3,7,Regulars
4063,351,8,690.5,2,2,1,5,Hibernating
4064,370,13,1763.78,2,4,4,10,At Risk
4065,163,13,2402.95,3,4,4,11,Big Spenders
4066,933,5,542.01,1,1,1,3,Hibernating
4067,292,10,1972.1399999999999,2,3,4,9,Regulars
4068,259,8,1306.31,2,2,3,7,Regulars
4069,71,9,2230.26,4,2,4,10,Big Spenders
4070,523,19,4417.05,1,5,5,11,At Risk
4071,158,9,2226.78,3,2,4,9,Big Spenders
4072,595,8,2265.97,1,2,4,7,Regulars
4073,40,7,2283.32,5,1,4,10,Big Spenders
4074,144,17,2787.42,4,5,5,14,Champions
4075,358,11,2456.7,2,3,4,9,Regulars
4076,93,11,1046.27,4,3,2,9,Loyal
4077,48,13,1229.64,5,4,2,11,Loyal
4078,760,7,1908.51,1,1,4,6,Regulars
4079,108,9,3972.0,4,2,5,11,Big Spenders
4080,139,14,2527.76,4,5,4,13,Champions
4081,40,10,936.02,5,3,2,10,Loyal
4082,245,11,654.7,3,3,1,7,Regulars
4083,1,15,1764.58,5,5,4,14,Champions
4084,209,13,1816.45,3,4,4,11,Big Spenders
4085,21,11,1005.13,5,3,2,10,Loyal
4086,103,10,2062.64,4,3,4,11,Loyal
4087,703,7,1797.52,1,1,4,6,Regulars
4088,594,10,1474.42,1,3,3,7,Regulars
4089,14,9,994.5899999999999,5,2,2,9,Regulars
4090,32,15,3991.3399999999997,5,5,5,15,Champions
4091,153,13,1927.0,3,4,4,11,Big Spenders
4092,391,5,929.56,2,1,2,5,Hibernating
4093,318,9,877.67,2,2,2,6,Hibernating
4094,812,9,582.14,1,2,1,4,Hibernating
4095,67,11,1415.13,4,3,3,10,Loyal
4096,573,8,2110.55,1,2,4,7,Regulars
4097,182,10,1421.02,3,3,3,9,Regulars
4098,171,11,958.34,3,3,2,8,Regulars
4099,117,10,1024.61,4,3,2,9,Loyal
4100,247,6,849.26,3,1,2,6,Regulars
4101,116,7,2150.75,4,1,4,9,Big Spenders
4102,498,11,997.5899999999999,1,3,2,6,Regulars
4103,64,13,2119.62,5,4,4,13,Champions
4104,118,14,1082.15,4,5,2,11,Loyal
4105,22,14,4456.49,5,5,5,15,Champions
4106,133,12,960.49,4,4,2,10,Loyal
4107,302,17,1987.8,2,5,4,11,At Risk
4108,274,10,2397.72,2,3,4,9,Regulars
4109,15,11,1543.42,5,3,3,11,Loyal
4110,145,12,1441.67,4,4,3,11,Loyal
4111,44,15,1410.9,5,5,3,13,Loyal
4112,223,9,838.81,3,2,1,6,Regulars
4113,63,14,1390.04,5,5,3,13,Loyal
4114,290,7,1108.7,2,1,2,5,Hibernating
4115,85,8,1926.62,4,2,4,10,Big Spenders
4116,164,12,1719.77,3,4,3,10,Regulars
4117,432,9,1702.8899999999999,2,2,3,7,Regulars
4118,180,7,572.7,3,1,1,5,Regulars
4119,666,10,1738.68,1,3,4,8,Regulars
4120,38,12,1716.55,5,4,3,12,Loyal
4121,18,14,1358.98,5,5,3,13,Loyal
4122,80,8,335.29,4,2,1,7,Regulars
4123,760,8,542.05,1,2,1,4,Hibernating
4124,103,12,1417.42,4,4,3,11,Loyal
4125,196,10,2120.25,3,3,4,10,Big Spenders
4126,11,13,2391.05,5,4,4,13,Champions
4127,263,9,1276.05,2,2,3,7,Regulars
4128,753,8,792.53,1,2,1,4,Hibernating
4129,160,5,645.0300000000001,3,1,1,5,Regulars
4130,188,8,574.87,3,2,1,6,Regulars
4131,226,10,1382.4299999999998,3,3,3,9,Regulars
4132,46,15,1562.21,5,5,3,13,Loyal
4133,110,16,6816.09,4,5,5,14,Champions
4134,486,9,2160.27,1,2,4,7,Regulars
4135,191,16,1975.22,3,5,4,12,Big Spenders
4136,6,13,1379.56,5,4,3,12,Loyal
4137,288,11,868.2,2,3,2,7,Regulars
4138,20,12,1649.9,5,4,3,12,Loyal
4139,652,8,891.24,1,2,2,5,Hibernating
4140,87,14,2679.62,4,5,5,14,Champions
4141,17,11,1800.37,5,3,4,12,Loyal
4142,89,13,2730.91,4,4,5,13,Champions
4143,591,11,819.0699999999999,1,3,1,5,Regulars
4144,173,12,1166.97,3,4,2,9,Regulars
4145,204,9,655.41,3,2,1,6,Regulars
4146,162,12,2202.6,3,4,4,11,Big Spenders
4147,56,9,2183.22,5,2,4,11,Big Spenders
4148,226,7,823.1700000000001,3,1,1,5,Regulars
4149,179,10,2624.38,3,3,5,11,Big Spenders
4150,19,6,442.07,5,1,1,7,Regulars
4151,365,9,723.52,2,2,1,5,Hibernating
4152,163,10,864.8,3,3,2,8,Regulars
4153,110,8,1880.76,4,2,4,10,Big Spenders
4154,499,9,2281.0,1,2,4,7,Regulars
4155,767,11,2106.24,1,3,4,8,Regulars
4156,190,18,1792.17,3,5,4,12,Big Spenders
4157,539,8,952.8900000000001,1,2,2,5,Hibernating
4158,51,11,1478.75,5,3,3,11,Loyal
4159,191,14,1165.44,3,5,2,10,Regulars
4160,209,7,508.54,3,1,1,5,Regulars
4161,492,11,2428.52,1,3,4,8,Regulars
4162,858,8,950.4,1,2,2,5,Hibernating
4163,270,8,2049.4900000000002,2,2,4,8,Regulars
4164,321,12,1239.82,2,4,2,8,At Risk
4165,223,5,508.42,3,1,1,5,Regulars
4166,400,8,639.67,2,2,1,5,Hibernating
4167,8,14,2448.4500000000003,5,5,4,14,Champions
4168,110,13,2329.73,4,4,4,12,Champions
4169,122,8,849.86,4,2,2,8,Regulars
4170,108,11,2232.74,4,3,4,11,Loyal
4171,109,12,1042.92,4,4,2,10,Loyal
4172,728,10,2377.37,1,3,4,8,Regulars
4173,1160,13,3580.47,1,4,5,10,At Risk
4174,328,8,3523.9100000000003,2,2,5,9,Regulars
4175,305,8,378.62,2,2,1,5,Hibernating
4176,888,12,3515.23,1,4,5,10,At Risk
4177,231,9,2273.87,3,2,4,9,Big Spenders
4178,919,8,667.87,1,2,1,4,Hibernating
4179,193,13,1709.92,3,4,3,10,Regulars
4180,326,10,4217.56,2,3,5,10,Regulars
4181,145,14,1822.42,4,5,4,13,Champions
4182,148,11,816.35,3,3,1,7,Regulars
4183,238,12,1088.88,3,4,2,9,Regulars
4184,54,15,1571.69,5,5,3,13,Loyal
4185,71,13,2692.26,4,4,5,13,Champions
4186,13,15,1198.21,5,5,2,12,Loyal
4187,97,9,1647.3,4,2,3,9,Regulars
4188,97,8,4138.39,4,2,5,11,Big Spenders
4189,156,12,1213.28,3,4,2,9,Regulars
4190,1212,3,207.53,1,1,1,3,Hibernating
4191,454,10,527.59,2,3,1,6,Regulars
4192,70,9,2027.92,4,2,4,10,Big Spenders
4193,406,9,981.91,2,2,2,6,Hibernating
4194,10,15,2894.7799999999997,5,5,5,15,Champions
4195,132,7,1660.45,4,1,3,8,Regulars
4196,210,10,1041.8500000000001,3,3,2,8,Regulars
4197,60,11,1930.9499999999998,5,3,4,12,Loyal
4198,191,10,2176.9900000000002,3,3,4,10,Big Spenders
4199,468,14,4926.01,1,5,5,11,At Risk
4200,230,11,1330.02,3,3,3,9,Regulars
4201,305,9,1536.11,2,2,3,7,Regulars
4202,152,10,3216.6800000000003,3,3,5,11,Big Spenders
4203,64,10,843.36,5,3,1,9,Loyal
4204,255,9,873.46,2,2,2,6,Hibernating
4205,98,12,3313.33,4,4,5,13,Champions
4206,69,12,1034.88,4,4,2,10,Loyal
4207,445,4,275.24,2,1,1,4,Hibernating
4208,69,13,1450.13,4,4,3,11,Loyal
4209,75,8,2677.84,4,2,5,11,Big Spenders
4210,460,9,1025.22,1,2,2,5,Hibernating
4211,261,8,864.35,2,2,2,6,Hibernating
4212,35,11,1767.8799999999999,5,3,4,12,Loyal
4213,83,10,1628.1,4,3,3,10,Loyal
4214,430,14,2064.4900000000002,2,5,4,11,At Risk
4215,10,16,4008.7400000000002,5,5,5,15,Champions
4216,382,5,963.24,2,1,2,5,Hibernating
4217,96,9,1299.45,4,2,3,9,Regulars
4218,194,9,2339.64,3,2,4,9,Big Spenders
4219,32,13,3912.05,5,4,5,14,Champions
4220,118,7,1584.83,4,1,3,8,Regulars
4221,278,7,538.37,2,1,1,4,Hibernating
4222,178,4,817.32,3,1,1,5,Regulars
4223,92,10,1659.7199999999998,4,3,3,10,Loyal
4224,658,6,2467.6099999999997,1,1,4,6,Regulars
4225,151,7,437.53,3,1,1,5,Regulars
4226,416,12,1552.87,2,4,3,9,At Risk
4227,217,7,1425.94,3,1,3,7,Regulars
4228,952,8,842.6199999999999,1,2,1,4,Hibernating
4229,9,13,1111.08,5,4,2,11,Loyal
4230,76,9,1546.55,4,2,3,9,Regulars
4231,42,11,1419.95,5,3,3,11,Loyal
4232,1372,6,2131.45,1,1,4,6,Regulars
4233,23,11,1540.17,5,3,3,11,Loyal
4234,964,6,870.33,1,1,2,4,Hibernating
4235,264,15,1980.05,2,5,4,11,At Risk
4236,4,15,1550.24,5,5,3,13,Loyal
4237,212,13,2323.33,3,4,4,11,Big Spenders
4238,308,13,6419.919999999999,2,4,5,11,At Risk
4239,289,12,1337.95,2,4,3,9,At Risk
4240,41,9,935.53,5,2,2,9,Regulars
4241,29,9,1068.56,5,2,2,9,Regulars
4242,385,15,2834.89,2,5,5,12,At Risk
4243,267,8,932.8399999999999,2,2,2,6,Hibernating
4244,4,15,1971.77,5,5,4,14,Champions
4245,297,13,5707.29,2,4,5,11,At Risk
4246,71,14,2063.44,4,5,4,13,Champions
4247,99,12,1988.05,4,4,4,12,Champions
4248,41,18,2299.32,5,5,4,14,Champions
4249,155,16,2537.76,3,5,4,12,Big Spenders
4250,127,16,3379.52,4,5,5,14,Champions
4251,7,13,1147.64,5,4,2,11,Loyal
4252,128,12,2166.97,4,4,4,12,Champions
4253,134,8,1142.1200000000001,4,2,2,8,Regulars
4254,566,13,2006.24,1,4,4,9,At Risk
4255,476,9,1599.78,1,2,3,6,Regulars
4256,183,9,992.13,3,2,2,7,Regulars
4257,911,6,3170.8900000000003,1,1,5,7,Regulars
4258,127,11,1402.59,4,3,3,10,Loyal
4259,468,10,554.53,1,3,1,5,Regulars
4260,123,8,1102.41,4,2,2,8,Regulars
4261,97,10,1302.01,4,3,3,10,Loyal
4262,187,14,2819.06,3,5,5,13,Big Spenders
4263,416,7,1500.3200000000002,2,1,3,6,Regulars
4264,128,12,2617.8900000000003,4,4,5,13,Champions
4265,166,18,3953.38,3,5,5,13,Big Spenders
4266,194,7,705.81,3,1,1,5,Regulars
4267,5,14,3196.81,5,5,5,15,Champions
4268,28,16,1489.1399999999999,5,5,3,13,Loyal
4269,376,8,1053.3999999999999,2,2,2,6,Hibernating
4270,498,9,790.33,1,2,1,4,Hibernating
4271,146,8,2057.83,4,2,4,10,Big Spenders
4272,255,5,185.4,2,1,1,4,Hibernating
4273,191,13,1298.43,3,4,3,10,Regulars
4274,372,6,480.13,2,1,1,4,Hibernating
4275,64,13,2846.74,5,4,5,14,Champions
4276,324,6,503.79999999999995,2,1,1,4,Hibernating
4277,4,11,2241.48,5,3,4,12,Loyal
4278,6,14,2974.67,5,5,5,15,Champions
4279,656,7,853.03,1,1,2,4,Hibernating
4280,368,10,1316.43,2,3,3,8,Regulars
4281,228,8,2678.65,3,2,5,10,Big Spenders
4282,19,10,3506.5100000000007,5,3,5,13,Loyal
4283,305,11,1587.1100000000001,2,3,3,8,Regulars
4284,174,6,457.13,3,1,1,5,Regulars
4285,221,14,2077.42,3,5,4,12,Big Spenders
4286,36,9,1601.5,5,2,3,10,Regulars
4287,18,6,425.45,5,1,1,7,Regulars
4288,386,4,456.15999999999997,2,1,1,4,Hibernating
4289,467,7,1323.61,1,1,3,5,Regulars
4290,563,4,653.6,1,1,1,3,Hibernating
4291,154,11,1484.83,3,3,3,9,Regulars
4292,168,13,2091.9700000000003,3,4,4,11,Big Spenders
4293,384,6,443.14,2,1,1,4,Hibernating
4294,938,7,541.02,1,1,1,3,Hibernating
4295,21,12,1864.4199999999998,5,4,4,13,Champions
4296,174,6,444.99,3,1,1,5,Regulars
4297,218,10,1885.47,3,3,4,10,Big Spenders
4298,411,11,1044.19,2,3,2,7,Regulars
4299,60,9,1720.62,5,2,3,10,Regulars
4300,270,13,1819.5,2,4,4,10,At Risk
4301,11,6,417.45,5,1,1,7,Regulars
4302,538,12,2309.51,1,4,4,9,At Risk
4303,189,12,2051.58,3,4,4,11,Big Spenders
4304,287,16,2266.84,2,5,4,11,At Risk
4305,611,7,594.9,1,1,1,3,Hibernating
4306,829,10,978.56,1,3,2,6,Regulars
4307,98,9,765.78,4,2,1,7,Regulars
4308,114,12,3021.6000000000004,4,4,5,13,Champions
4309,135,7,2022.57,4,1,4,9,Big Spenders
4310,365,10,902.02,2,3,2,7,Regulars
4311,525,8,2468.75,1,2,4,7,Regulars
4312,17,15,1547.92,5,5,3,13,Loyal
4313,440,8,971.0999999999999,2,2,2,6,Hibernating
4314,42,14,1506.67,5,5,3,13,Loyal
4315,77,15,1291.1,4,5,3,12,Loyal
4316,955,6,482.65,1,1,1,3,Hibernating
4317,481,8,1195.97,1,2,2,5,Hibernating
4318,8,15,1246.29,5,5,3,13,Loyal
4319,26,9,599.86,5,2,1,8,Regulars
4320,68,8,1149.5,4,2,2,8,Regulars
4321,44,9,3232.53,5,2,5,12,Big Spenders
4322,41,15,2814.6,5,5,5,15,Champions
4323,147,7,645.22,4,1,1,6,Regulars
4324,571,7,606.5,1,1,1,3,Hibernating
4325,84,16,3287.2200000000003,4,5,5,14,Champions
4326,6,11,843.3199999999999,5,3,1,9,Loyal
4327,490,8,1047.53,1,2,2,5,Hibernating
4328,194,13,1090.6100000000001,3,4,2,9,Regulars
4329,267,9,2154.71,2,2,4,8,Regulars
4330,202,12,1140.97,3,4,2,9,Regulars
4331,81,13,1240.1299999999999,4,4,2,10,Loyal
4332,10,9,2698.6299999999997,5,2,5,12,Big Spenders
4333,188,17,1962.19,3,5,4,12,Big Spenders
4334,25,13,3734.56,5,4,5,14,Champions
4335,99,9,1294.19,4,2,3,9,Regulars
4336,40,9,1127.04,5,2,2,9,Regulars
4337,160,10,1553.8,3,3,3,9,Regulars
4338,251,12,1688.05,2,4,3,9,At Risk
4339,824,8,799.96,1,2,1,4,Hibernating
4340,419,11,1211.4099999999999,2,3,2,7,Regulars
4341,17,8,534.08,5,2,1,8,Regulars
4342,853,8,774.82,1,2,1,4,Hibernating
4343,119,12,1455.2800000000002,4,4,3,11,Loyal
4344,743,8,4055.7,1,2,5,8,Regulars
4345,116,13,1522.58,4,4,3,11,Loyal
4346,254,9,1692.47,2,2,3,7,Regulars
4347,308,10,1116.21,2,3,2,7,Regulars
4348,287,10,3020.65,2,3,5,10,Regulars
4349,387,14,1727.0,2,5,4,11,At Risk
4350,792,8,882.2499999999999,1,2,2,5,Hibernating
4351,515,10,582.62,1,3,1,5,Regulars
4352,262,8,933.15,2,2,2,6,Hibernating
4353,78,8,549.71,4,2,1,7,Regulars
4354,121,11,2804.69,4,3,5,12,Loyal
4355,654,8,878.5200000000001,1,2,2,5,Hibernating
4356,114,16,2478.94,4,5,4,13,Champions
4357,976,7,944.25,1,1,2,4,Hibernating
4358,387,10,1197.05,2,3,2,7,Regulars
4359,478,5,401.52,1,1,1,3,Hibernating
4360,769,11,1364.98,1,3,3,7,Regulars
4361,308,13,862.7299999999999,2,4,2,8,At Risk
4362,358,7,4792.42,2,1,5,8,Regulars
4363,87,10,2437.73,4,3,4,11,Loyal
4364,928,11,1201.77,1,3,2,6,Regulars
4365,88,17,2842.94,4,5,5,14,Champions
4366,92,13,1811.81,4,4,4,12,Champions
4367,139,8,2094.8399999999997,4,2,4,10,Big Spenders
4368,156,11,1113.46,3,3,2,8,Regulars
4369,350,8,639.33,2,2,1,5,Hibernating
4370,220,9,1275.92,3,2,3,8,Regulars
4371,93,14,1846.66,4,5,4,13,Champions
4372,252,11,3364.61,2,3,5,10,Regulars
4373,120,13,1542.97,4,4,3,11,Loyal
4374,218,12,2059.53,3,4,4,11,Big Spenders
4375,140,7,1612.6100000000001,4,1,3,8,Regulars
4376,195,12,1180.27,3,4,2,9,Regulars
4377,142,10,1430.54,4,3,3,10,Loyal
4378,42,9,1583.3500000000001,5,2,3,10,Regulars
4379,285,12,2243.62,2,4,4,10,At Risk
4380,405,10,1825.31,2,3,4,9,Regulars
4381,494,13,1167.3700000000001,1,4,2,7,At Risk
4382,65,12,1320.6,5,4,3,12,Loyal
4383,313,10,2229.77,2,3,4,9,Regulars
4384,245,14,1726.08,3,5,4,12,Big Spenders
4385,158,15,3948.76,3,5,5,13,Big Spenders
4386,738,11,1183.06,1,3,2,6,Regulars
4387,860,4,606.41,1,1,1,3,Hibernating
4388,458,11,1398.98,2,3,3,8,Regulars
4389,555,9,764.09,1,2,1,4,Hibernating
4390,971,10,984.88,1,3,2,6,Regulars
4391,41,11,1274.8,5,3,3,11,Loyal
4392,1041,5,514.67,1,1,1,3,Hibernating
4393,96,13,2039.05,4,4,4,12,Champions
4394,75,9,825.66,4,2,1,7,Regulars
4395,272,13,1086.68,2,4,2,8,At Risk
4396,34,9,1170.99,5,2,2,9,Regulars
4397,105,5,274.74,4,1,1,6,Regulars
4398,142,13,1803.23,4,4,4,12,Champions
4399,54,9,884.8,5,2,2,9,Regulars
4400,11,14,1939.3000000000002,5,5,4,14,Champions
4401,130,9,2885.0599999999995,4,2,5,11,Big Spenders
4402,260,10,2121.02,2,3,4,9,Regulars
4403,160,12,1387.18,3,4,3,10,Regulars
4404,286,8,958.96,2,2,2,6,Hibernating
4405,176,14,4516.79,3,5,5,13,Big Spenders
4406,199,7,512.91,3,1,1,5,Regulars
4407,1104,9,2835.02,1,2,5,8,Regulars
4408,450,15,1513.79,2,5,3,10,At Risk
4409,40,7,2029.79,5,1,4,10,Big Spenders
4410,293,8,1834.52,2,2,4,8,Regulars
4411,5,14,2063.67,5,5,4,14,Champions
4412,135,10,946.36,4,3,2,9,Loyal
4413,126,17,1478.47,4,5,3,12,Loyal
4414,416,4,360.12,2,1,1,4,Hibernating
4415,1528,7,743.03,1,1,1,3,Hibernating
4416,213,12,2418.92,3,4,4,11,Big Spenders
4417,347,10,1529.71,2,3,3,8,Regulars
4418,122,9,757.85,4,2,1,7,Regulars
4419,190,16,4671.860000000001,3,5,5,13,Big Spenders
4420,106,10,3797.32,4,3,5,12,Loyal
4421,517,8,1226.35,1,2,2,5,Hibernating
4422,182,10,1791.23,3,3,4,10,Big Spenders
4423,179,11,1132.41,3,3,2,8,Regulars
4424,28,12,3397.13,5,4,5,14,Champions
4425,108,13,2640.01,4,4,5,13,Champions
4426,200,12,1156.17,3,4,2,9,Regulars
4427,1169,5,3010.07,1,1,5,7,Regulars
4428,79,14,4136.8,4,5,5,14,Champions
4429,519,14,4375.09,1,5,5,11,At Risk
4430,283,15,2743.7099999999996,2,5,5,12,At Risk
4431,485,6,581.81,1,1,1,3,Hibernating
4432,96,13,2551.71,4,4,4,12,Champions
4433,614,6,2218.97,1,1,4,6,Regulars
4434,702,7,445.56,1,1,1,3,Hibernating
4435,218,7,812.4,3,1,1,5,Regulars
4436,69,15,1909.48,4,5,4,13,Champions
4437,1667,3,1027.67,1,1,2,4,Hibernating
4438,845,8,3699.4900000000007,1,2,5,8,Regulars
4439,551,10,2387.16,1,3,4,8,Regulars
4440,69,9,1619.9,4,2,3,9,Regulars
4441,156,7,2827.21,3,1,5,9,Big Spenders
4442,301,12,1113.04,2,4,2,8,At Risk
4443,241,8,1055.65,3,2,2,7,Regulars
4444,28,15,1516.28,5,5,3,13,Loyal
4445,1265,6,577.9,1,1,1,3,Hibernating
4446,484,9,958.42,1,2,2,5,Hibernating
4447,258,14,1775.71,2,5,4,11,At Risk
4448,61,12,1278.41,5,4,3,12,Loyal
4449,23,13,2896.0,5,4,5,14,Champions
4450,295,11,3432.65,2,3,5,10,Regulars
4451,249,9,2294.71,2,2,4,8,Regulars
4452,355,7,726.16,2,1,1,4,Hibernating
4453,648,6,741.38,1,1,1,3,Hibernating
4454,187,10,1174.0,3,3,2,8,Regulars
4455,534,13,2583.14,1,4,5,10,At Risk
4456,955,3,3247.0299999999997,1,1,5,7,Regulars
4457,265,15,5261.87,2,5,5,12,At Risk
4458,154,12,2481.48,3,4,4,11,Big Spenders
4459,14,18,5922.64,5,5,5,15,Champions
4460,2,10,2018.4299999999998,5,3,4,12,Loyal
4461,676,9,3569.42,1,2,5,8,Regulars
4462,340,8,1117.11,2,2,2,6,Hibernating
4463,7,6,1542.58,5,1,3,9,Regulars
4464,109,15,2088.86,4,5,4,13,Champions
4465,247,14,1698.49,3,5,3,11,Regulars
4466,295,6,277.81,2,1,1,4,Hibernating
4467,189,10,917.66,3,3,2,8,Regulars
4468,123,7,3148.73,4,1,5,10,Big Spenders
4469,156,7,1646.1299999999999,3,1,3,7,Regulars
4470,1606,3,625.56,1,1,1,3,Hibernating
4471,177,10,2311.81,3,3,4,10,Big Spenders
4472,900,4,642.24,1,1,1,3,Hibernating
4473,126,13,2946.9,4,4,5,13,Champions
4474,92,9,1248.96,4,2,3,9,Regulars
4475,31,10,723.4499999999999,5,3,1,9,Loyal
4476,52,8,410.74,5,2,1,8,Regulars
4477,223,10,1143.43,3,3,2,8,Regulars
4478,66,11,1542.9,4,3,3,10,Loyal
4479,156,2,246.24,3,1,1,5,Regulars
4480,27,12,2328.59,5,4,4,13,Champions
4481,345,10,1040.3799999999999,2,3,2,7,Regulars
4482,147,13,4429.099999999999,4,4,5,13,Champions
4483,179,9,777.23,3,2,1,6,Regulars
4484,312,9,933.11,2,2,2,6,Hibernating
4485,64,11,628.01,5,3,1,9,Loyal
4486,445,13,1357.58,2,4,3,9,At Risk
4487,614,16,1966.27,1,5,4,10,At Risk
4488,2,11,1957.77,5,3,4,12,Loyal
4489,50,18,5183.32,5,5,5,15,Champions
4490,5,13,1070.86,5,4,2,11,Loyal
4491,237,8,951.56,3,2,2,7,Regulars
4492,462,8,2211.39,1,2,4,7,Regulars
4493,531,11,1810.05,1,3,4,8,Regulars
4494,192,5,213.0,3,1,1,5,Regulars
4495,623,7,708.67,1,1,1,3,Hibernating
4496,91,12,856.25,4,4,2,10,Loyal
4497,423,6,1022.78,2,1,2,5,Hibernating
4498,129,11,2597.7799999999997,4,3,5,12,Loyal
4499,132,12,1504.4299999999998,4,4,3,11,Loyal
4500,568,7,1061.41,1,1,2,4,Hibernating
4501,515,9,5740.929999999999,1,2,5,8,Regulars
4502,55,6,1236.2199999999998,5,1,2,8,Regulars
4503,0,11,1000.2,5,3,2,10,Loyal
4504,87,11,2788.7999999999997,4,3,5,12,Loyal
4505,29,5,433.99,5,1,1,7,Regulars
4506,443,9,2849.96,2,2,5,9,Regulars
4507,48,13,1639.1200000000001,5,4,3,12,Loyal
4508,152,11,884.61,3,3,2,8,Regulars
4509,121,7,699.71,4,1,1,6,Regulars
4510,578,6,895.7900000000001,1,1,2,4,Hibernating
4511,287,9,826.68,2,2,1,5,Hibernating
4512,247,7,780.87,3,1,1,5,Regulars
4513,692,15,1810.48,1,5,4,10,At Risk
4514,21,9,660.29,5,2,1,8,Regulars
4515,318,8,1310.6499999999999,2,2,3,7,Regulars
4516,97,10,1439.49,4,3,3,10,Loyal
4517,392,8,1829.0900000000001,2,2,4,8,Regulars
4518,339,10,2173.44,2,3,4,9,Regulars
4519,122,13,1832.52,4,4,4,12,Champions
4520,27,12,1168.89,5,4,2,11,Loyal
4521,52,11,3582.6,5,3,5,13,Loyal
4522,34,16,1682.88,5,5,3,13,Loyal
4523,46,20,6009.54,5,5,5,15,Champions
4524,552,13,3801.9900000000002,1,4,5,10,At Risk
4525,904,5,340.51,1,1,1,3,Hibernating
4526,425,7,455.44,2,1,1,4,Hibernating
4527,30,13,2733.7299999999996,5,4,5,14,Champions
4528,65,18,1826.98,5,5,4,14,Champions
4529,234,8,3924.62,3,2,5,10,Big Spenders
4530,21,13,1698.35,5,4,3,12,Loyal
4531,72,13,1154.55,4,4,2,10,Loyal
4532,1326,3,345.33,1,1,1,3,Hibernating
4533,11,15,2138.07,5,5,4,14,Champions
4534,89,7,1480.11,4,1,3,8,Regulars
4535,65,12,1422.03,5,4,3,12,Loyal
4536,51,8,1265.24,5,2,3,10,Regulars
4537,49,16,3190.22,5,5,5,15,Champions
4538,50,10,568.49,5,3,1,9,Loyal
4539,4,6,539.13,5,1,1,7,Regulars
4540,8,16,1652.98,5,5,3,13,Loyal
4541,8,10,1254.02,5,3,3,11,Loyal
4542,110,11,1274.8200000000002,4,3,3,10,Loyal
4543,148,14,1904.22,3,5,4,12,Big Spenders
4544,791,4,208.26,1,1,1,3,Hibernating
4545,471,8,1659.74,1,2,3,6,Regulars
4546,544,3,116.42,1,1,1,3,Hibernating
4547,446,7,465.75,2,1,1,4,Hibernating
4548,67,12,960.37,4,4,2,10,Loyal
4549,1120,8,607.1999999999999,1,2,1,4,Hibernating
4550,137,13,1619.56,4,4,3,11,Loyal
4551,135,9,2287.29,4,2,4,10,Big Spenders
4552,10,13,2252.87,5,4,4,13,Champions
4553,145,7,1686.23,4,1,3,8,Regulars
4554,210,12,2267.63,3,4,4,11,Big Spenders
4555,242,12,1563.78,3,4,3,10,Regulars
4556,0,9,2726.7,5,2,5,12,Big Spenders
4557,59,9,2368.44,5,2,4,11,Big Spenders
4558,418,9,1101.78,2,2,2,6,Hibernating
4559,212,11,2225.41,3,3,4,10,Big Spenders
4560,331,13,2437.4700000000003,2,4,4,10,At Risk
4561,68,11,681.22,4,3,1,8,Loyal
4562,26,9,1212.2600000000002,5,2,2,9,Regulars
4563,801,9,951.5,1,2,2,5,Hibernating
4564,149,12,1326.54,3,4,3,10,Regulars
4565,7,10,1767.1,5,3,4,12,Loyal
4566,78,12,1646.8999999999999,4,4,3,11,Loyal
4567,8,10,2097.72,5,3,4,12,Loyal
4568,337,8,2452.0300000000007,2,2,4,8,Regulars
4569,116,9,1987.04,4,2,4,10,Big Spenders
4570,229,6,691.73,3,1,1,5,Regulars
4571,76,8,832.75,4,2,1,7,Regulars
4572,110,9,958.5,4,2,2,8,Regulars
4573,65,13,1629.8600000000001,5,4,3,12,Loyal
4574,173,13,1399.94,3,4,3,10,Regulars
4575,31,16,1269.57,5,5,3,13,Loyal
4576,54,15,3599.26,5,5,5,15,Champions
4577,338,7,726.8499999999999,2,1,1,4,Hibernating
4578,159,10,1116.45,3,3,2,8,Regulars
4579,274,11,3670.2200000000003,2,3,5,10,Regulars
4580,646,8,977.1800000000001,1,2,2,5,Hibernating
4581,249,12,660.4300000000001,2,4,1,7,At Risk
4582,753,7,984.01,1,1,2,4,Hibernating
4583,65,8,1499.01,5,2,3,10,Regulars
4584,109,10,1805.96,4,3,4,11,Loyal
4585,123,9,577.84,4,2,1,7,Regulars
4586,310,9,1919.07,2,2,4,8,Regulars
4587,526,3,192.85000000000002,1,1,1,3,Hibernating
4588,36,7,530.84,5,1,1,7,Regulars
4589,235,11,1991.27,3,3,4,10,Big Spenders
4590,8,9,2341.56,5,2,4,11,Big Spenders
4591,124,7,699.91,4,1,1,6,Regulars
4592,178,8,1454.99,3,2,3,8,Regulars
4593,152,5,820.18,3,1,1,5,Regulars
4594,190,13,2498.98,3,4,4,11,Big Spenders
4595,64,12,1898.13,5,4,4,13,Champions
4596,261,8,1437.31,2,2,3,7,Regulars
4597,105,10,1653.69,4,3,3,10,Loyal
4598,23,11,1557.47,5,3,3,11,Loyal
4599,568,10,3627.7,1,3,5,9,Regulars
4600,185,7,2183.06,3,1,4,8,Big Spenders
4601,237,12,2522.41,3,4,4,11,Big Spenders
4602,181,12,1881.3700000000001,3,4,4,11,Big Spenders
4603,47,15,4231.63,5,5,5,15,Champions
4604,17,14,3069.8500000000004,5,5,5,15,Champions
4605,9,22,3830.09,5,5,5,15,Champions
4606,195,12,1448.98,3,4,3,10,Regulars
4607,81,13,4572.629999999999,4,4,5,13,Champions
4608,205,10,2000.3,3,3,4,10,Big Spenders
4609,97,11,1428.48,4,3,3,10,Loyal
4610,85,10,1975.9699999999998,4,3,4,11,Loyal
4611,85,10,885.87,4,3,2,9,Loyal
4612,328,10,3197.09,2,3,5,10,Regulars
4613,285,10,1544.81,2,3,3,8,Regulars
4614,172,8,337.21,3,2,1,6,Regulars
4615,12,12,1408.69,5,4,3,12,Loyal
4616,113,9,1549.13,4,2,3,9,Regulars
4617,268,10,1683.58,2,3,3,8,Regulars
4618,120,13,2869.94,4,4,5,13,Champions
4619,149,14,3977.57,3,5,5,13,Big Spenders
4620,484,11,1436.83,1,3,3,7,Regulars
4621,623,5,481.53999999999996,1,1,1,3,Hibernating
4622,553,15,2909.63,1,5,5,11,At Risk
4623,802,5,2216.87,1,1,4,6,Regulars
4624,55,12,1252.98,5,4,3,12,Loyal
4625,15,13,1302.1,5,4,3,12,Loyal
4626,108,7,2226.31,4,1,4,9,Big Spenders
4627,88,14,2576.13,4,5,5,14,Champions
4628,298,9,1807.51,2,2,4,8,Regulars
4629,82,7,317.28000000000003,4,1,1,6,Regulars
4630,195,10,4741.849999999999,3,3,5,11,Big Spenders
4631,162,9,737.53,3,2,1,6,Regulars
4632,99,13,1826.97,4,4,4,12,Champions
4633,68,9,1350.01,4,2,3,9,Regulars
4634,134,20,4280.7,4,5,5,14,Champions
4635,153,12,1511.07,3,4,3,10,Regulars
4636,742,11,1701.8999999999999,1,3,3,7,Regulars
4637,623,6,935.91,1,1,2,4,Hibernating
4638,441,12,4001.0299999999997,2,4,5,11,At Risk
4639,228,12,3641.15,3,4,5,12,Big Spenders
4640,333,9,1140.25,2,2,2,6,Hibernating
4641,188,9,1049.8899999999999,3,2,2,7,Regulars
4642,145,11,2355.67,4,3,4,11,Loyal
4643,47,7,477.52,5,1,1,7,Regulars
4644,216,9,1924.61,3,2,4,9,Big Spenders
4645,295,13,1799.6100000000001,2,4,4,10,At Risk
4646,301,6,2135.79,2,1,4,7,Regulars
4647,803,11,2278.72,1,3,4,8,Regulars
4648,189,14,4476.839999999999,3,5,5,13,Big Spenders
4649,719,12,1888.36,1,4,4,9,At Risk
4650,35,15,3041.23,5,5,5,15,Champions
4651,1297,5,598.78,1,1,1,3,Hibernating
4652,270,13,1109.1,2,4,2,8,At Risk
4653,165,12,1234.79,3,4,2,9,Regulars
4654,74,16,1748.04,4,5,4,13,Champions
4655,127,11,1175.45,4,3,2,9,Loyal
4656,1538,7,669.1999999999999,1,1,1,3,Hibernating
4657,644,10,1152.17,1,3,2,6,Regulars
4658,435,11,1972.3799999999999,2,3,4,9,Regulars
4659,1720,8,806.67,1,2,1,4,Hibernating
4660,81,12,1296.69,4,4,3,11,Loyal
4661,206,9,2005.9,3,2,4,9,Big Spenders
4662,184,12,1664.29,3,4,3,10,Regulars
4663,19,13,1481.56,5,4,3,12,Loyal
4664,46,5,694.2900000000001,5,1,1,7,Regulars
4665,122,18,2018.71,4,5,4,13,Champions
4666,330,15,4494.62,2,5,5,12,At Risk
4667,178,5,327.81,3,1,1,5,Regulars
4668,148,9,1477.84,3,2,3,8,Regulars
4669,290,9,1107.56,2,2,2,6,Hibernating
4670,3,11,849.02,5,3,2,10,Loyal
4671,188,6,361.99,3,1,1,5,Regulars
4672,418,11,2314.18,2,3,4,9,Regulars
4673,65,15,1874.01,5,5,4,14,Champions
4674,251,17,3119.58,2,5,5,12,At Risk
4675,42,9,968.46,5,2,2,9,Regulars
4676,472,11,1505.1999999999998,1,3,3,7,Regulars
4677,398,5,1125.26,2,1,2,5,Hibernating
4678,107,8,727.07,4,2,1,7,Regulars
4679,37,13,2608.4700000000003,5,4,5,14,Champions
4680,83,15,2776.21,4,5,5,14,Champions
4681,76,10,3577.28,4,3,5,12,Loyal
4682,582,12,1975.3899999999999,1,4,4,9,At Risk
4683,101,14,3721.9900000000002,4,5,5,14,Champions
4684,1688,5,370.48,1,1,1,3,Hibernating
4685,5,10,1919.93,5,3,4,12,Loyal
4686,533,13,1029.9399999999998,1,4,2,7,At Risk
4687,106,15,849.05,4,5,2,11,Loyal
4688,9,12,4343.87,5,4,5,14,Champions
4689,27,14,2412.73,5,5,4,14,Champions
4690,426,10,834.61,2,3,1,6,Regulars
4691,151,8,1860.76,3,2,4,9,Big Spenders
4692,45,10,999.29,5,3,2,10,Loyal
4693,30,14,1720.42,5,5,3,13,Loyal
4694,301,8,1009.77,2,2,2,6,Hibernating
4695,255,14,1584.96,2,5,3,10,At Risk
4696,322,9,1155.95,2,2,2,6,Hibernating
4697,862,9,790.72,1,2,1,4,Hibernating
4698,35,14,1832.76,5,5,4,14,Champions
4699,147,11,1617.6399999999999,4,3,3,10,Loyal
4700,52,13,2956.94,5,4,5,14,Champions
4701,445,9,2488.25,2,2,4,8,Regulars
4702,37,14,2649.15,5,5,5,15,Champions
4703,24,6,2889.26,5,1,5,11,Big Spenders
4704,153,12,1677.0,3,4,3,10,Regulars
4705,500,10,1288.2,1,3,3,7,Regulars
4706,67,13,1304.87,4,4,3,11,Loyal
4707,211,9,1356.3600000000001,3,2,3,8,Regulars
4708,190,14,1351.66,3,5,3,11,Regulars
4709,284,10,632.26,2,3,1,6,Regulars
4710,54,14,1748.99,5,5,4,14,Champions
4711,224,15,2183.37,3,5,4,12,Big Spenders
4712,427,9,2511.45,2,2,4,8,Regulars
4713,154,10,1652.32,3,3,3,9,Regulars
4714,100,16,2594.91,4,5,5,14,Champions
4715,88,14,6404.75,4,5,5,14,Champions
4716,54,7,2779.43,5,1,5,11,Big Spenders
4717,105,9,4726.08,4,2,5,11,Big Spenders
4718,5,12,1168.45,5,4,2,11,Loyal
4719,46,12,836.13,5,4,1,10,Loyal
4720,63,13,2524.46,5,4,4,13,Champions
4721,750,16,2194.77,1,5,4,10,At Risk
4722,470,10,1732.61,1,3,4,8,Regulars
4723,324,9,1032.8899999999999,2,2,2,6,Hibernating
4724,172,15,3217.19,3,5,5,13,Big Spenders
4725,85,9,560.86,4,2,1,7,Regulars
4726,105,10,3137.5,4,3,5,12,Loyal
4727,720,8,902.11,1,2,2,5,Hibernating
4728,270,7,661.15,2,1,1,4,Hibernating
4729,199,9,1369.93,3,2,3,8,Regulars
4730,4,11,1018.98,5,3,2,10,Loyal
4731,206,5,806.09,3,1,1,5,Regulars
4732,227,4,332.68,3,1,1,5,Regulars
4733,467,8,511.81,1,2,1,4,Hibernating
4734,0,6,2663.8900000000003,5,1,5,11,Big Spenders
4735,168,8,506.78999999999996,3,2,1,6,Regulars
4736,164,11,1216.3400000000001,3,3,2,8,Regulars
4737,339,8,600.12,2,2,1,5,Hibernating
4738,340,8,672.87,2,2,1,5,Hibernating
4739,549,10,909.25,1,3,2,6,Regulars
4740,23,10,1666.3999999999999,5,3,3,11,Loyal
4741,160,8,1792.01,3,2,4,9,Big Spenders
4742,161,13,708.44,3,4,1,8,Regulars
4743,140,7,2097.02,4,1,4,9,Big Spenders
4744,127,15,1857.6699999999998,4,5,4,13,Champions
4745,178,17,3912.33,3,5,5,13,Big Spenders
4746,187,12,1961.19,3,4,4,11,Big Spenders
4747,607,9,660.99,1,2,1,4,Hibernating
4748,10,11,768.12,5,3,1,9,Loyal
4749,1101,7,870.62,1,1,2,4,Hibernating
4750,319,8,374.06,2,2,1,5,Hibernating
4751,65,13,2325.6,5,4,4,13,Champions
4752,4,7,1103.17,5,1,2,8,Regulars
4753,213,8,909.08,3,2,2,7,Regulars
4754,123,9,2474.6800000000003,4,2,4,10,Big Spenders
4755,737,8,962.26,1,2,2,5,Hibernating
4756,37,7,1122.86,5,1,2,8,Regulars
4757,120,13,1052.49,4,4,2,10,Loyal
4758,42,11,926.35,5,3,2,10,Loyal
4759,110,13,2400.5299999999997,4,4,4,12,Champions
4760,495,3,279.77,1,1,1,3,Hibernating
4761,585,8,1059.8999999999999,1,2,2,5,Hibernating
4762,287,10,2697.13,2,3,5,10,Regulars
4763,43,7,1380.35,5,1,3,9,Regulars
4764,324,6,1330.1999999999998,2,1,3,6,Regulars
4765,812,12,1457.27,1,4,3,8,At Risk
4766,252,13,4925.59,2,4,5,11,At Risk
4767,11,7,935.51,5,1,2,8,Regulars
4768,147,17,1689.92,4,5,3,12,Loyal
4769,1051,7,984.1700000000001,1,1,2,4,Hibernating
4770,178,5,384.45,3,1,1,5,Regulars
4771,184,10,1945.3,3,3,4,10,Big Spenders
4772,277,10,1359.59,2,3,3,8,Regulars
4773,11,10,1009.7,5,3,2,10,Loyal
4774,265,13,3086.5899999999997,2,4,5,11,At Risk
4775,92,9,1098.2,4,2,2,8,Regulars
4776,1019,7,2463.71,1,1,4,6,Regulars
4777,35,19,3241.5,5,5,5,15,Champions
4778,145,8,443.35,4,2,1,7,Regulars
4779,440,6,340.84000000000003,2,1,1,4,Hibernating
4780,187,11,1198.99,3,3,2,8,Regulars
4781,515,8,3326.62,1,2,5,8,Regulars
4782,209,13,3041.3099999999995,3,4,5,12,Big Spenders
4783,303,17,3591.2200000000003,2,5,5,12,At Risk
4784,369,9,1531.8600000000001,2,2,3,7,Regulars
4785,165,7,1467.8000000000002,3,1,3,7,Regulars
4786,460,12,1904.13,1,4,4,9,At Risk
4787,253,10,1428.68,2,3,3,8,Regulars
4788,229,13,3739.15,3,4,5,12,Big Spenders
4789,316,11,1157.2,2,3,2,7,Regulars
4790,252,8,1111.41,2,2,2,6,Hibernating
4791,208,9,722.13,3,2,1,6,Regulars
4792,241,11,1189.5900000000001,3,3,2,8,Regulars
4793,1263,6,283.36,1,1,1,3,Hibernating
4794,31,13,1328.3200000000002,5,4,3,12,Loyal
4795,193,6,1031.69,3,1,2,6,Regulars
4796,400,10,741.88,2,3,1,6,Regulars
4797,858,8,3482.4200000000005,1,2,5,8,Regulars
4798,127,9,2811.6600000000003,4,2,5,11,Big Spenders
4799,779,9,694.99,1,2,1,4,Hibernating
4800,27,6,472.49,5,1,1,7,Regulars
4801,6,9,1043.1,5,2,2,9,Regulars
4802,538,14,1381.67,1,5,3,9,At Risk
4803,146,12,1299.55,4,4,3,11,Loyal
4804,619,12,1103.35,1,4,2,7,At Risk
4805,125,8,423.91,4,2,1,7,Regulars
4806,93,8,666.14,4,2,1,7,Regulars
4807,758,7,3936.82,1,1,5,7,Regulars
4808,202,9,930.8199999999999,3,2,2,7,Regulars
4809,189,8,988.25,3,2,2,7,Regulars
4810,272,6,1835.3700000000001,2,1,4,7,Regulars
4811,383,8,2871.71,2,2,5,9,Regulars
4812,363,9,1650.6599999999999,2,2,3,7,Regulars
4813,81,8,3098.53,4,2,5,11,Big Spenders
4814,247,10,2821.24,3,3,5,11,Big Spenders
4815,8,11,2117.52,5,3,4,12,Loyal
4816,27,12,2189.81,5,4,4,13,Champions
4817,572,11,869.12,1,3,2,6,Regulars
4818,371,9,948.86,2,2,2,6,Hibernating
4819,53,11,2849.07,5,3,5,13,Loyal
4820,214,14,1613.74,3,5,3,11,Regulars
4821,153,8,1742.51,3,2,4,9,Big Spenders
4822,496,11,3598.1499999999996,1,3,5,9,Regulars
4823,155,13,1312.8899999999999,3,4,3,10,Regulars
4824,26,17,2399.77,5,5,4,14,Champions
4825,568,7,2690.84,1,1,5,7,Regulars
4826,340,12,3277.9900000000002,2,4,5,11,At Risk
4827,140,13,862.02,4,4,2,10,Loyal
4828,103,12,2816.02,4,4,5,13,Champions
4829,76,10,3570.0099999999998,4,3,5,12,Loyal
4830,13,11,1487.28,5,3,3,11,Loyal
4831,511,7,632.5500000000001,1,1,1,3,Hibernating
4832,307,8,1400.6399999999999,2,2,3,7,Regulars
4833,9,9,2198.09,5,2,4,11,Big Spenders
4834,363,20,3071.61,2,5,5,12,At Risk
4835,68,14,1810.25,4,5,4,13,Champions
4836,837,12,2010.45,1,4,4,9,At Risk
4837,33,11,2834.29,5,3,5,13,Loyal
4838,1069,10,1177.73,1,3,2,6,Regulars
4839,119,12,2575.4,4,4,5,13,Champions
4840,50,12,1266.74,5,4,3,12,Loyal
4841,216,12,2599.69,3,4,5,12,Big Spenders
4842,47,15,1036.38,5,5,2,12,Loyal
4843,214,11,2782.0699999999997,3,3,5,11,Big Spenders
4844,559,7,586.49,1,1,1,3,Hibernating
4845,220,11,1903.51,3,3,4,10,Big Spenders
4846,300,4,556.8100000000001,2,1,1,4,Hibernating
4847,72,17,3267.21,4,5,5,14,Champions
4848,350,5,423.96000000000004,2,1,1,4,Hibernating
4849,167,10,906.2099999999999,3,3,2,8,Regulars
4850,124,15,1735.83,4,5,4,13,Champions
4851,737,8,1140.33,1,2,2,5,Hibernating
4852,76,10,1617.6799999999998,4,3,3,10,Loyal
4853,139,16,3163.33,4,5,5,14,Champions
4854,981,4,309.19,1,1,1,3,Hibernating
4855,560,5,1621.28,1,1,3,5,Regulars
4856,237,10,3487.98,3,3,5,11,Big Spenders
4857,1229,11,1649.8899999999999,1,3,3,7,Regulars
4858,84,7,624.4399999999999,4,1,1,6,Regulars
4859,596,8,787.22,1,2,1,4,Hibernating
4860,189,3,522.66,3,1,1,5,Regulars
4861,229,17,2808.8300000000004,3,5,5,13,Big Spenders
4862,278,16,3566.92,2,5,5,12,At Risk
4863,623,5,2748.67,1,1,5,7,Regulars
4864,45,9,911.57,5,2,2,9,Regulars
4865,204,12,2313.21,3,4,4,11,Big Spenders
4866,108,10,1922.2800000000002,4,3,4,11,Loyal
4867,125,15,3534.24,4,5,5,14,Champions
4868,629,12,3114.86,1,4,5,10,At Risk
4869,68,12,3561.8199999999997,4,4,5,13,Champions
4870,334,5,543.42,2,1,1,4,Hibernating
4871,41,10,1751.8,5,3,4,12,Loyal
4872,18,14,1526.64,5,5,3,13,Loyal
4873,467,11,1052.3200000000002,1,3,2,6,Regulars
4874,447,8,469.53999999999996,2,2,1,5,Hibernating
4875,224,21,2137.87,3,5,4,12,Big Spenders
4876,64,16,2319.98,5,5,4,14,Champions
4877,22,13,2120.42,5,4,4,13,Champions
4878,271,12,3821.7999999999997,2,4,5,11,At Risk
4879,35,9,935.57,5,2,2,9,Regulars
4880,320,11,1001.48,2,3,2,7,Regulars
4881,604,10,1148.73,1,3,2,6,Regulars
4882,516,13,1589.9299999999998,1,4,3,8,At Risk
4883,577,10,2316.46,1,3,4,8,Regulars
4884,413,6,477.53,2,1,1,4,Hibernating
4885,122,10,2848.15,4,3,5,12,Loyal
4886,516,5,2813.21,1,1,5,7,Regulars
4887,83,16,3768.14,4,5,5,14,Champions
4888,651,6,4591.43,1,1,5,7,Regulars
4889,289,9,840.0699999999999,2,2,1,5,Hibernating
4890,565,10,748.99,1,3,1,5,Regulars
4891,503,11,906.53,1,3,2,6,Regulars
4892,38,10,1370.75,5,3,3,11,Loyal
4893,161,16,1523.76,3,5,3,11,Regulars
4894,28,9,790.25,5,2,1,8,Regulars
4895,5,12,3870.88,5,4,5,14,Champions
4896,15,14,2490.0,5,5,4,14,Champions
4897,96,8,909.37,4,2,2,8,Regulars
4898,212,8,1161.45,3,2,2,7,Regulars
4899,107,16,2447.87,4,5,4,13,Champions
4900,524,9,1911.59,1,2,4,7,Regulars
4901,97,11,2531.41,4,3,4,11,Loyal
4902,9,14,1912.3600000000001,5,5,4,14,Champions
4903,151,15,1350.56,3,5,3,11,Regulars
4904,475,15,6033.96,1,5,5,11,At Risk
4905,188,8,708.48,3,2,1,6,Regulars
4906,221,7,1073.71,3,1,2,6,Regulars
4907,133,9,873.06,4,2,2,8,Regulars
4908,639,9,3024.75,1,2,5,8,Regulars
4909,134,13,1164.14,4,4,2,10,Loyal
4910,295,10,2535.95,2,3,4,9,Regulars
4911,23,7,950.06,5,1,2,8,Regulars
4912,106,8,607.69,4,2,1,7,Regulars
4913,983,4,263.84000000000003,1,1,1,3,Hibernating
4914,32,9,1031.59,5,2,2,9,Regulars
4915,183,7,1563.37,3,1,3,7,Regulars
4916,140,13,1081.66,4,4,2,10,Loyal
4917,312,7,895.62,2,1,2,5,Hibernating
4918,703,10,1205.4,1,3,2,6,Regulars
4919,45,7,661.83,5,1,1,7,Regulars
4920,114,8,1405.22,4,2,3,9,Regulars
4921,72,10,1372.08,4,3,3,10,Loyal
4922,356,7,929.94,2,1,2,5,Hibernating
4923,209,10,2428.19,3,3,4,10,Big Spenders
4924,145,12,1423.72,4,4,3,11,Loyal
4925,437,11,2930.12,2,3,5,10,Regulars
4926,14,10,1433.72,5,3,3,11,Loyal
4927,161,19,5452.71,3,5,5,13,Big Spenders
4928,180,12,2074.83,3,4,4,11,Big Spenders
4929,933,6,2311.18,1,1,4,6,Regulars
4930,126,10,1112.79,4,3,2,9,Loyal
4931,92,9,1363.1499999999999,4,2,3,9,Regulars
4932,57,7,442.40999999999997,5,1,1,7,Regulars
4933,723,6,424.15,1,1,1,3,Hibernating
4934,90,9,1791.26,4,2,4,10,Big Spenders
4935,40,14,3707.3900000000003,5,5,5,15,Champions
4936,247,10,1641.6100000000001,3,3,3,9,Regulars
4937,418,10,838.1,2,3,1,6,Regulars
4938,256,13,3787.1499999999996,2,4,5,11,At Risk
4939,33,13,1029.76,5,4,2,11,Loyal
4940,20,11,1342.71,5,3,3,11,Loyal
4941,237,11,1376.25,3,3,3,9,Regulars
4942,260,13,4600.110000000001,2,4,5,11,At Risk
4943,153,4,271.83,3,1,1,5,Regulars
4944,328,6,661.02,2,1,1,4,Hibernating
4945,74,10,1331.8999999999999,4,3,3,10,Loyal
4946,17,7,2995.1400000000003,5,1,5,11,Big Spenders
4947,75,12,1229.17,4,4,2,10,Loyal
4948,98,13,2182.66,4,4,4,12,Champions
4949,16,9,869.83,5,2,2,9,Regulars
4950,345,10,3243.37,2,3,5,10,Regulars
4951,79,14,1905.4299999999998,4,5,4,13,Champions
4952,75,18,6318.01,4,5,5,14,Champions
4953,213,7,877.7,3,1,2,6,Regulars
4954,945,8,1075.77,1,2,2,5,Hibernating
4955,23,8,813.22,5,2,1,8,Regulars
4956,155,8,2252.0699999999997,3,2,4,9,Big Spenders
4957,166,12,2205.31,3,4,4,11,Big Spenders
4958,139,11,1352.49,4,3,3,10,Loyal
4959,433,6,783.21,2,1,1,4,Hibernating
4960,31,15,1901.2399999999998,5,5,4,14,Champions
4961,264,12,875.47,2,4,2,8,At Risk
4962,152,10,863.78,3,3,2,8,Regulars
4963,41,6,563.76,5,1,1,7,Regulars
4964,249,16,3838.3100000000004,2,5,5,12,At Risk
4965,39,9,994.9399999999999,5,2,2,9,Regulars
4966,271,10,1011.37,2,3,2,7,Regulars
4967,22,16,3321.31,5,5,5,15,Champions
4968,594,11,2185.81,1,3,4,8,Regulars
4969,8,14,3204.65,5,5,5,15,Champions
4970,124,9,820.0799999999999,4,2,1,7,Regulars
4971,66,9,771.46,4,2,1,7,Regulars
4972,3,12,1365.42,5,4,3,12,Loyal
4973,129,8,2429.78,4,2,4,10,Big Spenders
4974,483,19,3166.69,1,5,5,11,At Risk
4975,9,13,2370.94,5,4,4,13,Champions
4976,299,13,1776.1,2,4,4,10,At Risk
4977,103,9,806.17,4,2,1,7,Regulars
4978,53,11,2281.48,5,3,4,12,Loyal
4979,6,9,3024.11,5,2,5,12,Big Spenders
4980,100,15,1559.33,4,5,3,12,Loyal
4981,46,12,1566.47,5,4,3,12,Loyal
4982,212,8,1904.94,3,2,4,9,Big Spenders
4983,448,8,775.1,2,2,1,5,Hibernating
4984,903,6,499.28,1,1,1,3,Hibernating
4985,620,4,196.52999999999997,1,1,1,3,Hibernating
4986,382,6,785.44,2,1,1,4,Hibernating
4987,174,10,936.5,3,3,2,8,Regulars
4988,264,10,1051.66,2,3,2,7,Regulars
4989,282,4,354.72999999999996,2,1,1,4,Hibernating
4990,678,7,854.46,1,1,2,4,Hibernating
4991,267,16,2325.71,2,5,4,11,At Risk
4992,31,16,5062.09,5,5,5,15,Champions
4993,57,9,1187.6,5,2,2,9,Regulars
4994,132,12,2996.84,4,4,5,13,Champions
4995,292,16,1667.01,2,5,3,10,At Risk
4996,83,14,6042.36,4,5,5,14,Champions
4997,202,12,863.16,3,4,2,9,Regulars
4998,73,7,597.96,4,1,1,6,Regulars
4999,185,6,386.95000000000005,3,1,1,5,Regulars
5000,124,8,1874.45,4,2,4,10,Big Spenders
5001,446,11,1146.52,2,3,2,7,Regulars
5002,236,6,543.58,3,1,1,5,Regulars
5003,149,14,1461.1,3,5,3,11,Regulars
5004,954,11,1142.3899999999999,1,3,2,6,Regulars
5005,91,16,2681.42,4,5,5,14,Champions
5006,167,8,382.67,3,2,1,6,Regulars
5007,723,9,682.66,1,2,1,4,Hibernating
5008,338,13,2361.6800000000003,2,4,4,10,At Risk
5009,171,6,2991.88,3,1,5,9,Big Spenders
5010,101,7,477.26,4,1,1,6,Regulars
5011,149,10,2532.99,3,3,4,10,Big Spenders
5012,245,12,2123.38,3,4,4,11,Big Spenders
5013,35,8,5330.13,5,2,5,12,Big Spenders
5014,118,9,1465.55,4,2,3,9,Regulars
5015,41,11,2650.4300000000003,5,3,5,13,Loyal
5016,115,12,727.96,4,4,1,9,Loyal
5017,84,10,2261.91,4,3,4,11,Loyal
5018,333,14,2490.89,2,5,4,11,At Risk
5019,9,12,887.8499999999999,5,4,2,11,Loyal
5020,11,12,2292.07,5,4,4,13,Champions
5021,129,10,2839.37,4,3,5,12,Loyal
5022,276,12,1942.16,2,4,4,10,At Risk
5023,322,7,1206.7,2,1,2,5,Hibernating
5024,538,9,1756.22,1,2,4,7,Regulars
5025,241,16,2302.4,3,5,4,12,Big Spenders
5026,26,13,1932.68,5,4,4,13,Champions
5027,54,9,1621.3,5,2,3,10,Regulars
5028,5,10,1207.09,5,3,2,10,Loyal
5029,158,13,1846.42,3,4,4,11,Big Spenders
5030,205,10,1236.6399999999999,3,3,2,8,Regulars
5031,17,10,928.21,5,3,2,10,Loyal
5032,521,15,3174.44,1,5,5,11,At Risk
5033,221,6,2820.06,3,1,5,9,Big Spenders
5034,556,8,1574.04,1,2,3,6,Regulars
5035,412,9,2817.84,2,2,5,9,Regulars
5036,45,15,3433.1499999999996,5,5,5,15,Champions
5037,566,12,2053.74,1,4,4,9,At Risk
5038,163,11,1107.14,3,3,2,8,Regulars
5039,67,12,2078.9700000000003,4,4,4,12,Champions
5040,894,7,1427.3199999999997,1,1,3,5,Regulars
5041,477,8,1654.09,1,2,3,6,Regulars
5042,545,8,577.45,1,2,1,4,Hibernating
5043,686,3,1424.29,1,1,3,5,Regulars
5044,211,11,1246.8400000000001,3,3,3,9,Regulars
5045,188,5,506.44,3,1,1,5,Regulars
5046,194,10,3688.5299999999997,3,3,5,11,Big Spenders
5047,36,8,990.52,5,2,2,9,Regulars
5048,691,10,1695.71,1,3,3,7,Regulars
5049,346,13,910.93,2,4,2,8,At Risk
5050,59,15,1213.01,5,5,2,12,Loyal
5051,187,11,2755.4300000000003,3,3,5,11,Big Spenders
5052,283,9,1119.72,2,2,2,6,Hibernating
5053,237,8,926.03,3,2,2,7,Regulars
5054,158,8,1644.31,3,2,3,8,Regulars
5055,47,8,766.3,5,2,1,8,Regulars
5056,530,6,1880.63,1,1,4,6,Regulars
5057,55,7,1400.7,5,1,3,9,Regulars
5058,861,5,624.9,1,1,1,3,Hibernating
5059,371,10,1723.72,2,3,3,8,Regulars
5060,130,10,3797.8799999999997,4,3,5,12,Loyal
5061,29,7,821.9,5,1,1,7,Regulars
5062,49,12,677.64,5,4,1,10,Loyal
5063,140,7,378.61,4,1,1,6,Regulars
5064,517,10,3967.72,1,3,5,9,Regulars
5065,138,15,1335.45,4,5,3,12,Loyal
5066,61,8,537.25,5,2,1,8,Regulars
5067,40,8,448.78000000000003,5,2,1,8,Regulars
5068,206,8,887.8199999999999,3,2,2,7,Regulars
5069,622,8,1167.6599999999999,1,2,2,5,Hibernating
5070,276,10,1896.71,2,3,4,9,Regulars
5071,397,10,1821.72,2,3,4,9,Regulars
5072,79,6,658.52,4,1,1,6,Regulars
5073,112,11,2739.59,4,3,5,12,Loyal
5074,63,14,3656.61,5,5,5,15,Champions
5075,155,14,1309.6200000000001,3,5,3,11,Regulars
5076,385,7,502.07000000000005,2,1,1,4,Hibernating
5077,70,7,719.12,4,1,1,6,Regulars
5078,946,14,1296.55,1,5,3,9,At Risk
5079,596,7,1178.51,1,1,2,4,Hibernating
5080,22,9,1412.37,5,2,3,10,Regulars
5081,303,10,1026.65,2,3,2,7,Regulars
5082,147,8,308.34,4,2,1,7,Regulars
5083,471,9,591.58,1,2,1,4,Hibernating
5084,495,10,3578.2700000000004,1,3,5,9,Regulars
5085,17,14,1099.42,5,5,2,12,Loyal
5086,252,14,3189.97,2,5,5,12,At Risk
5087,55,10,2125.98,5,3,4,12,Loyal
5088,420,9,1265.6299999999999,2,2,3,7,Regulars
5089,129,7,3123.5299999999997,4,1,5,10,Big Spenders
5090,492,6,889.83,1,1,2,4,Hibernating
5091,335,12,2574.12,2,4,5,11,At Risk
5092,153,9,2071.76,3,2,4,9,Big Spenders
5093,465,8,993.08,1,2,2,5,Hibernating
5094,300,14,3932.98,2,5,5,12,At Risk
5095,20,11,902.71,5,3,2,10,Loyal
5096,134,14,2191.92,4,5,4,13,Champions
5097,209,14,1394.6000000000001,3,5,3,11,Regulars
5098,369,10,4469.55,2,3,5,10,Regulars
5099,99,9,1200.3200000000002,4,2,2,8,Regulars
5100,352,9,1596.41,2,2,3,7,Regulars
5101,302,11,1128.6799999999998,2,3,2,7,Regulars
5102,52,12,1603.45,5,4,3,12,Loyal
5103,75,7,2419.2799999999997,4,1,4,9,Big Spenders
5104,95,12,1919.2,4,4,4,12,Champions
5105,188,7,1543.8799999999999,3,1,3,7,Regulars
5106,87,12,1626.2,4,4,3,11,Loyal
5107,84,9,1034.14,4,2,2,8,Regulars
5108,664,7,655.4,1,1,1,3,Hibernating
5109,251,19,4771.04,2,5,5,12,At Risk
5110,91,11,1389.76,4,3,3,10,Loyal
5111,119,8,2093.93,4,2,4,10,Big Spenders
5112,241,6,1568.06,3,1,3,7,Regulars
5113,172,6,671.92,3,1,1,5,Regulars
5114,194,7,307.20000000000005,3,1,1,5,Regulars
5115,169,11,1510.5,3,3,3,9,Regulars
5116,575,15,3191.24,1,5,5,11,At Risk
5117,235,14,3581.96,3,5,5,13,Big Spenders
5118,213,16,3469.12,3,5,5,13,Big Spenders
5119,238,12,1581.37,3,4,3,10,Regulars
5120,378,13,1658.0,2,4,3,9,At Risk
5121,175,10,1324.17,3,3,3,9,Regulars
5122,688,12,955.36,1,4,2,7,At Risk
5123,271,6,537.46,2,1,1,4,Hibernating
5124,129,8,1026.12,4,2,2,8,Regulars
5125,401,16,2917.77,2,5,5,12,At Risk
5126,813,5,269.46,1,1,1,3,Hibernating
5127,363,5,985.29,2,1,2,5,Hibernating
5128,98,13,1898.3999999999999,4,4,4,12,Champions
5129,95,13,2619.69,4,4,5,13,Champions
5130,808,10,1659.3899999999999,1,3,3,7,Regulars
5131,118,14,1046.01,4,5,2,11,Loyal
5132,488,13,1322.51,1,4,3,8,At Risk
5133,504,9,2324.31,1,2,4,7,Regulars
5134,552,6,1902.3899999999999,1,1,4,6,Regulars
5135,310,14,1554.4099999999999,2,5,3,10,At Risk
5136,138,13,1301.1599999999999,4,4,3,11,Loyal
5137,167,14,3842.58,3,5,5,13,Big Spenders
5138,3,10,807.13,5,3,1,9,Loyal
5139,443,15,1563.22,2,5,3,10,At Risk
5140,164,11,1983.8300000000002,3,3,4,10,Big Spenders
5141,224,13,1599.93,3,4,3,10,Regulars
5142,242,12,1083.82,3,4,2,9,Regulars
5143,295,13,2128.93,2,4,4,10,At Risk
5144,224,13,1499.14,3,4,3,10,Regulars
5145,0,13,2209.13,5,4,4,13,Champions
5146,131,11,1547.01,4,3,3,10,Loyal
5147,230,8,566.65,3,2,1,6,Regulars
5148,623,9,1736.27,1,2,4,7,Regulars
5149,296,7,592.18,2,1,1,4,Hibernating
5150,243,14,1259.17,3,5,3,11,Regulars
5151,82,10,2082.59,4,3,4,11,Loyal
5152,183,16,1266.77,3,5,3,11,Regulars
5153,271,16,3942.1499999999996,2,5,5,12,At Risk
5154,200,15,2186.85,3,5,4,12,Big Spenders
5155,34,16,3041.62,5,5,5,15,Champions
5156,289,9,610.56,2,2,1,5,Hibernating
5157,6,19,1892.53,5,5,4,14,Champions
5158,1077,6,477.61,1,1,1,3,Hibernating
5159,18,11,4507.83,5,3,5,13,Loyal
5160,149,12,1284.6699999999998,3,4,3,10,Regulars
5161,328,11,1774.53,2,3,4,9,Regulars
5162,128,13,2839.78,4,4,5,13,Champions
5163,417,14,1101.8700000000001,2,5,2,9,At Risk
5164,181,10,2361.38,3,3,4,10,Big Spenders
5165,197,11,866.99,3,3,2,8,Regulars
5166,81,15,4030.63,4,5,5,14,Champions
5167,214,13,5610.41,3,4,5,12,Big Spenders
5168,68,8,647.5,4,2,1,7,Regulars
5169,32,13,1742.19,5,4,4,13,Champions
5170,345,15,4657.82,2,5,5,12,At Risk
5171,227,10,1842.1599999999999,3,3,4,10,Big Spenders
5172,16,9,1184.14,5,2,2,9,Regulars
5173,16,8,511.69,5,2,1,8,Regulars
5174,406,11,2294.71,2,3,4,9,Regulars
5175,113,12,1618.96,4,4,3,11,Loyal
5176,85,7,1715.3500000000001,4,1,3,8,Regulars
5177,190,5,616.64,3,1,1,5,Regulars
5178,122,15,2828.54,4,5,5,14,Champions
5179,313,11,1169.07,2,3,2,7,Regulars
5180,58,14,4503.86,5,5,5,15,Champions
5181,202,8,1108.8,3,2,2,7,Regulars
5182,606,7,1638.0,1,1,3,5,Regulars
5183,533,9,675.98,1,2,1,4,Hibernating
5184,18,11,1482.0800000000002,5,3,3,11,Loyal
5185,770,9,1096.1999999999998,1,2,2,5,Hibernating
5186,628,9,1036.25,1,2,2,5,Hibernating
5187,256,12,2311.12,2,4,4,10,At Risk
5188,580,12,2270.47,1,4,4,9,At Risk
5189,266,7,1813.48,2,1,4,7,Regulars
5190,138,12,1409.55,4,4,3,11,Loyal
5191,602,4,285.22,1,1,1,3,Hibernating
5192,338,6,810.1199999999999,2,1,1,4,Hibernating
5193,68,17,2615.51,4,5,5,14,Champions
5194,150,18,4525.49,3,5,5,13,Big Spenders
5195,70,6,755.01,4,1,1,6,Regulars
5196,206,7,592.74,3,1,1,5,Regulars
5197,107,10,3119.47,4,3,5,12,Loyal
5198,441,7,1241.72,2,1,3,6,Regulars
5199,742,10,1620.25,1,3,3,7,Regulars
5200,536,10,4605.54,1,3,5,9,Regulars
5201,127,11,3084.7999999999997,4,3,5,12,Loyal
5202,609,9,2510.98,1,2,4,7,Regulars
5203,81,12,1107.31,4,4,2,10,Loyal
5204,49,3,571.1099999999999,5,1,1,7,Regulars
5205,55,10,3531.32,5,3,5,13,Loyal
5206,289,12,1133.68,2,4,2,8,At Risk
5207,101,14,1727.1100000000001,4,5,4,13,Champions
5208,548,10,1778.53,1,3,4,8,Regulars
5209,488,14,2413.5,1,5,4,10,At Risk
5210,301,12,2961.77,2,4,5,11,At Risk
5211,258,10,3340.26,2,3,5,10,Regulars
5212,154,12,1370.47,3,4,3,10,Regulars
5213,161,12,3750.37,3,4,5,12,Big Spenders
5214,84,9,925.8199999999999,4,2,2,8,Regulars
5215,19,19,1806.6100000000001,5,5,4,14,Champions
5216,917,8,626.8199999999999,1,2,1,4,Hibernating
5217,563,12,1503.46,1,4,3,8,At Risk
5218,188,15,3402.42,3,5,5,13,Big Spenders
5219,969,10,1126.06,1,3,2,6,Regulars
5220,122,12,1199.17,4,4,2,10,Loyal
5221,18,8,877.18,5,2,2,9,Regulars
5222,25,12,1764.73,5,4,4,13,Champions
5223,69,8,3597.3000000000006,4,2,5,11,Big Spenders
5224,366,11,1189.7,2,3,2,7,Regulars
5225,195,9,1445.33,3,2,3,8,Regulars
5226,27,9,1760.24,5,2,4,11,Big Spenders
5227,60,16,2994.55,5,5,5,15,Champions
5228,123,9,1085.48,4,2,2,8,Regulars
5229,39,12,1566.22,5,4,3,12,Loyal
5230,0,14,903.73,5,5,2,12,Loyal
5231,168,13,755.79,3,4,1,8,Regulars
5232,17,14,2000.74,5,5,4,14,Champions
5233,65,9,927.85,5,2,2,9,Regulars
5234,109,9,999.76,4,2,2,8,Regulars
5235,82,12,1211.1,4,4,2,10,Loyal
5236,375,5,380.22,2,1,1,4,Hibernating
5237,1745,3,248.07,1,1,1,3,Hibernating
5238,69,7,4158.03,4,1,5,10,Big Spenders
5239,116,10,1235.99,4,3,2,9,Loyal
5240,9,10,3658.76,5,3,5,13,Loyal
5241,688,9,2038.25,1,2,4,7,Regulars
5242,168,11,1492.65,3,3,3,9,Regulars
5243,122,11,2642.56,4,3,5,12,Loyal
5244,90,14,2900.71,4,5,5,14,Champions
5245,242,12,1795.12,3,4,4,11,Big Spenders
5246,27,13,3584.37,5,4,5,14,Champions
5247,47,8,1024.91,5,2,2,9,Regulars
5248,26,8,792.72,5,2,1,8,Regulars
5249,181,11,1089.15,3,3,2,8,Regulars
5250,1127,5,2749.33,1,1,5,7,Regulars
5251,50,15,1499.23,5,5,3,13,Loyal
5252,361,8,633.79,2,2,1,5,Hibernating
5253,185,9,1206.62,3,2,2,7,Regulars
5254,31,11,788.12,5,3,1,9,Loyal
5255,262,6,666.91,2,1,1,4,Hibernating
5256,231,9,1343.6699999999998,3,2,3,8,Regulars
5257,348,9,1411.05,2,2,3,7,Regulars
5258,318,13,2600.1700000000005,2,4,5,11,At Risk
5259,549,13,989.1500000000001,1,4,2,7,At Risk
5260,167,7,566.48,3,1,1,5,Regulars
5261,490,15,2530.57,1,5,4,10,At Risk
5262,23,12,2286.65,5,4,4,13,Champions
5263,521,7,1399.53,1,1,3,5,Regulars
5264,379,12,2887.78,2,4,5,11,At Risk
5265,185,15,1888.35,3,5,4,12,Big Spenders
5266,264,12,1436.0,2,4,3,9,At Risk
5267,216,11,1093.01,3,3,2,8,Regulars
5268,667,6,594.95,1,1,1,3,Hibernating
5269,680,5,1181.79,1,1,2,4,Hibernating
5270,398,13,1600.23,2,4,3,9,At Risk
5271,207,15,3932.65,3,5,5,13,Big Spenders
5272,376,10,1746.0,2,3,4,9,Regulars
5273,189,17,2752.2799999999997,3,5,5,13,Big Spenders
5274,1018,7,1166.33,1,1,2,4,Hibernating
5275,249,16,1643.57,2,5,3,10,At Risk
5276,54,4,1014.51,5,1,2,8,Regulars
5277,148,14,2889.4,3,5,5,13,Big Spenders
5278,397,8,1125.27,2,2,2,6,Hibernating
5279,199,9,1936.35,3,2,4,9,Big Spenders
5280,42,11,1142.67,5,3,2,10,Loyal
5281,20,14,2124.35,5,5,4,14,Champions
5282,170,8,771.9200000000001,3,2,1,6,Regulars
5283,521,11,2863.13,1,3,5,9,Regulars
5284,64,13,4727.51,5,4,5,14,Champions
5285,239,10,2249.8,3,3,4,10,Big Spenders
5286,52,10,2319.46,5,3,4,12,Loyal
5287,498,9,1622.29,1,2,3,6,Regulars
5288,399,14,4409.21,2,5,5,12,At Risk
5289,174,10,1310.99,3,3,3,9,Regulars
5290,110,9,679.9,4,2,1,7,Regulars
5291,451,7,812.2199999999998,2,1,1,4,Hibernating
5292,64,12,4551.46,5,4,5,14,Champions
5293,83,15,2216.31,4,5,4,13,Champions
5294,658,10,2175.26,1,3,4,8,Regulars
5295,246,9,1645.77,3,2,3,8,Regulars
5296,122,9,1130.75,4,2,2,8,Regulars
5297,60,13,4932.82,5,4,5,14,Champions
5298,265,14,2053.56,2,5,4,11,At Risk
5299,48,15,3441.5499999999997,5,5,5,15,Champions
5300,223,7,3008.06,3,1,5,9,Big Spenders
5301,91,9,2136.1800000000003,4,2,4,10,Big Spenders
5302,67,18,3519.99,4,5,5,14,Champions
5303,69,12,2354.0,4,4,4,12,Champions
5304,435,10,884.97,2,3,2,7,Regulars
5305,91,11,1400.66,4,3,3,10,Loyal
5306,183,14,2117.35,3,5,4,12,Big Spenders
5307,357,10,998.47,2,3,2,7,Regulars
5308,685,7,395.07,1,1,1,3,Hibernating
5309,434,8,892.22,2,2,2,6,Hibernating
5310,379,10,1732.61,2,3,4,9,Regulars
5311,31,8,460.59000000000003,5,2,1,8,Regulars
5312,2057,2,609.95,1,1,1,3,Hibernating
5313,225,13,1090.43,3,4,2,9,Regulars
5314,238,14,1624.51,3,5,3,11,Regulars
5315,127,8,662.27,4,2,1,7,Regulars
5316,88,16,1731.3899999999999,4,5,4,13,Champions
5317,305,7,1452.3,2,1,3,6,Regulars
5318,707,10,962.28,1,3,2,6,Regulars
5319,24,17,1756.66,5,5,4,14,Champions
5320,335,9,1812.65,2,2,4,8,Regulars
5321,123,13,2288.93,4,4,4,12,Champions
5322,467,7,641.54,1,1,1,3,Hibernating
5323,555,5,485.83,1,1,1,3,Hibernating
5324,351,12,1843.5,2,4,4,10,At Risk
5325,342,12,1344.95,2,4,3,9,At Risk
5326,355,8,563.38,2,2,1,5,Hibernating
5327,81,4,403.45,4,1,1,6,Regulars
5328,566,6,691.04,1,1,1,3,Hibernating
5329,298,8,2619.04,2,2,5,9,Regulars
5330,21,17,2671.32,5,5,5,15,Champions
5331,259,9,1044.27,2,2,2,6,Hibernating
5332,0,14,1795.28,5,5,4,14,Champions
5333,807,9,689.22,1,2,1,4,Hibernating
5334,307,5,541.98,2,1,1,4,Hibernating
5335,307,12,2262.62,2,4,4,10,At Risk
5336,223,7,725.64,3,1,1,5,Regulars
5337,30,9,1383.3,5,2,3,10,Regulars
5338,21,16,3350.11,5,5,5,15,Champions
5339,170,8,715.77,3,2,1,6,Regulars
5340,310,11,1502.91,2,3,3,8,Regulars
5341,18,5,388.73,5,1,1,7,Regulars
5342,410,3,218.35,2,1,1,4,Hibernating
5343,53,15,1486.97,5,5,3,13,Loyal
5344,162,11,2676.4,3,3,5,11,Big Spenders
5345,5,10,2126.41,5,3,4,12,Loyal
5346,506,7,1098.18,1,1,2,4,Hibernating
5347,215,5,766.24,3,1,1,5,Regulars
5348,230,15,3983.6299999999997,3,5,5,13,Big Spenders
5349,74,9,724.1999999999999,4,2,1,7,Regulars
5350,396,8,912.81,2,2,2,6,Hibernating
5351,53,6,1766.8599999999997,5,1,4,10,Big Spenders
5352,535,6,681.12,1,1,1,3,Hibernating
5353,97,12,1207.8,4,4,2,10,Loyal
5354,122,7,295.11,4,1,1,6,Regulars
5355,274,11,1200.28,2,3,2,7,Regulars
5356,49,11,1689.25,5,3,3,11,Loyal
5357,226,11,2332.9900000000002,3,3,4,10,Big Spenders
5358,337,9,1865.42,2,2,4,8,Regulars
5359,17,7,727.28,5,1,1,7,Regulars
5360,333,10,1198.8400000000001,2,3,2,7,Regulars
5361,875,6,514.23,1,1,1,3,Hibernating
5362,175,3,152.93,3,1,1,5,Regulars
5363,183,17,1706.09,3,5,3,11,Regulars
5364,384,7,688.21,2,1,1,4,Hibernating
5365,196,11,1384.27,3,3,3,9,Regulars
5366,117,14,4400.65,4,5,5,14,Champions
5367,284,13,1685.82,2,4,3,9,At Risk
5368,64,10,793.97,5,3,1,9,Loyal
5369,661,7,679.77,1,1,1,3,Hibernating
5370,42,12,2356.31,5,4,4,13,Champions
5371,952,4,804.21,1,1,1,3,Hibernating
5372,91,13,4538.88,4,4,5,13,Champions
5373,159,8,1447.89,3,2,3,8,Regulars
5374,103,15,917.98,4,5,2,11,Loyal
5375,35,14,1995.2199999999998,5,5,4,14,Champions
5376,52,12,1202.77,5,4,2,11,Loyal
5377,50,9,1481.55,5,2,3,10,Regulars
5378,84,10,2336.25,4,3,4,11,Loyal
5379,1127,8,2480.95,1,2,4,7,Regulars
5380,8,10,1247.53,5,3,3,11,Loyal
5381,7,8,465.84000000000003,5,2,1,8,Regulars
5382,17,15,1209.73,5,5,2,12,Loyal
5383,58,13,5247.8099999999995,5,4,5,14,Champions
5384,806,9,990.4,1,2,2,5,Hibernating
5385,249,10,1403.07,2,3,3,8,Regulars
5386,223,13,2294.79,3,4,4,11,Big Spenders
5387,258,10,2141.25,2,3,4,9,Regulars
5388,188,11,1076.6,3,3,2,8,Regulars
5389,481,10,602.59,1,3,1,5,Regulars
5390,323,13,2824.2,2,4,5,11,At Risk
5391,527,11,2227.98,1,3,4,8,Regulars
5392,64,9,2383.92,5,2,4,11,Big Spenders
5393,7,10,1493.3200000000002,5,3,3,11,Loyal
5394,514,6,656.32,1,1,1,3,Hibernating
5395,165,11,2403.46,3,3,4,10,Big Spenders
5396,214,11,933.75,3,3,2,8,Regulars
5397,230,12,1290.87,3,4,3,10,Regulars
5398,30,6,1069.97,5,1,2,8,Regulars
5399,82,6,743.22,4,1,1,6,Regulars
5400,67,7,559.59,4,1,1,6,Regulars
5401,203,4,186.61,3,1,1,5,Regulars
5402,131,16,1944.24,4,5,4,13,Champions
5403,938,4,682.5,1,1,1,3,Hibernating
5404,841,10,1617.67,1,3,3,7,Regulars
5405,47,6,686.0699999999999,5,1,1,7,Regulars
5406,382,12,2257.8399999999997,2,4,4,10,At Risk
5407,68,6,688.0899999999999,4,1,1,6,Regulars
5408,371,12,2079.2000000000003,2,4,4,10,At Risk
5409,352,5,382.64,2,1,1,4,Hibernating
5410,100,11,2360.54,4,3,4,11,Loyal
5411,189,12,1498.16,3,4,3,10,Regulars
5412,7,11,884.52,5,3,2,10,Loyal
5413,7,13,1631.81,5,4,3,12,Loyal
5414,13,6,1171.39,5,1,2,8,Regulars
5415,105,13,2982.3500000000004,4,4,5,13,Champions
5416,312,6,993.76,2,1,2,5,Hibernating
5417,30,13,1294.45,5,4,3,12,Loyal
5418,3,14,1332.01,5,5,3,13,Loyal
5419,125,13,3881.94,4,4,5,13,Champions
5420,335,9,1069.6,2,2,2,6,Hibernating
5421,236,6,418.3,3,1,1,5,Regulars
5422,539,11,1264.57,1,3,3,7,Regulars
5423,23,6,595.0,5,1,1,7,Regulars
5424,61,13,2069.12,5,4,4,13,Champions
5425,86,8,1066.81,4,2,2,8,Regulars
5426,684,8,619.62,1,2,1,4,Hibernating
5427,72,5,917.0999999999999,4,1,2,7,Regulars
5428,284,10,2128.4700000000003,2,3,4,9,Regulars
5429,460,14,2235.67,1,5,4,10,At Risk
5430,177,18,1782.59,3,5,4,12,Big Spenders
5431,88,8,2260.62,4,2,4,10,Big Spenders
5432,2200,1,44.93,1,1,1,3,Hibernating
5433,1,13,896.78,5,4,2,11,Loyal
5434,159,14,2089.78,3,5,4,12,Big Spenders
5435,463,11,4181.95,1,3,5,9,Regulars
5436,543,5,346.67,1,1,1,3,Hibernating
5437,466,8,615.33,1,2,1,4,Hibernating
5438,172,11,3430.23,3,3,5,11,Big Spenders
5439,150,8,2183.5099999999998,3,2,4,9,Big Spenders
5440,242,8,677.07,3,2,1,6,Regulars
5441,251,11,2891.54,2,3,5,10,Regulars
5442,530,7,677.9200000000001,1,1,1,3,Hibernating
5443,271,11,2075.37,2,3,4,9,Regulars
5444,492,10,1768.83,1,3,4,8,Regulars
5445,5,15,1622.28,5,5,3,13,Loyal
5446,2,12,1006.92,5,4,2,11,Loyal
5447,139,16,2409.5299999999997,4,5,4,13,Champions
5448,125,7,1600.65,4,1,3,8,Regulars
5449,138,11,2906.08,4,3,5,12,Loyal
5450,428,7,2422.5600000000004,2,1,4,7,Regulars
5451,453,11,1227.48,2,3,2,7,Regulars
5452,105,6,198.87,4,1,1,6,Regulars
5453,191,11,1542.05,3,3,3,9,Regulars
5454,174,8,678.17,3,2,1,6,Regulars
5455,734,8,723.8,1,2,1,4,Hibernating
5456,113,10,701.07,4,3,1,8,Loyal
5457,527,9,474.48,1,2,1,4,Hibernating
5458,336,7,1143.38,2,1,2,5,Hibernating
5459,830,7,2903.55,1,1,5,7,Regulars
5460,817,10,3098.7,1,3,5,9,Regulars
5461,555,8,2236.33,1,2,4,7,Regulars
5462,378,14,2242.84,2,5,4,11,At Risk
5463,27,14,1241.0,5,5,2,12,Loyal
5464,414,12,1592.75,2,4,3,9,At Risk
5465,191,9,949.91,3,2,2,7,Regulars
5466,411,13,1644.05,2,4,3,9,At Risk
5467,44,9,2261.62,5,2,4,11,Big Spenders
5468,463,12,1401.17,1,4,3,8,At Risk
5469,74,8,855.37,4,2,2,8,Regulars
5470,583,8,249.6,1,2,1,4,Hibernating
5471,520,8,727.87,1,2,1,4,Hibernating
5472,900,9,2086.53,1,2,4,7,Regulars
5473,173,14,2178.32,3,5,4,12,Big Spenders
5474,21,11,3365.68,5,3,5,13,Loyal
5475,68,5,880.4399999999999,4,1,2,7,Regulars
5476,172,13,987.6899999999999,3,4,2,9,Regulars
5477,302,8,1310.05,2,2,3,7,Regulars
5478,553,3,434.69,1,1,1,3,Hibernating
5479,192,9,768.48,3,2,1,6,Regulars
5480,725,7,287.28,1,1,1,3,Hibernating
5481,281,13,1499.98,2,4,3,9,At Risk
5482,333,8,1188.23,2,2,2,6,Hibernating
5483,190,6,890.8800000000001,3,1,2,6,Regulars
5484,176,11,2342.29,3,3,4,10,Big Spenders
5485,65,4,383.15,5,1,1,7,Regulars
5486,86,9,1579.72,4,2,3,9,Regulars
5487,94,8,3153.5899999999997,4,2,5,11,Big Spenders
5488,130,13,1952.26,4,4,4,12,Champions
5489,329,10,1275.1,2,3,3,8,Regulars
5490,300,8,1051.11,2,2,2,6,Hibernating
5491,408,6,1155.67,2,1,2,5,Hibernating
5492,424,8,898.5500000000001,2,2,2,6,Hibernating
5493,1222,6,373.58000000000004,1,1,1,3,Hibernating
5494,185,5,1105.2,3,1,2,6,Regulars
5495,53,9,1351.37,5,2,3,10,Regulars
5496,80,12,2267.4300000000003,4,4,4,12,Champions
5497,77,6,1723.7000000000003,4,1,3,8,Regulars
5498,271,9,1837.3799999999999,2,2,4,8,Regulars
5499,166,13,1927.88,3,4,4,11,Big Spenders
5500,88,16,1297.23,4,5,3,12,Loyal
5501,183,10,985.11,3,3,2,8,Regulars
5502,155,12,2407.3999999999996,3,4,4,11,Big Spenders
5503,16,10,1998.42,5,3,4,12,Loyal
5504,536,11,3026.84,1,3,5,9,Regulars
5505,472,12,1537.3899999999999,1,4,3,8,At Risk
5506,535,9,2470.42,1,2,4,7,Regulars
5507,64,8,2286.33,5,2,4,11,Big Spenders
5508,476,10,836.5,1,3,1,5,Regulars
5509,966,9,592.93,1,2,1,4,Hibernating
5510,45,14,2355.21,5,5,4,14,Champions
5511,179,6,413.65000000000003,3,1,1,5,Regulars
5512,330,10,1695.0,2,3,3,8,Regulars
5513,958,7,931.61,1,1,2,4,Hibernating
5514,460,10,2723.01,1,3,5,9,Regulars
5515,18,9,1388.2500000000002,5,2,3,10,Regulars
5516,91,8,1515.71,4,2,3,9,Regulars
5517,583,9,1143.13,1,2,2,5,Hibernating
5518,188,9,987.32,3,2,2,7,Regulars
5519,155,11,2578.18,3,3,5,11,Big Spenders
5520,176,9,1597.07,3,2,3,8,Regulars
5521,161,12,1047.28,3,4,2,9,Regulars
5522,650,8,652.25,1,2,1,4,Hibernating
5523,189,11,2643.64,3,3,5,11,Big Spenders
5524,144,5,589.2,4,1,1,6,Regulars
5525,819,12,1094.21,1,4,2,7,At Risk
5526,206,11,1573.9,3,3,3,9,Regulars
5527,1167,7,542.39,1,1,1,3,Hibernating
5528,281,8,1364.29,2,2,3,7,Regulars
5529,25,6,507.73,5,1,1,7,Regulars
5530,7,11,1048.96,5,3,2,10,Loyal
5531,174,11,1322.8999999999999,3,3,3,9,Regulars
5532,1875,4,362.96,1,1,1,3,Hibernating
5533,125,14,2394.33,4,5,4,13,Champions
5534,144,8,1598.5400000000002,4,2,3,9,Regulars
5535,490,14,1352.59,1,5,3,9,At Risk
5536,373,8,973.0699999999999,2,2,2,6,Hibernating
5537,82,13,2913.3,4,4,5,13,Champions
5538,222,13,1123.14,3,4,2,9,Regulars
5539,556,5,1114.59,1,1,2,4,Hibernating
5540,174,12,4228.14,3,4,5,12,Big Spenders
5541,24,5,668.0799999999999,5,1,1,7,Regulars
5542,167,5,861.24,3,1,2,6,Regulars
5543,548,12,1823.94,1,4,4,9,At Risk
5544,222,11,2382.02,3,3,4,10,Big Spenders
5545,29,8,1525.99,5,2,3,10,Regulars
5546,151,9,1308.6399999999999,3,2,3,8,Regulars
5547,52,13,3284.89,5,4,5,14,Champions
5548,111,14,2026.3,4,5,4,13,Champions
5549,373,10,1081.03,2,3,2,7,Regulars
5550,12,11,1529.99,5,3,3,11,Loyal
5551,340,6,288.36,2,1,1,4,Hibernating
5552,2,13,1806.6100000000001,5,4,4,13,Champions
5553,116,11,3714.07,4,3,5,12,Loyal
5554,885,9,1784.3700000000001,1,2,4,7,Regulars
5555,216,11,963.51,3,3,2,8,Regulars
5556,340,9,1906.25,2,2,4,8,Regulars
5557,49,16,1637.98,5,5,3,13,Loyal
5558,392,12,1308.62,2,4,3,9,At Risk
5559,915,11,4691.42,1,3,5,9,Regulars
5560,235,9,5393.56,3,2,5,10,Big Spenders
5561,49,13,869.65,5,4,2,11,Loyal
5562,43,9,1705.35,5,2,3,10,Regulars
5563,313,8,677.33,2,2,1,5,Hibernating
5564,31,6,750.48,5,1,1,7,Regulars
5565,200,16,3772.67,3,5,5,13,Big Spenders
5566,43,12,1718.19,5,4,3,12,Loyal
5567,1007,9,1250.25,1,2,3,6,Regulars
5568,455,14,2267.04,2,5,4,11,At Risk
5569,489,9,617.8199999999999,1,2,1,4,Hibernating
5570,163,5,434.52,3,1,1,5,Regulars
5571,61,10,2378.3700000000003,5,3,4,12,Loyal
5572,78,16,3689.31,4,5,5,14,Champions
5573,49,8,1077.71,5,2,2,9,Regulars
5574,3,7,610.03,5,1,1,7,Regulars
5575,255,11,1127.01,2,3,2,7,Regulars
5576,34,10,2512.71,5,3,4,12,Loyal
5577,619,12,1145.8700000000001,1,4,2,7,At Risk
5578,676,8,1489.32,1,2,3,6,Regulars
5579,85,11,3092.3599999999997,4,3,5,12,Loyal
5580,182,10,3594.28,3,3,5,11,Big Spenders
5581,64,15,1742.71,5,5,4,14,Champions
5582,540,9,2577.5299999999997,1,2,5,8,Regulars
5583,23,8,1248.99,5,2,3,10,Regulars
5584,341,5,957.7099999999999,2,1,2,5,Hibernating
5585,521,5,873.1600000000001,1,1,2,4,Hibernating
5586,156,13,1501.79,3,4,3,10,Regulars
5587,974,6,555.84,1,1,1,3,Hibernating
5588,229,13,1066.22,3,4,2,9,Regulars
5589,224,8,677.02,3,2,1,6,Regulars
5590,262,10,2699.85,2,3,5,10,Regulars
5591,131,11,3887.51,4,3,5,12,Loyal
5592,187,8,1438.82,3,2,3,8,Regulars
5593,108,10,1342.5300000000002,4,3,3,10,Loyal
5594,359,9,2613.64,2,2,5,9,Regulars
5595,267,12,2332.97,2,4,4,10,At Risk
5596,498,14,2372.88,1,5,4,10,At Risk
5597,937,6,631.89,1,1,1,3,Hibernating
5598,74,12,1655.08,4,4,3,11,Loyal
5599,605,11,776.9,1,3,1,5,Regulars
5600,70,19,3706.22,4,5,5,14,Champions
5601,363,16,3202.02,2,5,5,12,At Risk
5602,92,8,763.29,4,2,1,7,Regulars
5603,24,12,1923.71,5,4,4,13,Champions
5604,64,9,3187.81,5,2,5,12,Big Spenders
5605,492,9,1024.97,1,2,2,5,Hibernating
5606,110,14,1492.3000000000002,4,5,3,12,Loyal
5607,56,12,1387.04,5,4,3,12,Loyal
5608,53,12,2283.46,5,4,4,13,Champions
5609,19,15,2808.2,5,5,5,15,Champions
5610,5,16,2468.48,5,5,4,14,Champions
5611,207,7,1433.3400000000001,3,1,3,7,Regulars
5612,28,16,3084.45,5,5,5,15,Champions
5613,401,10,870.05,2,3,2,7,Regulars
5614,189,12,1359.3899999999999,3,4,3,10,Regulars
5615,31,5,2231.65,5,1,4,10,Big Spenders
5616,110,9,1956.53,4,2,4,10,Big Spenders
5617,170,9,3037.9,3,2,5,10,Big Spenders
5618,145,9,1399.96,4,2,3,9,Regulars
5619,316,5,576.8799999999999,2,1,1,4,Hibernating
5620,431,8,727.32,2,2,1,5,Hibernating
5621,17,12,1069.4,5,4,2,11,Loyal
5622,389,7,2614.75,2,1,5,8,Regulars
5623,57,12,1100.15,5,4,2,11,Loyal
5624,922,2,406.59000000000003,1,1,1,3,Hibernating
5625,403,9,595.02,2,2,1,5,Hibernating
5626,436,4,664.1700000000001,2,1,1,4,Hibernating
5627,154,17,2151.08,3,5,4,12,Big Spenders
5628,228,10,1298.55,3,3,3,9,Regulars
5629,258,8,2623.29,2,2,5,9,Regulars
5630,132,9,2261.8199999999997,4,2,4,10,Big Spenders
5631,296,8,1513.6799999999998,2,2,3,7,Regulars
5632,125,11,709.5,4,3,1,8,Loyal
5633,93,11,1312.44,4,3,3,10,Loyal
5634,171,12,3120.23,3,4,5,12,Big Spenders
5635,6,4,364.04,5,1,1,7,Regulars
5636,716,9,932.63,1,2,2,5,Hibernating
5637,837,10,1373.26,1,3,3,7,Regulars
5638,93,16,4893.32,4,5,5,14,Champions
5639,465,6,1257.65,1,1,3,5,Regulars
5640,334,11,3182.19,2,3,5,10,Regulars
5641,573,13,2456.59,1,4,4,9,At Risk
5642,394,7,1977.1100000000001,2,1,4,7,Regulars
5643,47,9,1648.1699999999998,5,2,3,10,Regulars
5644,284,8,837.0799999999999,2,2,1,5,Hibernating
5645,116,12,1262.3,4,4,3,11,Loyal
5646,83,12,1559.09,4,4,3,11,Loyal
5647,190,11,2574.8599999999997,3,3,5,11,Big Spenders
5648,21,12,2387.89,5,4,4,13,Champions
5649,745,4,1590.74,1,1,3,5,Regulars
5650,379,14,3778.36,2,5,5,12,At Risk
5651,49,8,892.53,5,2,2,9,Regulars
5652,247,6,1457.81,3,1,3,7,Regulars
5653,337,4,572.79,2,1,1,4,Hibernating
5654,62,13,2095.03,5,4,4,13,Champions
5655,125,10,2007.12,4,3,4,11,Loyal
5656,733,7,3570.54,1,1,5,7,Regulars
5657,58,15,1753.92,5,5,4,14,Champions
5658,237,13,2316.21,3,4,4,11,Big Spenders
5659,19,7,333.05,5,1,1,7,Regulars
5660,720,6,1460.2199999999998,1,1,3,5,Regulars
5661,157,9,2544.2999999999997,3,2,4,9,Big Spenders
5662,435,8,1506.04,2,2,3,7,Regulars
5663,294,5,457.57000000000005,2,1,1,4,Hibernating
5664,179,15,2176.14,3,5,4,12,Big Spenders
5665,76,9,1502.73,4,2,3,9,Regulars
5666,40,5,501.49,5,1,1,7,Regulars
5667,0,10,876.64,5,3,2,10,Loyal
5668,455,19,2807.25,2,5,5,12,At Risk
5669,89,11,916.11,4,3,2,9,Loyal
5670,596,7,1576.9,1,1,3,5,Regulars
5671,790,4,358.55,1,1,1,3,Hibernating
5672,0,11,3621.97,5,3,5,13,Loyal
5673,234,9,3021.2,3,2,5,10,Big Spenders
5674,205,6,742.39,3,1,1,5,Regulars
5675,92,19,1886.1699999999998,4,5,4,13,Champions
5676,170,18,2129.19,3,5,4,12,Big Spenders
5677,236,16,2022.06,3,5,4,12,Big Spenders
5678,297,11,1186.59,2,3,2,7,Regulars
5679,512,16,2144.85,1,5,4,10,At Risk
5680,560,13,1710.25,1,4,3,8,At Risk
5681,168,8,1368.5500000000002,3,2,3,8,Regulars
5682,2,7,1266.52,5,1,3,9,Regulars
5683,298,5,272.32,2,1,1,4,Hibernating
5684,838,10,1714.37,1,3,3,7,Regulars
5685,20,10,2197.47,5,3,4,12,Loyal
5686,295,11,1493.59,2,3,3,8,Regulars
5687,371,9,3488.51,2,2,5,9,Regulars
5688,230,7,502.34999999999997,3,1,1,5,Regulars
5689,104,10,1663.4099999999999,4,3,3,10,Loyal
5690,685,10,2324.32,1,3,4,8,Regulars
5691,667,6,398.96,1,1,1,3,Hibernating
5692,99,10,3455.89,4,3,5,12,Loyal
5693,81,9,2705.8700000000003,4,2,5,11,Big Spenders
5694,173,9,1598.9599999999998,3,2,3,8,Regulars
5695,452,8,790.5799999999999,2,2,1,5,Hibernating
5696,207,6,3824.15,3,1,5,9,Big Spenders
5697,542,10,3923.7,1,3,5,9,Regulars
5698,64,9,1061.39,5,2,2,9,Regulars
5699,390,12,2904.44,2,4,5,11,At Risk
5700,38,11,1909.1399999999999,5,3,4,12,Loyal
5701,196,11,1075.55,3,3,2,8,Regulars
5702,232,10,2379.3,3,3,4,10,Big Spenders
5703,122,15,1911.57,4,5,4,13,Champions
5704,191,10,865.01,3,3,2,8,Regulars
5705,220,8,1199.52,3,2,2,7,Regulars
5706,25,19,4495.32,5,5,5,15,Champions
5707,234,10,729.05,3,3,1,7,Regulars
5708,75,13,2514.06,4,4,4,12,Champions
5709,344,7,2279.9,2,1,4,7,Regulars
5710,21,4,460.47,5,1,1,7,Regulars
5711,8,10,689.48,5,3,1,9,Loyal
5712,309,10,1484.86,2,3,3,8,Regulars
5713,430,7,685.4000000000001,2,1,1,4,Hibernating
5714,196,10,1158.78,3,3,2,8,Regulars
5715,74,19,4301.349999999999,4,5,5,14,Champions
5716,78,10,3863.35,4,3,5,12,Loyal
5717,363,12,4153.16,2,4,5,11,At Risk
5718,173,11,3249.65,3,3,5,11,Big Spenders
5719,506,8,1004.91,1,2,2,5,Hibernating
5720,209,6,1213.9699999999998,3,1,2,6,Regulars
5721,604,9,2896.21,1,2,5,8,Regulars
5722,67,10,972.54,4,3,2,9,Loyal
5723,23,13,1862.1100000000001,5,4,4,13,Champions
5724,690,12,1561.4,1,4,3,8,At Risk
5725,43,9,1541.49,5,2,3,10,Regulars
5726,226,11,1876.51,3,3,4,10,Big Spenders
5727,615,10,889.81,1,3,2,6,Regulars
5728,261,6,466.29999999999995,2,1,1,4,Hibernating
5729,193,13,1140.84,3,4,2,9,Regulars
5730,323,12,2083.9,2,4,4,10,At Risk
5731,7,12,3566.57,5,4,5,14,Champions
5732,21,15,6922.83,5,5,5,15,Champions
5733,25,15,1980.3700000000001,5,5,4,14,Champions
5734,254,14,5381.59,2,5,5,12,At Risk
5735,175,15,3189.98,3,5,5,13,Big Spenders
5736,766,15,3304.65,1,5,5,11,At Risk
5737,118,15,3752.0,4,5,5,14,Champions
5738,574,10,1268.05,1,3,3,7,Regulars
5739,69,16,1713.1,4,5,3,12,Loyal
5740,355,9,2959.24,2,2,5,9,Regulars
5741,959,7,317.03999999999996,1,1,1,3,Hibernating
5742,16,13,2856.1099999999997,5,4,5,14,Champions
5743,242,15,1595.77,3,5,3,11,Regulars
5744,130,13,780.6700000000001,4,4,1,9,Loyal
5745,161,6,550.3,3,1,1,5,Regulars
5746,52,10,2038.23,5,3,4,12,Loyal
5747,27,11,858.81,5,3,2,10,Loyal
5748,151,12,954.3,3,4,2,9,Regulars
5749,65,11,3103.7,5,3,5,13,Loyal
5750,297,13,3618.19,2,4,5,11,At Risk
5751,108,14,4968.160000000001,4,5,5,14,Champions
5752,32,15,1914.8600000000001,5,5,4,14,Champions
5753,349,10,1121.77,2,3,2,7,Regulars
5754,195,11,2010.1299999999999,3,3,4,10,Big Spenders
5755,127,13,1231.82,4,4,2,10,Loyal
5756,357,8,1947.94,2,2,4,8,Regulars
5757,60,12,1849.72,5,4,4,13,Champions
5758,259,15,1740.15,2,5,4,11,At Risk
5759,250,13,1611.64,2,4,3,9,At Risk
5760,2,12,4778.94,5,4,5,14,Champions
5761,1071,8,1148.24,1,2,2,5,Hibernating
5762,521,5,439.84,1,1,1,3,Hibernating
5763,827,8,1026.45,1,2,2,5,Hibernating
5764,601,10,901.73,1,3,2,6,Regulars
5765,28,11,875.01,5,3,2,10,Loyal
5766,71,8,2349.2799999999997,4,2,4,10,Big Spenders
5767,900,6,508.84,1,1,1,3,Hibernating
5768,432,13,1493.84,2,4,3,9,At Risk
5769,257,4,563.6800000000001,2,1,1,4,Hibernating
5770,196,15,3172.6499999999996,3,5,5,13,Big Spenders
5771,86,6,427.33,4,1,1,6,Regulars
5772,551,9,1229.84,1,2,2,5,Hibernating
5773,284,12,2093.27,2,4,4,10,At Risk
5774,91,9,1107.72,4,2,2,8,Regulars
5775,165,6,2084.7200000000003,3,1,4,8,Big Spenders
5776,101,10,2761.66,4,3,5,12,Loyal
5777,942,8,1584.8,1,2,3,6,Regulars
5778,46,9,1293.69,5,2,3,10,Regulars
5779,1077,7,1832.96,1,1,4,6,Regulars
5780,196,9,597.64,3,2,1,6,Regulars
5781,959,6,3424.65,1,1,5,7,Regulars
5782,199,17,3162.15,3,5,5,13,Big Spenders
5783,714,8,427.87,1,2,1,4,Hibernating
5784,757,10,924.98,1,3,2,6,Regulars
5785,51,15,3522.08,5,5,5,15,Champions
5786,505,12,1576.4,1,4,3,8,At Risk
5787,329,9,835.62,2,2,1,5,Hibernating
5788,429,12,1254.83,2,4,3,9,At Risk
5789,9,8,467.56,5,2,1,8,Regulars
5790,107,5,296.44,4,1,1,6,Regulars
5791,68,10,1606.12,4,3,3,10,Loyal
5792,52,12,1646.32,5,4,3,12,Loyal
5793,118,8,380.27,4,2,1,7,Regulars
5794,345,7,350.88,2,1,1,4,Hibernating
5795,382,8,1285.73,2,2,3,7,Regulars
5796,354,6,1659.6599999999999,2,1,3,6,Regulars
5797,307,9,2164.82,2,2,4,8,Regulars
5798,114,13,4379.150000000001,4,4,5,13,Champions
5799,508,9,1098.65,1,2,2,5,Hibernating
5800,338,7,492.64000000000004,2,1,1,4,Hibernating
5801,613,9,1202.45,1,2,2,5,Hibernating
5802,75,13,1239.7,4,4,2,10,Loyal
5803,47,12,784.03,5,4,1,10,Loyal
5804,440,9,1074.82,2,2,2,6,Hibernating
5805,42,13,2329.27,5,4,4,13,Champions
5806,90,7,1614.1599999999999,4,1,3,8,Regulars
5807,161,11,1075.6000000000001,3,3,2,8,Regulars
5808,750,12,1512.1100000000001,1,4,3,8,At Risk
5809,127,12,879.95,4,4,2,10,Loyal
5810,134,10,3535.46,4,3,5,12,Loyal
5811,609,9,1050.8,1,2,2,5,Hibernating
5812,103,9,1356.77,4,2,3,9,Regulars
5813,118,14,1559.46,4,5,3,12,Loyal
5814,31,13,1735.33,5,4,4,13,Champions
5815,217,14,2173.8,3,5,4,12,Big Spenders
5816,317,7,1896.4099999999999,2,1,4,7,Regulars
5817,133,16,1045.3,4,5,2,11,Loyal
5818,166,13,1172.12,3,4,2,9,Regulars
5819,551,8,842.9,1,2,1,4,Hibernating
5820,53,15,4256.77,5,5,5,15,Champions
5821,0,10,1770.6399999999999,5,3,4,12,Loyal
5822,361,10,875.71,2,3,2,7,Regulars
5823,169,23,4592.64,3,5,5,13,Big Spenders
5824,195,9,826.7,3,2,1,6,Regulars
5825,172,10,587.57,3,3,1,7,Regulars
5826,15,16,2411.48,5,5,4,14,Champions
5827,279,10,1633.49,2,3,3,8,Regulars
5828,67,10,1718.92,4,3,3,10,Loyal
5829,119,7,1528.58,4,1,3,8,Regulars
5830,304,13,2637.7999999999997,2,4,5,11,At Risk
5831,38,11,3100.41,5,3,5,13,Loyal
5832,125,17,4313.650000000001,4,5,5,14,Champions
5833,382,8,467.87,2,2,1,5,Hibernating
5834,216,7,2282.7,3,1,4,8,Big Spenders
5835,185,6,780.14,3,1,1,5,Regulars
5836,99,9,845.99,4,2,2,8,Regulars
5837,21,4,435.5,5,1,1,7,Regulars
5838,71,9,1411.46,4,2,3,9,Regulars
5839,187,9,703.89,3,2,1,6,Regulars
5840,202,9,1850.9399999999998,3,2,4,9,Big Spenders
5841,439,4,750.96,2,1,1,4,Hibernating
5842,114,10,676.67,4,3,1,8,Loyal
5843,154,11,3175.9400000000005,3,3,5,11,Big Spenders
5844,94,12,1593.58,4,4,3,11,Loyal
5845,153,9,1209.43,3,2,2,7,Regulars
5846,326,15,4268.58,2,5,5,12,At Risk
5847,172,10,4472.71,3,3,5,11,Big Spenders
5848,517,6,536.74,1,1,1,3,Hibernating
5849,331,12,1257.8899999999999,2,4,3,9,At Risk
5850,118,17,5119.9,4,5,5,14,Champions
5851,313,14,2474.84,2,5,4,11,At Risk
5852,452,8,855.63,2,2,2,6,Hibernating
5853,106,9,1539.97,4,2,3,9,Regulars
5854,545,8,891.7,1,2,2,5,Hibernating
5855,215,13,956.45,3,4,2,9,Regulars
5856,560,13,2509.31,1,4,4,9,At Risk
5857,254,10,1481.39,2,3,3,8,Regulars
5858,30,14,1955.05,5,5,4,14,Champions
5859,397,8,1401.37,2,2,3,7,Regulars
5860,182,9,2482.1,3,2,4,9,Big Spenders
5861,100,11,1939.67,4,3,4,11,Loyal
5862,357,10,1097.74,2,3,2,7,Regulars
5863,154,9,663.04,3,2,1,6,Regulars
5864,98,5,862.47,4,1,2,7,Regulars
5865,287,10,1475.6299999999999,2,3,3,8,Regulars
5866,117,8,934.3699999999999,4,2,2,8,Regulars
5867,108,11,1223.62,4,3,2,9,Loyal
5868,365,10,2750.14,2,3,5,10,Regulars
5869,65,11,1138.6399999999999,5,3,2,10,Loyal
5870,529,10,1506.55,1,3,3,7,Regulars
5871,79,8,1960.55,4,2,4,10,Big Spenders
5872,79,8,2016.4499999999998,4,2,4,10,Big Spenders
5873,503,10,1566.96,1,3,3,7,Regulars
5874,16,12,1886.3999999999999,5,4,4,13,Champions
5875,129,9,1284.79,4,2,3,9,Regulars
5876,100,18,2171.98,4,5,4,13,Champions
5877,184,12,2682.08,3,4,5,12,Big Spenders
5878,940,8,712.42,1,2,1,4,Hibernating
5879,216,6,602.54,3,1,1,5,Regulars
5880,776,10,2942.88,1,3,5,9,Regulars
5881,163,9,1675.34,3,2,3,8,Regulars
5882,204,10,672.48,3,3,1,7,Regulars
5883,105,10,740.48,4,3,1,8,Loyal
5884,558,7,2929.9,1,1,5,7,Regulars
5885,890,8,625.63,1,2,1,4,Hibernating
5886,140,12,2044.4,4,4,4,12,Champions
5887,422,11,1002.55,2,3,2,7,Regulars
5888,138,11,2135.8,4,3,4,11,Loyal
5889,50,17,3521.9799999999996,5,5,5,15,Champions
5890,172,9,1866.8,3,2,4,9,Big Spenders
5891,308,8,891.31,2,2,2,6,Hibernating
5892,151,10,2148.96,3,3,4,10,Big Spenders
5893,264,11,2043.1999999999998,2,3,4,9,Regulars
5894,817,10,4494.4800000000005,1,3,5,9,Regulars
5895,165,8,4924.169999999999,3,2,5,10,Big Spenders
5896,11,18,2342.21,5,5,4,14,Champions
5897,16,19,2811.4,5,5,5,15,Champions
5898,168,12,1293.77,3,4,3,10,Regulars
5899,56,17,2983.35,5,5,5,15,Champions
5900,92,7,746.76,4,1,1,6,Regulars
5901,3,10,1703.67,5,3,3,11,Loyal
5902,390,10,1427.31,2,3,3,8,Regulars
5903,318,10,1440.0,2,3,3,8,Regulars
5904,72,9,1152.25,4,2,2,8,Regulars
5905,82,13,3113.65,4,4,5,13,Champions
5906,117,11,1846.85,4,3,4,11,Loyal
5907,202,10,1957.05,3,3,4,10,Big Spenders
5908,40,14,2340.82,5,5,4,14,Champions
5909,116,18,2347.15,4,5,4,13,Champions
5910,525,5,346.2,1,1,1,3,Hibernating
5911,71,13,3889.5,4,4,5,13,Champions
5912,456,10,1662.98,2,3,3,8,Regulars
5913,31,8,549.03,5,2,1,8,Regulars
5914,604,8,550.5300000000001,1,2,1,4,Hibernating
5915,183,13,2316.31,3,4,4,11,Big Spenders
5916,169,10,2529.78,3,3,4,10,Big Spenders
5917,402,12,3115.59,2,4,5,11,At Risk
5918,378,10,1191.69,2,3,2,7,Regulars
5919,266,8,1166.97,2,2,2,6,Hibernating
5920,89,7,1042.1299999999999,4,1,2,7,Regulars
5921,266,11,5168.43,2,3,5,10,Regulars
5922,167,8,282.61,3,2,1,6,Regulars
5923,369,9,655.9000000000001,2,2,1,5,Hibernating
5924,1279,4,274.46,1,1,1,3,Hibernating
5925,190,12,1055.25,3,4,2,9,Regulars
5926,280,7,504.81,2,1,1,4,Hibernating
5927,506,9,1348.95,1,2,3,6,Regulars
5928,78,8,823.6700000000001,4,2,1,7,Regulars
5929,573,6,549.0,1,1,1,3,Hibernating
5930,119,12,4579.469999999999,4,4,5,13,Champions
5931,165,14,7169.51,3,5,5,13,Big Spenders
5932,156,18,1072.28,3,5,2,10,Regulars
5933,47,10,1092.85,5,3,2,10,Loyal
5934,44,4,458.97,5,1,1,7,Regulars
5935,242,10,1032.0900000000001,3,3,2,8,Regulars
5936,266,9,2800.16,2,2,5,9,Regulars
5937,35,13,3175.5699999999997,5,4,5,14,Champions
5938,69,15,3976.93,4,5,5,14,Champions
5939,376,16,1745.48,2,5,4,11,At Risk
5940,143,8,1326.3700000000001,4,2,3,9,Regulars
5941,84,10,2502.56,4,3,4,11,Loyal
5942,58,19,4072.1,5,5,5,15,Champions
5943,732,10,3330.56,1,3,5,9,Regulars
5944,89,12,1735.69,4,4,4,12,Champions
5945,38,11,2121.96,5,3,4,12,Loyal
5946,234,13,2412.78,3,4,4,11,Big Spenders
5947,289,5,333.7,2,1,1,4,Hibernating
5948,143,11,1894.23,4,3,4,11,Loyal
5949,185,6,510.24,3,1,1,5,Regulars
5950,90,12,1719.9099999999999,4,4,3,11,Loyal
5951,906,10,2315.8,1,3,4,8,Regulars
5952,335,10,1168.03,2,3,2,7,Regulars
5953,297,13,2515.74,2,4,4,10,At Risk
5954,143,8,646.22,4,2,1,7,Regulars
5955,23,12,1489.75,5,4,3,12,Loyal
5956,816,13,2261.68,1,4,4,9,At Risk
5957,55,7,691.18,5,1,1,7,Regulars
5958,647,7,1912.44,1,1,4,6,Regulars
5959,44,13,1794.1299999999999,5,4,4,13,Champions
5960,72,11,1939.76,4,3,4,11,Loyal
5961,134,9,982.47,4,2,2,8,Regulars
5962,550,10,874.39,1,3,2,6,Regulars
5963,26,12,1593.69,5,4,3,12,Loyal
5964,582,7,958.14,1,1,2,4,Hibernating
5965,680,8,954.55,1,2,2,5,Hibernating
5966,232,13,1154.6100000000001,3,4,2,9,Regulars
5967,111,8,2856.9300000000003,4,2,5,11,Big Spenders
5968,230,7,1020.5699999999999,3,1,2,6,Regulars
5969,212,12,1510.8500000000001,3,4,3,10,Regulars
5970,112,8,2385.6800000000003,4,2,4,10,Big Spenders
5971,228,16,4304.18,3,5,5,13,Big Spenders
5972,212,15,1134.07,3,5,2,10,Regulars
5973,1071,7,1670.94,1,1,3,5,Regulars
5974,101,14,1386.9,4,5,3,12,Loyal
5975,699,8,810.5799999999999,1,2,1,4,Hibernating
5976,855,9,1330.02,1,2,3,6,Regulars
5977,23,10,2172.1600000000003,5,3,4,12,Loyal
5978,140,11,878.1500000000001,4,3,2,9,Loyal
5979,64,16,2041.47,5,5,4,14,Champions
5980,287,12,3160.99,2,4,5,11,At Risk
5981,287,4,213.43,2,1,1,4,Hibernating
5982,133,10,490.62,4,3,1,8,Loyal
5983,97,10,1293.94,4,3,3,10,Loyal
5984,482,3,182.95,1,1,1,3,Hibernating
5985,247,6,520.45,3,1,1,5,Regulars
5986,164,10,1340.22,3,3,3,9,Regulars
5987,153,12,3374.92,3,4,5,12,Big Spenders
5988,68,10,599.3199999999999,4,3,1,8,Loyal
5989,1293,9,570.8,1,2,1,4,Hibernating
5990,16,10,2862.44,5,3,5,13,Loyal
5991,60,10,2870.1,5,3,5,13,Loyal
5992,166,18,1504.97,3,5,3,11,Regulars
5993,40,13,2371.85,5,4,4,13,Champions
5994,46,11,756.0600000000001,5,3,1,9,Loyal
5995,400,6,969.9399999999999,2,1,2,5,Hibernating
5996,92,14,1375.23,4,5,3,12,Loyal
5997,315,9,1865.9699999999998,2,2,4,8,Regulars
5998,15,16,4414.2699999999995,5,5,5,15,Champions
5999,603,12,5256.2699999999995,1,4,5,10,At Risk
6000,166,9,1435.97,3,2,3,8,Regulars
6001,610,10,1893.86,1,3,4,8,Regulars
6002,621,9,1752.9699999999998,1,2,4,7,Regulars
6003,195,12,1489.92,3,4,3,10,Regulars
6004,119,4,594.78,4,1,1,6,Regulars
6005,120,11,1168.91,4,3,2,9,Loyal
6006,110,8,2139.96,4,2,4,10,Big Spenders
6007,270,12,967.61,2,4,2,8,At Risk
6008,56,7,595.22,5,1,1,7,Regulars
6009,321,9,922.61,2,2,2,6,Hibernating
6010,527,5,289.08,1,1,1,3,Hibernating
6011,160,8,383.89,3,2,1,6,Regulars
6012,816,6,1684.67,1,1,3,5,Regulars
6013,1111,12,3494.45,1,4,5,10,At Risk
6014,1,8,3873.3599999999997,5,2,5,12,Big Spenders
6015,82,15,4332.5199999999995,4,5,5,14,Champions
6016,283,8,1643.21,2,2,3,7,Regulars
6017,12,16,3472.94,5,5,5,15,Champions
6018,359,11,1463.77,2,3,3,8,Regulars
6019,82,9,2333.97,4,2,4,10,Big Spenders
6020,61,9,1339.75,5,2,3,10,Regulars
6021,64,10,1682.5000000000002,5,3,3,11,Loyal
6022,94,12,1439.21,4,4,3,11,Loyal
6023,387,12,1330.09,2,4,3,9,At Risk
6024,199,10,1435.66,3,3,3,9,Regulars
6025,623,9,1392.98,1,2,3,6,Regulars
6026,55,11,1419.95,5,3,3,11,Loyal
6027,538,12,1969.93,1,4,4,9,At Risk
6028,39,15,1292.6100000000001,5,5,3,13,Loyal
6029,259,13,1606.34,2,4,3,9,At Risk
6030,863,10,1104.39,1,3,2,6,Regulars
6031,187,10,1731.9,3,3,4,10,Big Spenders
6032,140,9,3299.4900000000002,4,2,5,11,Big Spenders
6033,19,9,1143.49,5,2,2,9,Regulars
6034,146,11,1380.27,4,3,3,10,Loyal
6035,665,10,840.0899999999999,1,3,1,5,Regulars
6036,36,14,1672.93,5,5,3,13,Loyal
6037,147,10,1468.74,4,3,3,10,Loyal
6038,43,7,970.25,5,1,2,8,Regulars
6039,99,10,1580.48,4,3,3,10,Loyal
6040,31,11,985.78,5,3,2,10,Loyal
6041,69,11,1256.17,4,3,3,10,Loyal
6042,498,15,1825.51,1,5,4,10,At Risk
6043,158,13,1566.1299999999999,3,4,3,10,Regulars
6044,131,14,2039.63,4,5,4,13,Champions
6045,272,4,241.26,2,1,1,4,Hibernating
6046,292,9,1554.99,2,2,3,7,Regulars
6047,303,6,492.53,2,1,1,4,Hibernating
6048,144,3,2304.1,4,1,4,9,Big Spenders
6049,11,9,2637.1099999999997,5,2,5,12,Big Spenders
6050,211,12,1680.98,3,4,3,10,Regulars
6051,206,13,4192.45,3,4,5,12,Big Spenders
6052,91,8,1372.1299999999999,4,2,3,9,Regulars
6053,358,8,634.64,2,2,1,5,Hibernating
6054,247,8,2756.27,3,2,5,10,Big Spenders
6055,465,10,1222.52,1,3,2,6,Regulars
6056,78,13,1355.99,4,4,3,11,Loyal
6057,421,7,527.17,2,1,1,4,Hibernating
6058,0,7,489.71,5,1,1,7,Regulars
6059,354,10,1485.0800000000002,2,3,3,8,Regulars
6060,476,10,3304.9,1,3,5,9,Regulars
6061,452,9,374.62,2,2,1,5,Hibernating
6062,241,13,1594.57,3,4,3,10,Regulars
6063,154,13,2396.0299999999997,3,4,4,11,Big Spenders
6064,125,6,611.99,4,1,1,6,Regulars
6065,39,13,1372.07,5,4,3,12,Loyal
6066,71,10,3472.5,4,3,5,12,Loyal
6067,665,12,4549.599999999999,1,4,5,10,At Risk
6068,1370,8,3200.59,1,2,5,8,Regulars
6069,4,13,1634.17,5,4,3,12,Loyal
6070,338,7,1485.31,2,1,3,6,Regulars
6071,34,10,898.55,5,3,2,10,Loyal
6072,218,13,1335.26,3,4,3,10,Regulars
6073,237,10,1103.27,3,3,2,8,Regulars
6074,446,10,1150.68,2,3,2,7,Regulars
6075,60,9,633.03,5,2,1,8,Regulars
6076,651,7,1526.3,1,1,3,5,Regulars
6077,271,11,3042.54,2,3,5,10,Regulars
6078,651,7,941.1400000000001,1,1,2,4,Hibernating
6079,9,9,1013.52,5,2,2,9,Regulars
6080,216,12,993.8199999999999,3,4,2,9,Regulars
6081,274,8,458.23,2,2,1,5,Hibernating
6082,58,10,2172.32,5,3,4,12,Loyal
6083,128,13,1542.69,4,4,3,11,Loyal
6084,293,13,2831.0699999999997,2,4,5,11,At Risk
6085,568,9,3154.59,1,2,5,8,Regulars
6086,696,5,883.4100000000001,1,1,2,4,Hibernating
6087,130,7,616.0999999999999,4,1,1,6,Regulars
6088,69,8,3065.2799999999997,4,2,5,11,Big Spenders
6089,565,5,615.68,1,1,1,3,Hibernating
6090,518,11,1237.48,1,3,2,6,Regulars
6091,75,7,833.86,4,1,1,6,Regulars
6092,103,11,1425.38,4,3,3,10,Loyal
6093,238,7,602.89,3,1,1,5,Regulars
6094,140,9,1612.0700000000002,4,2,3,9,Regulars
6095,153,6,495.42,3,1,1,5,Regulars
6096,317,10,1020.4199999999998,2,3,2,7,Regulars
6097,211,11,2457.2000000000003,3,3,4,10,Big Spenders
6098,54,10,1570.47,5,3,3,11,Loyal
6099,450,15,2056.0699999999997,2,5,4,11,At Risk
6100,1886,2,241.61,1,1,1,3,Hibernating
6101,759,7,3440.52,1,1,5,7,Regulars
6102,597,14,2410.84,1,5,4,10,At Risk
6103,203,14,1461.28,3,5,3,11,Regulars
6104,547,10,754.02,1,3,1,5,Regulars
6105,761,12,2094.9900000000002,1,4,4,9,At Risk
6106,3,19,4813.280000000001,5,5,5,15,Champions
6107,197,10,2909.11,3,3,5,11,Big Spenders
6108,123,5,815.03,4,1,1,6,Regulars
6109,4,10,3620.73,5,3,5,13,Loyal
6110,339,6,823.37,2,1,1,4,Hibernating
6111,397,11,2479.14,2,3,4,9,Regulars
6112,115,14,2962.36,4,5,5,14,Champions
6113,50,8,860.6700000000001,5,2,2,9,Regulars
6114,241,8,578.1999999999999,3,2,1,6,Regulars
6115,55,12,1295.15,5,4,3,12,Loyal
6116,366,15,3523.73,2,5,5,12,At Risk
6117,303,12,1597.98,2,4,3,9,At Risk
6118,151,12,2557.59,3,4,4,11,Big Spenders
6119,392,11,4104.11,2,3,5,10,Regulars
6120,196,13,2052.64,3,4,4,11,Big Spenders
6121,74,11,1460.09,4,3,3,10,Loyal
6122,228,10,1218.42,3,3,2,8,Regulars
6123,419,17,3404.12,2,5,5,12,At Risk
6124,346,13,1643.21,2,4,3,9,At Risk
6125,148,12,1507.64,3,4,3,10,Regulars
6126,152,5,847.96,3,1,2,6,Regulars
6127,558,10,1209.05,1,3,2,6,Regulars
6128,213,5,216.70999999999998,3,1,1,5,Regulars
6129,30,17,1649.14,5,5,3,13,Loyal
6130,43,13,1451.53,5,4,3,12,Loyal
6131,83,9,1477.82,4,2,3,9,Regulars
6132,908,13,1861.86,1,4,4,9,At Risk
6133,122,16,2035.01,4,5,4,13,Champions
6134,44,14,1804.38,5,5,4,14,Champions
6135,78,11,3140.01,4,3,5,12,Loyal
6136,3,8,3519.67,5,2,5,12,Big Spenders
6137,275,9,2830.3,2,2,5,9,Regulars
6138,479,9,1748.21,1,2,4,7,Regulars
6139,52,8,6017.54,5,2,5,12,Big Spenders
6140,40,6,677.66,5,1,1,7,Regulars
6141,142,7,801.7099999999999,4,1,1,6,Regulars
6142,82,14,3764.92,4,5,5,14,Champions
6143,167,10,1419.32,3,3,3,9,Regulars
6144,120,17,2222.13,4,5,4,13,Champions
6145,25,15,2412.8,5,5,4,14,Champions
6146,80,10,1048.91,4,3,2,9,Loyal
6147,128,11,705.53,4,3,1,8,Loyal
6148,86,13,1950.66,4,4,4,12,Champions
6149,80,7,1562.99,4,1,3,8,Regulars
6150,25,14,1606.58,5,5,3,13,Loyal
6151,413,10,999.9599999999999,2,3,2,7,Regulars
6152,13,9,703.38,5,2,1,8,Regulars
6153,159,8,2451.1,3,2,4,9,Big Spenders
6154,85,7,715.48,4,1,1,6,Regulars
6155,31,10,1912.2,5,3,4,12,Loyal
6156,227,5,345.02,3,1,1,5,Regulars
6157,25,12,2685.92,5,4,5,14,Champions
6158,82,11,2996.49,4,3,5,12,Loyal
6159,617,9,1032.08,1,2,2,5,Hibernating
6160,245,10,727.76,3,3,1,7,Regulars
6161,193,15,3343.8,3,5,5,13,Big Spenders
6162,344,7,2026.9399999999998,2,1,4,7,Regulars
6163,50,11,1297.49,5,3,3,11,Loyal
6164,549,10,2496.57,1,3,4,8,Regulars
6165,93,9,2080.5,4,2,4,10,Big Spenders
6166,148,14,2625.42,3,5,5,13,Big Spenders
6167,70,8,690.56,4,2,1,7,Regulars
6168,41,13,1158.55,5,4,2,11,Loyal
6169,111,13,1894.76,4,4,4,12,Champions
6170,162,9,2093.9399999999996,3,2,4,9,Big Spenders
6171,226,11,1063.2,3,3,2,8,Regulars
6172,291,13,1021.27,2,4,2,8,At Risk
6173,102,19,1986.74,4,5,4,13,Champions
6174,20,17,6816.65,5,5,5,15,Champions
6175,289,6,2253.54,2,1,4,7,Regulars
6176,13,7,782.48,5,1,1,7,Regulars
6177,684,10,2328.0899999999997,1,3,4,8,Regulars
6178,389,10,3046.87,2,3,5,10,Regulars
6179,75,8,1167.81,4,2,2,8,Regulars
6180,1331,6,460.13,1,1,1,3,Hibernating
6181,192,14,2699.5099999999998,3,5,5,13,Big Spenders
6182,571,14,3414.54,1,5,5,11,At Risk
6183,151,11,2723.8,3,3,5,11,Big Spenders
6184,173,8,2963.0099999999998,3,2,5,10,Big Spenders
6185,421,9,1269.44,2,2,3,7,Regulars
6186,85,10,2450.69,4,3,4,11,Loyal
6187,658,5,2529.31,1,1,4,6,Regulars
6188,51,9,1414.31,5,2,3,10,Regulars
6189,161,18,2787.21,3,5,5,13,Big Spenders
6190,45,9,819.0099999999999,5,2,1,8,Regulars
6191,132,6,647.24,4,1,1,6,Regulars
6192,39,11,4246.06,5,3,5,13,Loyal
6193,199,13,1384.23,3,4,3,10,Regulars
6194,212,13,1693.3,3,4,3,10,Regulars
6195,217,11,874.36,3,3,2,8,Regulars
6196,1252,7,1435.59,1,1,3,5,Regulars
6197,207,13,1606.3400000000001,3,4,3,10,Regulars
6198,238,9,672.75,3,2,1,6,Regulars
6199,33,11,1191.8,5,3,2,10,Loyal
6200,208,10,910.2,3,3,2,8,Regulars
6201,107,9,717.65,4,2,1,7,Regulars
6202,532,14,3822.1499999999996,1,5,5,11,At Risk
6203,50,9,773.66,5,2,1,8,Regulars
6204,19,15,1861.7600000000002,5,5,4,14,Champions
6205,511,8,1422.3600000000001,1,2,3,6,Regulars
6206,115,11,1001.62,4,3,2,9,Loyal
6207,269,12,2136.29,2,4,4,10,At Risk
6208,55,11,872.17,5,3,2,10,Loyal
6209,92,7,1157.22,4,1,2,7,Regulars
6210,160,8,988.8299999999999,3,2,2,7,Regulars
6211,567,8,1037.1399999999999,1,2,2,5,Hibernating
6212,230,7,1070.3,3,1,2,6,Regulars
6213,215,11,4542.94,3,3,5,11,Big Spenders
6214,268,12,1945.8700000000001,2,4,4,10,At Risk
6215,49,13,1394.13,5,4,3,12,Loyal
6216,85,8,661.03,4,2,1,7,Regulars
6217,492,8,875.2900000000001,1,2,2,5,Hibernating
6218,3,15,1111.75,5,5,2,12,Loyal
6219,1401,8,884.38,1,2,2,5,Hibernating
6220,688,7,2168.19,1,1,4,6,Regulars
6221,74,10,1317.84,4,3,3,10,Loyal
6222,406,10,1441.5,2,3,3,8,Regulars
6223,1260,6,2038.77,1,1,4,6,Regulars
6224,708,6,585.01,1,1,1,3,Hibernating
6225,564,5,1030.5,1,1,2,4,Hibernating
6226,217,12,3200.76,3,4,5,12,Big Spenders
6227,125,12,1143.79,4,4,2,10,Loyal
6228,156,5,1025.1000000000001,3,1,2,6,Regulars
6229,42,17,1772.45,5,5,4,14,Champions
6230,647,8,941.8599999999999,1,2,2,5,Hibernating
6231,435,7,565.11,2,1,1,4,Hibernating
6232,476,12,3121.33,1,4,5,10,At Risk
6233,204,14,1577.54,3,5,3,11,Regulars
6234,45,9,793.51,5,2,1,8,Regulars
6235,169,11,1742.02,3,3,4,10,Big Spenders
6236,90,12,1182.6299999999999,4,4,2,10,Loyal
6237,284,8,2441.66,2,2,4,8,Regulars
6238,103,8,390.37,4,2,1,7,Regulars
6239,12,12,3562.26,5,4,5,14,Champions
6240,237,8,2561.6800000000003,3,2,4,9,Big Spenders
6241,554,5,735.8299999999999,1,1,1,3,Hibernating
6242,254,6,3189.5800000000004,2,1,5,8,Regulars
6243,172,13,1358.78,3,4,3,10,Regulars
6244,75,5,997.95,4,1,2,7,Regulars
6245,2,11,2344.91,5,3,4,12,Loyal
6246,281,15,3254.25,2,5,5,12,At Risk
6247,154,8,794.1700000000001,3,2,1,6,Regulars
6248,932,12,2468.93,1,4,4,9,At Risk
6249,78,9,2233.71,4,2,4,10,Big Spenders
6250,684,10,604.33,1,3,1,5,Regulars
6251,40,11,1433.48,5,3,3,11,Loyal
6252,332,6,323.39,2,1,1,4,Hibernating
6253,123,13,1838.8999999999999,4,4,4,12,Champions
6254,364,5,747.26,2,1,1,4,Hibernating
6255,145,9,4260.21,4,2,5,11,Big Spenders
6256,256,15,698.96,2,5,1,8,At Risk
6257,516,5,337.82,1,1,1,3,Hibernating
6258,153,10,1423.4099999999999,3,3,3,9,Regulars
6259,110,8,3135.85,4,2,5,11,Big Spenders
6260,556,8,1007.84,1,2,2,5,Hibernating
6261,380,12,958.1500000000001,2,4,2,8,At Risk
6262,260,15,3799.52,2,5,5,12,At Risk
6263,126,9,947.29,4,2,2,8,Regulars
6264,956,10,863.77,1,3,2,6,Regulars
6265,442,13,1499.51,2,4,3,9,At Risk
6266,12,13,2412.33,5,4,4,13,Champions
6267,138,7,674.49,4,1,1,6,Regulars
6268,65,7,1039.97,5,1,2,8,Regulars
6269,560,12,1129.19,1,4,2,7,At Risk
6270,333,7,1456.99,2,1,3,6,Regulars
6271,19,10,1533.86,5,3,3,11,Loyal
6272,6,8,1088.64,5,2,2,9,Regulars
6273,120,18,2295.9300000000003,4,5,4,13,Champions
6274,111,10,2617.63,4,3,5,12,Loyal
6275,746,13,3589.61,1,4,5,10,At Risk
6276,386,12,1997.45,2,4,4,10,At Risk
6277,217,10,2717.54,3,3,5,11,Big Spenders
6278,367,14,2149.82,2,5,4,11,At Risk
6279,227,13,1128.23,3,4,2,9,Regulars
6280,633,10,1976.79,1,3,4,8,Regulars
6281,267,16,2465.28,2,5,4,11,At Risk
6282,618,11,2364.8700000000003,1,3,4,8,Regulars
6283,261,6,619.8100000000001,2,1,1,4,Hibernating
6284,31,11,1449.75,5,3,3,11,Loyal
6285,87,9,1170.17,4,2,2,8,Regulars
6286,225,13,1174.73,3,4,2,9,Regulars
6287,67,12,5508.24,4,4,5,13,Champions
6288,584,9,826.93,1,2,1,4,Hibernating
6289,259,7,703.08,2,1,1,4,Hibernating
6290,161,14,3688.7700000000004,3,5,5,13,Big Spenders
6291,307,8,1238.87,2,2,2,6,Hibernating
6292,406,8,762.11,2,2,1,5,Hibernating
6293,205,10,836.22,3,3,1,7,Regulars
6294,286,6,805.55,2,1,1,4,Hibernating
6295,481,7,306.12,1,1,1,3,Hibernating
6296,40,11,827.9200000000001,5,3,1,9,Loyal
6297,293,11,1260.12,2,3,3,8,Regulars
6298,306,8,808.92,2,2,1,5,Hibernating
6299,229,15,3743.14,3,5,5,13,Big Spenders
6300,503,4,331.81,1,1,1,3,Hibernating
6301,169,11,3317.54,3,3,5,11,Big Spenders
6302,113,14,4875.91,4,5,5,14,Champions
6303,262,13,2038.96,2,4,4,10,At Risk
6304,65,12,2432.58,5,4,4,13,Champions
6305,279,14,3885.37,2,5,5,12,At Risk
6306,281,11,3316.8900000000003,2,3,5,10,Regulars
6307,156,9,2078.22,3,2,4,9,Big Spenders
6308,545,14,3929.45,1,5,5,11,At Risk
6309,1027,8,817.24,1,2,1,4,Hibernating
6310,37,12,1204.6299999999999,5,4,2,11,Loyal
6311,169,11,3292.1699999999996,3,3,5,11,Big Spenders
6312,61,8,1103.83,5,2,2,9,Regulars
6313,295,9,1008.42,2,2,2,6,Hibernating
6314,193,5,452.84,3,1,1,5,Regulars
6315,198,7,3163.45,3,1,5,9,Big Spenders
6316,605,9,591.66,1,2,1,4,Hibernating
6317,354,7,1821.48,2,1,4,7,Regulars
6318,13,9,799.12,5,2,1,8,Regulars
6319,49,15,2273.81,5,5,4,14,Champions
6320,187,10,1877.58,3,3,4,10,Big Spenders
6321,583,7,838.1800000000001,1,1,1,3,Hibernating
6322,966,4,1056.69,1,1,2,4,Hibernating
6323,1097,7,904.44,1,1,2,4,Hibernating
6324,26,8,3335.5099999999998,5,2,5,12,Big Spenders
6325,153,12,889.77,3,4,2,9,Regulars
6326,78,16,3342.2,4,5,5,14,Champions
6327,466,9,1436.03,1,2,3,6,Regulars
6328,520,11,934.4300000000001,1,3,2,6,Regulars
6329,110,8,2050.73,4,2,4,10,Big Spenders
6330,413,14,1622.75,2,5,3,10,At Risk
6331,151,9,746.94,3,2,1,6,Regulars
6332,427,10,967.94,2,3,2,7,Regulars
6333,232,18,4087.3700000000003,3,5,5,13,Big Spenders
6334,391,3,3899.9300000000003,2,1,5,8,Regulars
6335,26,12,2483.39,5,4,4,13,Champions
6336,291,11,1292.21,2,3,3,8,Regulars
6337,489,7,1893.09,1,1,4,6,Regulars
6338,89,10,1661.02,4,3,3,10,Loyal
6339,166,10,2209.02,3,3,4,10,Big Spenders
6340,1327,5,240.36999999999998,1,1,1,3,Hibernating
6341,154,8,798.47,3,2,1,6,Regulars
6342,262,13,1900.16,2,4,4,10,At Risk
6343,455,9,1464.99,2,2,3,7,Regulars
6344,862,8,2781.92,1,2,5,8,Regulars
6345,166,11,2129.84,3,3,4,10,Big Spenders
6346,133,12,2323.61,4,4,4,12,Champions
6347,194,12,4689.7300000000005,3,4,5,12,Big Spenders
6348,65,12,3487.87,5,4,5,14,Champions
6349,637,6,902.24,1,1,2,4,Hibernating
6350,698,4,1853.04,1,1,4,6,Regulars
6351,49,13,1351.48,5,4,3,12,Loyal
6352,178,14,1077.17,3,5,2,10,Regulars
6353,946,8,1094.73,1,2,2,5,Hibernating
6354,19,12,1872.8400000000001,5,4,4,13,Champions
6355,275,9,2826.42,2,2,5,9,Regulars
6356,146,11,820.4200000000001,4,3,1,8,Loyal
6357,139,13,2472.39,4,4,4,12,Champions
6358,135,13,1346.06,4,4,3,11,Loyal
6359,291,7,409.59,2,1,1,4,Hibernating
6360,65,10,1536.28,5,3,3,11,Loyal
6361,235,7,2577.52,3,1,5,9,Big Spenders
6362,303,12,1128.42,2,4,2,8,At Risk
6363,691,9,1568.8,1,2,3,6,Regulars
6364,117,13,2978.12,4,4,5,13,Champions
6365,408,5,2717.29,2,1,5,8,Regulars
6366,110,12,2674.05,4,4,5,13,Champions
6367,484,10,1953.2199999999998,1,3,4,8,Regulars
6368,258,11,1150.83,2,3,2,7,Regulars
6369,209,9,891.2,3,2,2,7,Regulars
6370,351,12,2573.52,2,4,4,10,At Risk
6371,52,12,3813.4,5,4,5,14,Champions
6372,110,10,1000.81,4,3,2,9,Loyal
6373,13,9,917.26,5,2,2,9,Regulars
6374,68,10,1930.1499999999999,4,3,4,11,Loyal
6375,88,17,1957.5900000000001,4,5,4,13,Champions
6376,122,15,2186.08,4,5,4,13,Champions
6377,411,12,934.59,2,4,2,8,At Risk
6378,106,7,747.02,4,1,1,6,Regulars
6379,583,10,3593.62,1,3,5,9,Regulars
6380,260,8,341.03,2,2,1,5,Hibernating
6381,48,10,2393.9900000000002,5,3,4,12,Loyal
6382,247,15,2727.81,3,5,5,13,Big Spenders
6383,124,13,984.61,4,4,2,10,Loyal
6384,147,14,1524.3600000000001,4,5,3,12,Loyal
6385,372,8,889.39,2,2,2,6,Hibernating
6386,389,13,2473.14,2,4,4,10,At Risk
6387,514,11,1021.2600000000001,1,3,2,6,Regulars
6388,489,13,2098.61,1,4,4,9,At Risk
6389,54,11,1729.24,5,3,4,12,Loyal
6390,136,15,1840.91,4,5,4,13,Champions
6391,577,8,790.57,1,2,1,4,Hibernating
6392,259,8,1308.8,2,2,3,7,Regulars
6393,3,6,1346.68,5,1,3,9,Regulars
6394,186,8,2593.59,3,2,5,10,Big Spenders
6395,37,14,2705.47,5,5,5,15,Champions
6396,80,16,1659.04,4,5,3,12,Loyal
6397,267,9,865.23,2,2,2,6,Hibernating
6398,288,10,1833.4400000000003,2,3,4,9,Regulars
6399,711,7,686.13,1,1,1,3,Hibernating
6400,125,18,2149.31,4,5,4,13,Champions
6401,46,12,1224.29,5,4,2,11,Loyal
6402,23,7,510.78999999999996,5,1,1,7,Regulars
6403,147,11,957.3800000000001,4,3,2,9,Loyal
6404,27,15,3382.15,5,5,5,15,Champions
6405,35,15,1973.15,5,5,4,14,Champions
6406,258,16,2560.15,2,5,4,11,At Risk
6407,394,12,660.5899999999999,2,4,1,7,At Risk
6408,1192,6,736.76,1,1,1,3,Hibernating
6409,45,11,915.76,5,3,2,10,Loyal
6410,244,9,717.92,3,2,1,6,Regulars
6411,94,9,989.66,4,2,2,8,Regulars
6412,450,7,517.6,2,1,1,4,Hibernating
6413,95,11,1562.46,4,3,3,10,Loyal
6414,105,8,2024.89,4,2,4,10,Big Spenders
6415,266,8,645.97,2,2,1,5,Hibernating
6416,156,7,512.9300000000001,3,1,1,5,Regulars
6417,38,7,1846.85,5,1,4,10,Big Spenders
6418,164,6,407.22,3,1,1,5,Regulars
6419,188,14,1359.25,3,5,3,11,Regulars
6420,167,13,1788.43,3,4,4,11,Big Spenders
6421,53,11,1541.96,5,3,3,11,Loyal
6422,95,6,355.81,4,1,1,6,Regulars
6423,108,16,1479.48,4,5,3,12,Loyal
6424,10,6,839.29,5,1,1,7,Regulars
6425,155,13,1631.38,3,4,3,10,Regulars
6426,342,12,1054.94,2,4,2,8,At Risk
6427,293,9,2118.71,2,2,4,8,Regulars
6428,301,8,738.6,2,2,1,5,Hibernating
6429,41,13,3527.05,5,4,5,14,Champions
6430,82,11,1205.74,4,3,2,9,Loyal
6431,218,7,1166.65,3,1,2,6,Regulars
6432,319,12,1371.53,2,4,3,9,At Risk
6433,27,11,1037.98,5,3,2,10,Loyal
6434,305,9,1601.43,2,2,3,7,Regulars
6435,112,10,977.8,4,3,2,9,Loyal
6436,349,8,1053.22,2,2,2,6,Hibernating
6437,524,13,4217.12,1,4,5,10,At Risk
6438,178,12,1273.71,3,4,3,10,Regulars
6439,62,15,3967.8599999999997,5,5,5,15,Champions
6440,65,11,978.77,5,3,2,10,Loyal
6441,92,14,4932.06,4,5,5,14,Champions
6442,582,6,462.4,1,1,1,3,Hibernating
6443,150,10,1613.99,3,3,3,9,Regulars
6444,269,7,969.5500000000001,2,1,2,5,Hibernating
6445,74,7,839.49,4,1,1,6,Regulars
6446,124,12,1233.1,4,4,2,10,Loyal
6447,420,9,1114.1100000000001,2,2,2,6,Hibernating
6448,4,12,2215.67,5,4,4,13,Champions
6449,243,14,1802.4499999999998,3,5,4,12,Big Spenders
6450,333,11,1545.83,2,3,3,8,Regulars
6451,544,11,1285.83,1,3,3,7,Regulars
6452,54,9,723.87,5,2,1,8,Regulars
6453,161,14,2312.9,3,5,4,12,Big Spenders
6454,222,12,1628.1000000000001,3,4,3,10,Regulars
6455,124,9,4229.090000000001,4,2,5,11,Big Spenders
6456,878,7,2121.54,1,1,4,6,Regulars
6457,223,14,1605.53,3,5,3,11,Regulars
6458,124,11,2231.7,4,3,4,11,Loyal
6459,259,13,2035.83,2,4,4,10,At Risk
6460,234,13,2662.3999999999996,3,4,5,12,Big Spenders
6461,116,6,589.06,4,1,1,6,Regulars
6462,273,12,1294.42,2,4,3,9,At Risk
6463,389,14,2685.76,2,5,5,12,At Risk
6464,1057,8,593.96,1,2,1,4,Hibernating
6465,381,9,1020.91,2,2,2,6,Hibernating
6466,764,7,2870.84,1,1,5,7,Regulars
6467,347,13,1774.08,2,4,4,10,At Risk
6468,37,11,1681.57,5,3,3,11,Loyal
6469,368,12,2555.58,2,4,4,10,At Risk
6470,43,11,921.06,5,3,2,10,Loyal
6471,545,9,442.68,1,2,1,4,Hibernating
6472,384,11,789.32,2,3,1,6,Regulars
6473,394,17,1736.96,2,5,4,11,At Risk
6474,284,9,645.15,2,2,1,5,Hibernating
6475,155,10,1276.17,3,3,3,9,Regulars
6476,511,7,2937.3599999999997,1,1,5,7,Regulars
6477,67,12,2922.41,4,4,5,13,Champions
6478,257,6,955.59,2,1,2,5,Hibernating
6479,148,12,2153.39,3,4,4,11,Big Spenders
6480,195,11,1835.48,3,3,4,10,Big Spenders
6481,131,10,2123.41,4,3,4,11,Loyal
6482,338,9,2768.65,2,2,5,9,Regulars
6483,40,18,2339.1,5,5,4,14,Champions
6484,847,10,2928.5,1,3,5,9,Regulars
6485,312,10,2738.5,2,3,5,10,Regulars
6486,66,9,969.87,4,2,2,8,Regulars
6487,2,11,1701.72,5,3,3,11,Loyal
6488,176,16,1253.26,3,5,3,11,Regulars
6489,122,8,860.12,4,2,2,8,Regulars
6490,164,7,849.59,3,1,2,6,Regulars
6491,351,11,5284.339999999999,2,3,5,10,Regulars
6492,50,9,1069.75,5,2,2,9,Regulars
6493,449,11,1129.72,2,3,2,7,Regulars
6494,217,11,1147.74,3,3,2,8,Regulars
6495,243,11,4300.589999999999,3,3,5,11,Big Spenders
6496,543,7,1858.69,1,1,4,6,Regulars
6497,345,9,3442.9900000000002,2,2,5,9,Regulars
6498,42,8,845.85,5,2,2,9,Regulars
6499,502,9,1386.17,1,2,3,6,Regulars
6500,514,11,2403.42,1,3,4,8,Regulars
6501,268,9,1052.04,2,2,2,6,Hibernating
6502,143,14,6186.86,4,5,5,14,Champions
6503,1189,3,140.0,1,1,1,3,Hibernating
6504,111,18,2891.06,4,5,5,14,Champions
6505,143,8,717.11,4,2,1,7,Regulars
6506,262,10,899.8000000000001,2,3,2,7,Regulars
6507,262,8,813.9,2,2,1,5,Hibernating
6508,16,12,2448.13,5,4,4,13,Champions
6509,488,7,2140.88,1,1,4,6,Regulars
6510,433,11,1345.71,2,3,3,8,Regulars
6511,110,7,2853.05,4,1,5,10,Big Spenders
6512,202,12,3985.17,3,4,5,12,Big Spenders
6513,118,6,1051.2,4,1,2,7,Regulars
6514,71,14,1640.75,4,5,3,12,Loyal
6515,645,11,849.59,1,3,2,6,Regulars
6516,442,8,1635.8799999999999,2,2,3,7,Regulars
6517,47,19,3642.89,5,5,5,15,Champions
6518,1056,6,1179.36,1,1,2,4,Hibernating
6519,1292,10,600.88,1,3,1,5,Regulars
6520,65,15,2656.83,5,5,5,15,Champions
6521,262,11,1243.08,2,3,3,8,Regulars
6522,682,9,961.8199999999999,1,2,2,5,Hibernating
6523,150,12,3105.29,3,4,5,12,Big Spenders
6524,605,8,1033.0,1,2,2,5,Hibernating
6525,181,13,2377.99,3,4,4,11,Big Spenders
6526,102,8,1580.3200000000002,4,2,3,9,Regulars
6527,311,4,1102.24,2,1,2,5,Hibernating
6528,162,9,1752.61,3,2,4,9,Big Spenders
6529,137,13,1405.56,4,4,3,11,Loyal
6530,128,12,2128.58,4,4,4,12,Champions
6531,103,16,1902.1100000000001,4,5,4,13,Champions
6532,221,13,1596.42,3,4,3,10,Regulars
6533,309,11,3090.48,2,3,5,10,Regulars
6534,111,6,1114.9899999999998,4,1,2,7,Regulars
6535,490,8,871.3800000000001,1,2,2,5,Hibernating
6536,35,15,2465.89,5,5,4,14,Champions
6537,371,9,923.8199999999999,2,2,2,6,Hibernating
6538,279,11,927.91,2,3,2,7,Regulars
6539,904,9,825.25,1,2,1,4,Hibernating
6540,113,8,3534.75,4,2,5,11,Big Spenders
6541,879,6,759.4300000000001,1,1,1,3,Hibernating
6542,209,13,1370.15,3,4,3,10,Regulars
6543,122,12,1619.97,4,4,3,11,Loyal
6544,69,9,390.32,4,2,1,7,Regulars
6545,112,13,986.81,4,4,2,10,Loyal
6546,405,11,1522.1499999999999,2,3,3,8,Regulars
6547,222,9,1707.9399999999998,3,2,3,8,Regulars
6548,101,10,1358.23,4,3,3,10,Loyal
6549,197,9,830.89,3,2,1,6,Regulars
6550,118,9,2668.85,4,2,5,11,Big Spenders
6551,22,10,997.3399999999999,5,3,2,10,Loyal
6552,843,4,886.07,1,1,2,4,Hibernating
6553,166,14,5092.78,3,5,5,13,Big Spenders
6554,495,6,945.33,1,1,2,4,Hibernating
6555,323,10,1317.2,2,3,3,8,Regulars
6556,26,13,3654.0200000000004,5,4,5,14,Champions
6557,98,16,2895.9200000000005,4,5,5,14,Champions
6558,28,5,351.11999999999995,5,1,1,7,Regulars
6559,298,9,903.86,2,2,2,6,Hibernating
6560,411,13,1656.01,2,4,3,9,At Risk
6561,78,7,1337.55,4,1,3,8,Regulars
6562,331,11,1473.44,2,3,3,8,Regulars
6563,99,8,3816.8,4,2,5,11,Big Spenders
6564,22,14,2266.81,5,5,4,14,Champions
6565,99,18,3733.31,4,5,5,14,Champions
6566,28,20,2461.94,5,5,4,14,Champions
6567,499,6,508.65999999999997,1,1,1,3,Hibernating
6568,80,9,746.04,4,2,1,7,Regulars
6569,345,9,1158.33,2,2,2,6,Hibernating
6570,452,8,2715.98,2,2,5,9,Regulars
6571,184,7,1454.98,3,1,3,7,Regulars
6572,287,8,2217.13,2,2,4,8,Regulars
6573,205,14,1093.23,3,5,2,10,Regulars
6574,92,8,1498.76,4,2,3,9,Regulars
6575,656,4,243.52999999999997,1,1,1,3,Hibernating
6576,13,10,938.23,5,3,2,10,Loyal
6577,706,8,1025.42,1,2,2,5,Hibernating
6578,142,12,1148.55,4,4,2,10,Loyal
6579,43,9,1054.8600000000001,5,2,2,9,Regulars
6580,352,14,1572.75,2,5,3,10,At Risk
6581,177,11,3221.42,3,3,5,11,Big Spenders
6582,313,11,1067.92,2,3,2,7,Regulars
6583,1,7,989.76,5,1,2,8,Regulars
6584,28,8,1276.29,5,2,3,10,Regulars
6585,48,14,4104.91,5,5,5,15,Champions
6586,545,10,2957.94,1,3,5,9,Regulars
6587,2,15,3227.6800000000003,5,5,5,15,Champions
6588,211,10,898.23,3,3,2,8,Regulars
6589,228,13,4308.39,3,4,5,12,Big Spenders
6590,939,8,1046.14,1,2,2,5,Hibernating
6591,672,10,1346.26,1,3,3,7,Regulars
6592,262,11,2720.93,2,3,5,10,Regulars
6593,553,5,737.68,1,1,1,3,Hibernating
6594,195,6,627.84,3,1,1,5,Regulars
6595,209,14,2925.0299999999997,3,5,5,13,Big Spenders
6596,130,10,5805.18,4,3,5,12,Loyal
6597,314,10,757.05,2,3,1,6,Regulars
6598,306,3,1767.93,2,1,4,7,Regulars
6599,264,8,934.6500000000001,2,2,2,6,Hibernating
6600,227,10,983.81,3,3,2,8,Regulars
6601,5,15,2680.84,5,5,5,15,Champions
6602,656,11,1327.79,1,3,3,7,Regulars
6603,198,6,1481.26,3,1,3,7,Regulars
6604,211,11,3609.35,3,3,5,11,Big Spenders
6605,149,10,1139.48,3,3,2,8,Regulars
6606,214,13,1012.3399999999999,3,4,2,9,Regulars
6607,310,10,1083.37,2,3,2,7,Regulars
6608,386,10,1075.6100000000001,2,3,2,7,Regulars
6609,16,12,2655.22,5,4,5,14,Champions
6610,109,9,791.17,4,2,1,7,Regulars
6611,567,8,1025.19,1,2,2,5,Hibernating
6612,19,16,1948.22,5,5,4,14,Champions
6613,78,11,1255.32,4,3,3,10,Loyal
6614,132,15,3109.69,4,5,5,14,Champions
6615,112,12,2687.41,4,4,5,13,Champions
6616,199,8,701.2,3,2,1,6,Regulars
6617,527,7,690.15,1,1,1,3,Hibernating
6618,87,10,2893.91,4,3,5,12,Loyal
6619,125,11,1500.29,4,3,3,10,Loyal
6620,141,19,3422.68,4,5,5,14,Champions
6621,305,8,4448.02,2,2,5,9,Regulars
6622,322,10,3845.38,2,3,5,10,Regulars
6623,93,13,2820.1600000000003,4,4,5,13,Champions
6624,38,6,901.67,5,1,2,8,Regulars
6625,21,7,1148.33,5,1,2,8,Regulars
6626,528,8,797.09,1,2,1,4,Hibernating
6627,149,6,870.8199999999999,3,1,2,6,Regulars
6628,15,12,1192.87,5,4,2,11,Loyal
6629,113,16,1445.1,4,5,3,12,Loyal
6630,263,6,861.46,2,1,2,5,Hibernating
6631,938,6,2267.64,1,1,4,6,Regulars
6632,30,13,2294.39,5,4,4,13,Champions
6633,997,9,560.9000000000001,1,2,1,4,Hibernating
6634,70,12,968.63,4,4,2,10,Loyal
6635,793,9,1285.54,1,2,3,6,Regulars
6636,40,21,3178.37,5,5,5,15,Champions
6637,64,12,1875.15,5,4,4,13,Champions
6638,602,8,2622.52,1,2,5,8,Regulars
6639,146,9,5483.81,4,2,5,11,Big Spenders
6640,561,7,659.78,1,1,1,3,Hibernating
6641,141,11,1458.0800000000002,4,3,3,10,Loyal
6642,124,8,1267.48,4,2,3,9,Regulars
6643,30,11,2062.5299999999997,5,3,4,12,Loyal
6644,258,12,2237.31,2,4,4,10,At Risk
6645,205,12,5109.61,3,4,5,12,Big Spenders
6646,596,11,2645.18,1,3,5,9,Regulars
6647,61,9,1217.17,5,2,2,9,Regulars
6648,267,10,3904.04,2,3,5,10,Regulars
6649,460,9,812.95,1,2,1,4,Hibernating
6650,572,8,512.75,1,2,1,4,Hibernating
6651,154,7,538.92,3,1,1,5,Regulars
6652,2,11,601.56,5,3,1,9,Loyal
6653,243,10,4321.4800000000005,3,3,5,11,Big Spenders
6654,836,5,289.82,1,1,1,3,Hibernating
6655,188,8,1727.52,3,2,4,9,Big Spenders
6656,245,7,1110.13,3,1,2,6,Regulars
6657,50,12,2017.82,5,4,4,13,Champions
6658,207,16,3230.52,3,5,5,13,Big Spenders
6659,17,9,635.21,5,2,1,8,Regulars
6660,82,13,2308.15,4,4,4,12,Champions
6661,25,8,2016.87,5,2,4,11,Big Spenders
6662,40,8,811.52,5,2,1,8,Regulars
6663,0,10,2242.98,5,3,4,12,Loyal
6664,225,15,1328.04,3,5,3,11,Regulars
6665,204,14,3770.7599999999998,3,5,5,13,Big Spenders
6666,199,6,910.31,3,1,2,6,Regulars
6667,43,12,1358.99,5,4,3,12,Loyal
6668,372,5,550.5999999999999,2,1,1,4,Hibernating
6669,153,13,2686.5899999999997,3,4,5,12,Big Spenders
6670,276,18,3944.53,2,5,5,12,At Risk
6671,573,9,833.88,1,2,1,4,Hibernating
6672,155,11,1135.61,3,3,2,8,Regulars
6673,176,12,1961.96,3,4,4,11,Big Spenders
6674,3,12,1403.47,5,4,3,12,Loyal
6675,41,8,739.49,5,2,1,8,Regulars
6676,331,6,526.38,2,1,1,4,Hibernating
6677,763,8,1454.58,1,2,3,6,Regulars
6678,277,6,347.67,2,1,1,4,Hibernating
6679,176,12,2681.54,3,4,5,12,Big Spenders
6680,9,11,706.85,5,3,1,9,Loyal
6681,60,16,1513.8,5,5,3,13,Loyal
6682,316,9,2701.43,2,2,5,9,Regulars
6683,303,5,868.0,2,1,2,5,Hibernating
6684,71,10,930.7900000000001,4,3,2,9,Loyal
6685,1185,8,657.99,1,2,1,4,Hibernating
6686,20,12,3017.7799999999997,5,4,5,14,Champions
6687,20,11,2324.64,5,3,4,12,Loyal
6688,65,10,2007.21,5,3,4,12,Loyal
6689,2,13,3626.85,5,4,5,14,Champions
6690,245,16,2399.65,3,5,4,12,Big Spenders
6691,555,7,667.71,1,1,1,3,Hibernating
6692,93,15,2003.77,4,5,4,13,Champions
6693,29,11,1186.31,5,3,2,10,Loyal
6694,210,8,1865.06,3,2,4,9,Big Spenders
6695,180,6,542.1600000000001,3,1,1,5,Regulars
6696,335,8,1020.93,2,2,2,6,Hibernating
6697,129,8,996.67,4,2,2,8,Regulars
6698,80,13,2524.36,4,4,4,12,Champions
6699,50,9,1674.72,5,2,3,10,Regulars
6700,368,12,2217.7,2,4,4,10,At Risk
6701,243,9,1042.49,3,2,2,7,Regulars
6702,290,14,3542.55,2,5,5,12,At Risk
6703,99,14,1209.83,4,5,2,11,Loyal
6704,617,4,357.71000000000004,1,1,1,3,Hibernating
6705,90,10,853.9100000000001,4,3,2,9,Loyal
6706,203,14,2861.7999999999997,3,5,5,13,Big Spenders
6707,680,10,1120.3,1,3,2,6,Regulars
6708,597,14,1151.3700000000001,1,5,2,8,At Risk
6709,170,11,3741.19,3,3,5,11,Big Spenders
6710,343,13,1544.17,2,4,3,9,At Risk
6711,81,8,2767.7799999999997,4,2,5,11,Big Spenders
6712,51,13,1188.43,5,4,2,11,Loyal
6713,528,9,625.5,1,2,1,4,Hibernating
6714,0,5,266.07,5,1,1,7,Regulars
6715,47,14,1482.57,5,5,3,13,Loyal
6716,433,10,2611.39,2,3,5,10,Regulars
6717,945,12,1871.13,1,4,4,9,At Risk
6718,37,12,1180.12,5,4,2,11,Loyal
6719,471,8,3101.54,1,2,5,8,Regulars
6720,470,6,884.57,1,1,2,4,Hibernating
6721,479,5,436.58,1,1,1,3,Hibernating
6722,130,11,1095.05,4,3,2,9,Loyal
6723,37,9,801.3499999999999,5,2,1,8,Regulars
6724,280,8,3147.05,2,2,5,9,Regulars
6725,1326,8,2335.21,1,2,4,7,Regulars
6726,43,12,1095.36,5,4,2,11,Loyal
6727,649,5,732.26,1,1,1,3,Hibernating
6728,79,11,1186.0,4,3,2,9,Loyal
6729,241,7,527.7,3,1,1,5,Regulars
6730,257,8,994.89,2,2,2,6,Hibernating
6731,352,7,1256.7,2,1,3,6,Regulars
6732,38,11,3605.2,5,3,5,13,Loyal
6733,89,8,2295.23,4,2,4,10,Big Spenders
6734,322,9,806.5699999999999,2,2,1,5,Hibernating
6735,210,8,666.97,3,2,1,6,Regulars
6736,433,6,5404.6900000000005,2,1,5,8,Regulars
6737,77,10,887.3199999999999,4,3,2,9,Loyal
6738,284,7,2665.02,2,1,5,8,Regulars
6739,91,9,736.21,4,2,1,7,Regulars
6740,56,12,2163.01,5,4,4,13,Champions
6741,21,8,611.21,5,2,1,8,Regulars
6742,666,6,1295.95,1,1,3,5,Regulars
6743,332,7,1561.27,2,1,3,6,Regulars
6744,640,9,1111.14,1,2,2,5,Hibernating
6745,178,7,2022.88,3,1,4,8,Big Spenders
6746,104,9,2349.4300000000003,4,2,4,10,Big Spenders
6747,146,15,2079.6,4,5,4,13,Champions
6748,699,11,1411.77,1,3,3,7,Regulars
6749,284,8,1144.3700000000001,2,2,2,6,Hibernating
6750,416,7,754.91,2,1,1,4,Hibernating
6751,379,9,2758.6500000000005,2,2,5,9,Regulars
6752,570,7,1377.78,1,1,3,5,Regulars
6753,66,4,370.52,4,1,1,6,Regulars
6754,49,8,1373.3200000000002,5,2,3,10,Regulars
6755,1,9,1125.3700000000001,5,2,2,9,Regulars
6756,162,9,3251.8900000000003,3,2,5,10,Big Spenders
6757,48,7,260.53,5,1,1,7,Regulars
6758,61,9,780.63,5,2,1,8,Regulars
6759,610,12,2352.53,1,4,4,9,At Risk
6760,70,16,3398.63,4,5,5,14,Champions
6761,96,10,2072.3700000000003,4,3,4,11,Loyal
6762,272,15,2757.15,2,5,5,12,At Risk
6763,305,10,1733.26,2,3,4,9,Regulars
6764,31,14,5491.889999999999,5,5,5,15,Champions
6765,129,12,1185.25,4,4,2,10,Loyal
6766,917,6,871.54,1,1,2,4,Hibernating
6767,133,9,1279.32,4,2,3,9,Regulars
6768,744,6,456.33,1,1,1,3,Hibernating
6769,9,8,770.14,5,2,1,8,Regulars
6770,6,14,1540.42,5,5,3,13,Loyal
6771,385,16,3035.1000000000004,2,5,5,12,At Risk
6772,104,16,5885.780000000001,4,5,5,14,Champions
6773,463,11,1991.72,1,3,4,8,Regulars
6774,69,10,2848.3699999999994,4,3,5,12,Loyal
6775,149,12,2259.16,3,4,4,11,Big Spenders
6776,2,9,1613.28,5,2,3,10,Regulars
6777,60,14,1662.2,5,5,3,13,Loyal
6778,78,10,1031.71,4,3,2,9,Loyal
6779,105,9,1094.25,4,2,2,8,Regulars
6780,196,11,2992.68,3,3,5,11,Big Spenders
6781,588,9,5105.46,1,2,5,8,Regulars
6782,59,10,813.38,5,3,1,9,Loyal
6783,352,8,1138.47,2,2,2,6,Hibernating
6784,151,9,1093.91,3,2,2,7,Regulars
6785,56,17,2430.93,5,5,4,14,Champions
6786,295,9,971.77,2,2,2,6,Hibernating
6787,383,9,1166.44,2,2,2,6,Hibernating
6788,38,10,1988.4,5,3,4,12,Loyal
6789,1157,9,2306.7000000000003,1,2,4,7,Regulars
6790,449,12,3694.8,2,4,5,11,At Risk
6791,21,13,2724.09,5,4,5,14,Champions
6792,108,8,1101.39,4,2,2,8,Regulars
6793,815,15,1848.81,1,5,4,10,At Risk
6794,193,6,580.66,3,1,1,5,Regulars
6795,61,8,791.1800000000001,5,2,1,8,Regulars
6796,555,11,1789.6000000000001,1,3,4,8,Regulars
6797,791,8,1870.62,1,2,4,7,Regulars
6798,28,11,2215.97,5,3,4,12,Loyal
6799,107,14,1480.69,4,5,3,12,Loyal
6800,310,10,1058.68,2,3,2,7,Regulars
6801,23,10,2945.77,5,3,5,13,Loyal
6802,238,8,956.9399999999999,3,2,2,7,Regulars
6803,277,12,2160.38,2,4,4,10,At Risk
6804,54,13,1640.8,5,4,3,12,Loyal
6805,198,12,1917.45,3,4,4,11,Big Spenders
6806,251,7,487.68,2,1,1,4,Hibernating
6807,42,7,961.97,5,1,2,8,Regulars
6808,768,9,962.23,1,2,2,5,Hibernating
6809,755,10,1556.43,1,3,3,7,Regulars
6810,50,7,1318.21,5,1,3,9,Regulars
6811,280,8,1078.96,2,2,2,6,Hibernating
6812,109,8,1180.1599999999999,4,2,2,8,Regulars
6813,182,10,2686.23,3,3,5,11,Big Spenders
6814,28,6,1292.16,5,1,3,9,Regulars
6815,37,12,2182.96,5,4,4,13,Champions
6816,114,10,1885.22,4,3,4,11,Loyal
6817,822,10,789.27,1,3,1,5,Regulars
6818,104,12,1694.32,4,4,3,11,Loyal
6819,489,7,3545.24,1,1,5,7,Regulars
6820,532,6,989.1800000000001,1,1,2,4,Hibernating
6821,884,7,1041.64,1,1,2,4,Hibernating
6822,174,6,475.01,3,1,1,5,Regulars
6823,161,8,1653.17,3,2,3,8,Regulars
6824,348,20,3982.1600000000003,2,5,5,12,At Risk
6825,95,10,970.74,4,3,2,9,Loyal
6826,63,14,3915.2599999999998,5,5,5,15,Champions
6827,545,12,1440.19,1,4,3,8,At Risk
6828,50,10,1293.2,5,3,3,11,Loyal
6829,111,9,1495.9599999999998,4,2,3,9,Regulars
6830,374,7,1459.4499999999998,2,1,3,6,Regulars
6831,307,15,1549.45,2,5,3,10,At Risk
6832,143,11,707.44,4,3,1,8,Loyal
6833,655,10,1021.97,1,3,2,6,Regulars
6834,253,13,915.51,2,4,2,8,At Risk
6835,66,15,3390.5299999999997,4,5,5,14,Champions
6836,78,11,1399.79,4,3,3,10,Loyal
6837,71,16,2116.55,4,5,4,13,Champions
6838,221,9,2697.41,3,2,5,10,Big Spenders
6839,785,7,1360.25,1,1,3,5,Regulars
6840,367,11,2569.5,2,3,4,9,Regulars
6841,104,10,2657.5,4,3,5,12,Loyal
6842,88,16,2397.44,4,5,4,13,Champions
6843,215,11,3374.3100000000004,3,3,5,11,Big Spenders
6844,85,8,714.2,4,2,1,7,Regulars
6845,251,14,2207.51,2,5,4,11,At Risk
6846,721,10,1729.3400000000001,1,3,4,8,Regulars
6847,175,5,564.07,3,1,1,5,Regulars
6848,61,11,929.78,5,3,2,10,Loyal
6849,919,12,1679.13,1,4,3,8,At Risk
6850,186,7,692.5899999999999,3,1,1,5,Regulars
6851,149,16,2396.19,3,5,4,12,Big Spenders
6852,199,15,2125.42,3,5,4,12,Big Spenders
6853,36,11,1109.33,5,3,2,10,Loyal
6854,350,12,1405.49,2,4,3,9,At Risk
6855,343,11,1321.72,2,3,3,8,Regulars
6856,93,10,958.1,4,3,2,9,Loyal
6857,607,10,660.52,1,3,1,5,Regulars
6858,257,13,2613.7200000000003,2,4,5,11,At Risk
6859,528,7,469.70000000000005,1,1,1,3,Hibernating
6860,107,15,3192.54,4,5,5,14,Champions
6861,91,19,3983.95,4,5,5,14,Champions
6862,295,12,2445.01,2,4,4,10,At Risk
6863,159,12,3082.25,3,4,5,12,Big Spenders
6864,148,9,710.29,3,2,1,6,Regulars
6865,46,12,812.3000000000001,5,4,1,10,Loyal
6866,118,9,2693.75,4,2,5,11,Big Spenders
6867,321,9,1348.06,2,2,3,7,Regulars
6868,211,11,1645.96,3,3,3,9,Regulars
6869,5,8,1209.23,5,2,2,9,Regulars
6870,1233,4,294.29,1,1,1,3,Hibernating
6871,43,15,2323.23,5,5,4,14,Champions
6872,99,12,2763.85,4,4,5,13,Champions
6873,439,7,727.51,2,1,1,4,Hibernating
6874,121,10,1268.48,4,3,3,10,Loyal
6875,46,15,3547.4700000000003,5,5,5,15,Champions
6876,655,8,1452.07,1,2,3,6,Regulars
6877,9,7,555.64,5,1,1,7,Regulars
6878,225,9,5056.070000000001,3,2,5,10,Big Spenders
6879,84,14,1232.69,4,5,2,11,Loyal
6880,312,11,1185.43,2,3,2,7,Regulars
6881,448,9,1656.74,2,2,3,7,Regulars
6882,7,11,1816.06,5,3,4,12,Loyal
6883,107,7,1258.15,4,1,3,8,Regulars
6884,200,9,264.21000000000004,3,2,1,6,Regulars
6885,529,9,1350.79,1,2,3,6,Regulars
6886,144,12,2441.33,4,4,4,12,Champions
6887,69,7,536.76,4,1,1,6,Regulars
6888,505,10,3807.33,1,3,5,9,Regulars
6889,99,10,749.52,4,3,1,8,Loyal
6890,160,9,902.78,3,2,2,7,Regulars
6891,30,14,1968.1100000000001,5,5,4,14,Champions
6892,227,13,2483.36,3,4,4,11,Big Spenders
6893,242,16,1784.6,3,5,4,12,Big Spenders
6894,119,9,1399.73,4,2,3,9,Regulars
6895,172,11,932.14,3,3,2,8,Regulars
6896,385,10,2456.3799999999997,2,3,4,9,Regulars
6897,474,6,1447.4600000000003,1,1,3,5,Regulars
6898,182,8,1926.75,3,2,4,9,Big Spenders
6899,3,17,5087.88,5,5,5,15,Champions
6900,414,7,250.08999999999997,2,1,1,4,Hibernating
6901,208,12,1283.38,3,4,3,10,Regulars
6902,86,15,3657.56,4,5,5,14,Champions
6903,789,9,908.3199999999999,1,2,2,5,Hibernating
6904,298,16,2181.44,2,5,4,11,At Risk
6905,780,8,2250.11,1,2,4,7,Regulars
6906,852,5,543.1099999999999,1,1,1,3,Hibernating
6907,427,11,3470.15,2,3,5,10,Regulars
6908,769,7,965.0400000000001,1,1,2,4,Hibernating
6909,165,9,1120.82,3,2,2,7,Regulars
6910,165,11,1163.79,3,3,2,8,Regulars
6911,678,6,1193.48,1,1,2,4,Hibernating
6912,108,6,1377.6,4,1,3,8,Regulars
6913,68,9,3043.93,4,2,5,11,Big Spenders
6914,109,5,1457.7,4,1,3,8,Regulars
6915,390,9,1249.27,2,2,3,7,Regulars
6916,357,12,2646.1099999999997,2,4,5,11,At Risk
6917,191,12,1456.03,3,4,3,10,Regulars
6918,48,12,3337.66,5,4,5,14,Champions
6919,85,16,5574.1900000000005,4,5,5,14,Champions
6920,227,14,2608.67,3,5,5,13,Big Spenders
6921,136,13,4656.73,4,4,5,13,Champions
6922,52,12,3000.93,5,4,5,14,Champions
6923,37,11,1118.77,5,3,2,10,Loyal
6924,4,13,1219.3600000000001,5,4,2,11,Loyal
6925,97,10,1767.66,4,3,4,11,Loyal
6926,478,12,3881.39,1,4,5,10,At Risk
6927,151,5,979.9200000000001,3,1,2,6,Regulars
6928,129,8,683.0600000000001,4,2,1,7,Regulars
6929,3,6,1458.23,5,1,3,9,Regulars
6930,317,10,1070.3600000000001,2,3,2,7,Regulars
6931,163,12,3737.31,3,4,5,12,Big Spenders
6932,54,12,2944.7000000000003,5,4,5,14,Champions
6933,67,14,1529.77,4,5,3,12,Loyal
6934,274,12,1106.06,2,4,2,8,At Risk
6935,8,10,1371.01,5,3,3,11,Loyal
6936,600,7,1249.4,1,1,3,5,Regulars
6937,475,7,1011.56,1,1,2,4,Hibernating
6938,232,13,2514.5299999999997,3,4,4,11,Big Spenders
6939,53,8,2058.85,5,2,4,11,Big Spenders
6940,129,10,3299.7000000000003,4,3,5,12,Loyal
6941,446,10,1027.48,2,3,2,7,Regulars
6942,662,10,1880.6200000000001,1,3,4,8,Regulars
6943,378,14,1087.45,2,5,2,9,At Risk
6944,64,13,1403.73,5,4,3,12,Loyal
6945,0,15,2837.4799999999996,5,5,5,15,Champions
6946,66,8,682.31,4,2,1,7,Regulars
6947,502,15,2794.67,1,5,5,11,At Risk
6948,78,9,2189.92,4,2,4,10,Big Spenders
6949,933,7,2669.32,1,1,5,7,Regulars
6950,193,7,582.19,3,1,1,5,Regulars
6951,142,14,2934.0,4,5,5,14,Champions
6952,46,8,1117.65,5,2,2,9,Regulars
6953,102,9,1834.6399999999999,4,2,4,10,Big Spenders
6954,114,9,1505.14,4,2,3,9,Regulars
6955,134,11,3466.92,4,3,5,12,Loyal
6956,448,9,833.72,2,2,1,5,Hibernating
6957,0,12,1865.67,5,4,4,13,Champions
6958,40,10,1079.9299999999998,5,3,2,10,Loyal
6959,24,14,1462.19,5,5,3,13,Loyal
6960,283,9,824.63,2,2,1,5,Hibernating
6961,156,10,906.54,3,3,2,8,Regulars
6962,208,9,2003.4199999999998,3,2,4,9,Big Spenders
6963,167,6,636.17,3,1,1,5,Regulars
6964,999,3,265.87,1,1,1,3,Hibernating
6965,330,7,1674.18,2,1,3,6,Regulars
6966,93,12,1402.27,4,4,3,11,Loyal
6967,56,9,645.6200000000001,5,2,1,8,Regulars
6968,40,8,1408.63,5,2,3,10,Regulars
6969,370,6,3138.29,2,1,5,8,Regulars
6970,46,10,1060.45,5,3,2,10,Loyal
6971,11,16,2460.64,5,5,4,14,Champions
6972,211,13,1485.0800000000002,3,4,3,10,Regulars
6973,110,13,4201.17,4,4,5,13,Champions
6974,118,6,559.56,4,1,1,6,Regulars
6975,121,11,1963.29,4,3,4,11,Loyal
6976,60,12,3569.62,5,4,5,14,Champions
6977,20,9,2931.88,5,2,5,12,Big Spenders
6978,72,18,3103.24,4,5,5,14,Champions
6979,166,11,1020.99,3,3,2,8,Regulars
6980,141,14,5197.9,4,5,5,14,Champions
6981,25,14,2497.39,5,5,4,14,Champions
6982,286,12,2023.88,2,4,4,10,At Risk
6983,158,8,1299.99,3,2,3,8,Regulars
6984,9,10,2641.48,5,3,5,13,Loyal
6985,135,13,2291.56,4,4,4,12,Champions
6986,150,7,1245.49,3,1,3,7,Regulars
6987,234,9,957.79,3,2,2,7,Regulars
6988,72,9,3063.31,4,2,5,11,Big Spenders
6989,240,7,3109.2799999999997,3,1,5,9,Big Spenders
6990,536,12,646.9,1,4,1,6,At Risk
6991,89,19,4383.84,4,5,5,14,Champions
6992,160,8,1399.6000000000001,3,2,3,8,Regulars
6993,194,16,1399.37,3,5,3,11,Regulars
6994,70,18,5131.3,4,5,5,14,Champions
6995,206,7,727.43,3,1,1,5,Regulars
6996,185,16,2054.94,3,5,4,12,Big Spenders
6997,349,14,1346.66,2,5,3,10,At Risk
6998,489,12,1616.0600000000002,1,4,3,8,At Risk
6999,50,13,1606.45,5,4,3,12,Loyal
7000,138,14,2334.74,4,5,4,13,Champions
7001,323,15,3532.99,2,5,5,12,At Risk
7002,663,10,2789.48,1,3,5,9,Regulars
7003,174,11,1391.32,3,3,3,9,Regulars
7004,163,16,2574.15,3,5,5,13,Big Spenders
7005,187,17,1828.98,3,5,4,12,Big Spenders
7006,1350,5,1700.2800000000002,1,1,3,5,Regulars
7007,314,9,1730.2400000000002,2,2,4,8,Regulars
7008,588,11,1022.9399999999999,1,3,2,6,Regulars
7009,155,8,1656.0900000000001,3,2,3,8,Regulars
7010,132,13,4215.75,4,4,5,13,Champions
7011,52,8,474.8,5,2,1,8,Regulars
7012,337,11,1425.21,2,3,3,8,Regulars
7013,110,12,1461.55,4,4,3,11,Loyal
7014,599,9,1321.94,1,2,3,6,Regulars
7015,162,8,2093.0,3,2,4,9,Big Spenders
7016,16,12,2758.83,5,4,5,14,Champions
7017,124,21,5314.67,4,5,5,14,Champions
7018,64,10,4714.14,5,3,5,13,Loyal
7019,36,7,1068.2,5,1,2,8,Regulars
7020,164,13,1611.24,3,4,3,10,Regulars
7021,173,9,1509.1200000000001,3,2,3,8,Regulars
7022,496,10,591.72,1,3,1,5,Regulars
7023,252,10,1301.22,2,3,3,8,Regulars
7024,30,13,1927.42,5,4,4,13,Champions
7025,40,10,1161.33,5,3,2,10,Loyal
7026,304,11,4866.71,2,3,5,10,Regulars
7027,690,11,662.33,1,3,1,5,Regulars
7028,31,11,1842.6,5,3,4,12,Loyal
7029,75,6,516.2,4,1,1,6,Regulars
7030,3,7,868.93,5,1,2,8,Regulars
7031,30,9,1956.27,5,2,4,11,Big Spenders
7032,82,11,1907.54,4,3,4,11,Loyal
7033,177,10,1578.5099999999998,3,3,3,9,Regulars
7034,352,10,777.11,2,3,1,6,Regulars
7035,237,12,1753.3799999999999,3,4,4,11,Big Spenders
7036,3,12,1225.21,5,4,2,11,Loyal
7037,983,7,1410.7800000000002,1,1,3,5,Regulars
7038,1001,10,2277.32,1,3,4,8,Regulars
7039,139,10,1983.14,4,3,4,11,Loyal
7040,403,9,1323.47,2,2,3,7,Regulars
7041,306,10,668.81,2,3,1,6,Regulars
7042,219,17,2266.07,3,5,4,12,Big Spenders
7043,282,13,2730.68,2,4,5,11,At Risk
7044,160,6,556.54,3,1,1,5,Regulars
7045,195,11,1558.42,3,3,3,9,Regulars
7046,587,9,1199.1599999999999,1,2,2,5,Hibernating
7047,242,6,3540.94,3,1,5,9,Big Spenders
7048,450,10,3247.35,2,3,5,10,Regulars
7049,514,8,1224.24,1,2,2,5,Hibernating
7050,75,17,4268.45,4,5,5,14,Champions
7051,320,12,1253.0,2,4,3,9,At Risk
7052,79,10,1561.28,4,3,3,10,Loyal
7053,461,7,940.38,1,1,2,4,Hibernating
7054,126,7,2053.7799999999997,4,1,4,9,Big Spenders
7055,1761,6,944.6,1,1,2,4,Hibernating
7056,920,8,1378.29,1,2,3,6,Regulars
7057,701,11,977.64,1,3,2,6,Regulars
7058,40,17,4167.39,5,5,5,15,Champions
7059,189,11,1463.81,3,3,3,9,Regulars
7060,39,11,985.2700000000001,5,3,2,10,Loyal
7061,237,11,1086.66,3,3,2,8,Regulars
7062,33,6,559.66,5,1,1,7,Regulars
7063,553,7,711.08,1,1,1,3,Hibernating
7064,302,9,1430.94,2,2,3,7,Regulars
7065,176,9,3113.6600000000003,3,2,5,10,Big Spenders
7066,293,12,1590.92,2,4,3,9,At Risk
7067,466,7,675.29,1,1,1,3,Hibernating
7068,322,11,1290.21,2,3,3,8,Regulars
7069,622,12,3093.41,1,4,5,10,At Risk
7070,250,14,2413.2000000000003,2,5,4,11,At Risk
7071,424,13,2394.0699999999997,2,4,4,10,At Risk
7072,221,13,2877.7,3,4,5,12,Big Spenders
7073,194,7,1267.2499999999998,3,1,3,7,Regulars
7074,987,7,1375.55,1,1,3,5,Regulars
7075,210,8,2566.55,3,2,4,9,Big Spenders
7076,13,11,1524.18,5,3,3,11,Loyal
7077,106,11,4829.9,4,3,5,12,Loyal
7078,284,12,1487.26,2,4,3,9,At Risk
7079,318,11,929.86,2,3,2,7,Regulars
7080,437,5,653.0999999999999,2,1,1,4,Hibernating
7081,117,9,881.31,4,2,2,8,Regulars
7082,62,13,2374.4199999999996,5,4,4,13,Champions
7083,250,13,3198.47,2,4,5,11,At Risk
7084,13,8,1068.06,5,2,2,9,Regulars
7085,438,14,3377.74,2,5,5,12,At Risk
7086,126,11,2497.3199999999997,4,3,4,11,Loyal
7087,232,8,1465.6999999999998,3,2,3,8,Regulars
7088,160,11,1355.7500000000002,3,3,3,9,Regulars
7089,436,17,6082.14,2,5,5,12,At Risk
7090,176,9,1336.32,3,2,3,8,Regulars
7091,290,5,410.65000000000003,2,1,1,4,Hibernating
7092,284,12,1060.1299999999999,2,4,2,8,At Risk
7093,5,14,1255.26,5,5,3,13,Loyal
7094,411,5,456.66999999999996,2,1,1,4,Hibernating
7095,526,4,623.09,1,1,1,3,Hibernating
7096,247,11,1309.6100000000001,3,3,3,9,Regulars
7097,99,13,1423.02,4,4,3,11,Loyal
7098,53,11,825.79,5,3,1,9,Loyal
7099,45,12,2388.87,5,4,4,13,Champions
7100,11,15,1530.67,5,5,3,13,Loyal
7101,122,12,1080.3899999999999,4,4,2,10,Loyal
7102,327,11,944.5,2,3,2,7,Regulars
7103,379,11,2243.85,2,3,4,9,Regulars
7104,72,11,1455.2700000000002,4,3,3,10,Loyal
7105,451,6,491.79,2,1,1,4,Hibernating
7106,230,10,3414.7400000000002,3,3,5,11,Big Spenders
7107,46,9,2748.52,5,2,5,12,Big Spenders
7108,322,15,1341.94,2,5,3,10,At Risk
7109,420,12,1995.1599999999999,2,4,4,10,At Risk
7110,79,8,754.81,4,2,1,7,Regulars
7111,63,16,1367.62,5,5,3,13,Loyal
7112,201,19,2721.77,3,5,5,13,Big Spenders
7113,111,9,1278.82,4,2,3,9,Regulars
7114,840,11,2116.0699999999997,1,3,4,8,Regulars
7115,169,8,439.55,3,2,1,6,Regulars
7116,377,8,608.8,2,2,1,5,Hibernating
7117,99,14,1503.04,4,5,3,12,Loyal
7118,379,9,615.61,2,2,1,5,Hibernating
7119,811,9,583.2,1,2,1,4,Hibernating
7120,408,6,979.91,2,1,2,5,Hibernating
7121,1695,5,743.5899999999999,1,1,1,3,Hibernating
7122,220,9,543.26,3,2,1,6,Regulars
7123,328,5,728.0899999999999,2,1,1,4,Hibernating
7124,23,14,2460.05,5,5,4,14,Champions
7125,57,9,1128.84,5,2,2,9,Regulars
7126,169,10,1977.27,3,3,4,10,Big Spenders
7127,123,17,1821.56,4,5,4,13,Champions
7128,176,13,1492.72,3,4,3,10,Regulars
7129,559,6,614.96,1,1,1,3,Hibernating
7130,229,11,1492.08,3,3,3,9,Regulars
7131,21,11,698.75,5,3,1,9,Loyal
7132,852,4,554.04,1,1,1,3,Hibernating
7133,178,8,1220.65,3,2,2,7,Regulars
7134,669,9,5400.360000000001,1,2,5,8,Regulars
7135,159,8,970.5999999999999,3,2,2,7,Regulars
7136,125,11,891.68,4,3,2,9,Loyal
7137,261,8,1106.91,2,2,2,6,Hibernating
7138,175,8,888.04,3,2,2,7,Regulars
7139,453,8,1351.25,2,2,3,7,Regulars
7140,237,9,868.37,3,2,2,7,Regulars
7141,129,12,1542.0,4,4,3,11,Loyal
7142,363,10,1512.87,2,3,3,8,Regulars
7143,155,9,1020.22,3,2,2,7,Regulars
7144,244,8,561.91,3,2,1,6,Regulars
7145,579,7,1455.7,1,1,3,5,Regulars
7146,101,12,2895.6800000000003,4,4,5,13,Champions
7147,8,16,2401.84,5,5,4,14,Champions
7148,295,7,2350.76,2,1,4,7,Regulars
7149,438,12,6536.859999999999,2,4,5,11,At Risk
7150,540,8,941.0699999999999,1,2,2,5,Hibernating
7151,6,10,737.0400000000001,5,3,1,9,Loyal
7152,184,8,3292.2999999999997,3,2,5,10,Big Spenders
7153,261,15,4558.4,2,5,5,12,At Risk
7154,182,7,1572.9099999999999,3,1,3,7,Regulars
7155,228,12,1354.24,3,4,3,10,Regulars
7156,31,10,1014.97,5,3,2,10,Loyal
7157,369,13,1287.3,2,4,3,9,At Risk
7158,85,11,4433.61,4,3,5,12,Loyal
7159,44,14,3524.92,5,5,5,15,Champions
7160,334,10,544.7,2,3,1,6,Regulars
7161,57,11,1361.27,5,3,3,11,Loyal
7162,441,11,1872.45,2,3,4,9,Regulars
7163,1335,5,376.57,1,1,1,3,Hibernating
7164,2151,2,51.730000000000025,1,1,1,3,Hibernating
7165,77,12,3372.42,4,4,5,13,Champions
7166,188,9,943.01,3,2,2,7,Regulars
7167,198,11,2296.98,3,3,4,10,Big Spenders
7168,62,10,1629.8000000000002,5,3,3,11,Loyal
7169,160,7,1160.14,3,1,2,6,Regulars
7170,254,6,390.75,2,1,1,4,Hibernating
7171,21,9,1289.29,5,2,3,10,Regulars
7172,177,12,1810.65,3,4,4,11,Big Spenders
7173,125,10,2566.23,4,3,4,11,Loyal
7174,130,11,667.02,4,3,1,8,Loyal
7175,349,10,987.75,2,3,2,7,Regulars
7176,942,8,1036.97,1,2,2,5,Hibernating
7177,281,17,4838.14,2,5,5,12,At Risk
7178,698,8,1580.05,1,2,3,6,Regulars
7179,1191,7,1013.05,1,1,2,4,Hibernating
7180,148,9,469.58,3,2,1,6,Regulars
7181,522,11,2299.91,1,3,4,8,Regulars
7182,483,15,2357.19,1,5,4,10,At Risk
7183,78,6,926.54,4,1,2,7,Regulars
7184,21,10,504.05,5,3,1,9,Loyal
7185,16,12,1944.2900000000002,5,4,4,13,Champions
7186,349,6,640.3499999999999,2,1,1,4,Hibernating
7187,424,7,670.79,2,1,1,4,Hibernating
7188,97,12,1164.12,4,4,2,10,Loyal
7189,15,13,2056.4,5,4,4,13,Champions
7190,147,5,441.13,4,1,1,6,Regulars
7191,448,10,885.16,2,3,2,7,Regulars
7192,16,10,2483.08,5,3,4,12,Loyal
7193,57,12,1113.65,5,4,2,11,Loyal
7194,393,15,2395.58,2,5,4,11,At Risk
7195,181,9,781.1899999999999,3,2,1,6,Regulars
7196,337,9,750.6199999999999,2,2,1,5,Hibernating
7197,225,7,1404.47,3,1,3,7,Regulars
7198,23,16,1235.3999999999999,5,5,2,12,Loyal
7199,211,10,2403.14,3,3,4,10,Big Spenders
7200,541,12,2387.58,1,4,4,9,At Risk
7201,132,9,2539.91,4,2,4,10,Big Spenders
7202,210,6,1762.74,3,1,4,8,Big Spenders
7203,141,10,1001.49,4,3,2,9,Loyal
7204,48,10,1498.5500000000002,5,3,3,11,Loyal
7205,515,9,1071.41,1,2,2,5,Hibernating
7206,1037,14,1665.61,1,5,3,9,At Risk
7207,189,5,2134.32,3,1,4,8,Big Spenders
7208,38,12,1631.1699999999998,5,4,3,12,Loyal
7209,99,9,1637.9199999999998,4,2,3,9,Regulars
7210,533,11,960.83,1,3,2,6,Regulars
7211,466,5,581.96,1,1,1,3,Hibernating
7212,102,19,2792.65,4,5,5,14,Champions
7213,240,9,1082.2,3,2,2,7,Regulars
7214,41,15,3906.1900000000005,5,5,5,15,Champions
7215,256,6,599.23,2,1,1,4,Hibernating
7216,352,15,3736.01,2,5,5,12,At Risk
7217,224,10,2268.1699999999996,3,3,4,10,Big Spenders
7218,162,13,1031.04,3,4,2,9,Regulars
7219,218,14,2228.79,3,5,4,12,Big Spenders
7220,561,8,980.63,1,2,2,5,Hibernating
7221,127,8,1034.8400000000001,4,2,2,8,Regulars
7222,868,5,356.28,1,1,1,3,Hibernating
7223,12,16,2339.52,5,5,4,14,Champions
7224,641,5,2101.13,1,1,4,6,Regulars
7225,723,7,946.32,1,1,2,4,Hibernating
7226,148,6,1040.7800000000002,3,1,2,6,Regulars
7227,371,11,991.76,2,3,2,7,Regulars
7228,376,9,2177.9300000000003,2,2,4,8,Regulars
7229,342,8,1854.72,2,2,4,8,Regulars
7230,160,10,958.4,3,3,2,8,Regulars
7231,145,10,1829.41,4,3,4,11,Loyal
7232,121,9,2300.39,4,2,4,10,Big Spenders
7233,219,12,2149.23,3,4,4,11,Big Spenders
7234,219,9,1208.81,3,2,2,7,Regulars
7235,774,8,571.72,1,2,1,4,Hibernating
7236,947,6,316.35,1,1,1,3,Hibernating
7237,143,11,729.3,4,3,1,8,Loyal
7238,29,15,1862.12,5,5,4,14,Champions
7239,226,5,3259.17,3,1,5,9,Big Spenders
7240,111,11,3823.84,4,3,5,12,Loyal
7241,91,19,5909.84,4,5,5,14,Champions
7242,50,9,463.96,5,2,1,8,Regulars
7243,301,12,2063.2599999999998,2,4,4,10,At Risk
7244,128,6,826.69,4,1,1,6,Regulars
7245,553,13,2178.82,1,4,4,9,At Risk
7246,326,9,650.2199999999999,2,2,1,5,Hibernating
7247,196,13,1223.3200000000002,3,4,2,9,Regulars
7248,625,9,1284.87,1,2,3,6,Regulars
7249,59,8,2146.1400000000003,5,2,4,11,Big Spenders
7250,126,10,2427.8,4,3,4,11,Loyal
7251,37,10,2641.68,5,3,5,13,Loyal
7252,67,13,2568.82,4,4,4,12,Champions
7253,92,10,1009.26,4,3,2,9,Loyal
7254,116,16,2866.2599999999998,4,5,5,14,Champions
7255,780,4,187.55,1,1,1,3,Hibernating
7256,77,15,1218.53,4,5,2,11,Loyal
7257,371,9,686.94,2,2,1,5,Hibernating
7258,34,11,2218.02,5,3,4,12,Loyal
7259,198,10,917.54,3,3,2,8,Regulars
7260,236,8,2385.66,3,2,4,9,Big Spenders
7261,52,8,2463.33,5,2,4,11,Big Spenders
7262,513,7,1195.97,1,1,2,4,Hibernating
7263,125,11,1518.71,4,3,3,10,Loyal
7264,319,12,1022.84,2,4,2,8,At Risk
7265,61,10,3594.3,5,3,5,13,Loyal
7266,553,7,632.74,1,1,1,3,Hibernating
7267,417,12,869.6,2,4,2,8,At Risk
7268,239,8,703.75,3,2,1,6,Regulars
7269,157,9,2609.22,3,2,5,10,Big Spenders
7270,50,5,179.2,5,1,1,7,Regulars
7271,112,12,2192.79,4,4,4,12,Champions
7272,351,6,342.93,2,1,1,4,Hibernating
7273,113,11,1113.69,4,3,2,9,Loyal
7274,266,12,2331.58,2,4,4,10,At Risk
7275,374,10,3833.17,2,3,5,10,Regulars
7276,243,12,1489.29,3,4,3,10,Regulars
7277,152,14,4530.0199999999995,3,5,5,13,Big Spenders
7278,42,5,502.2,5,1,1,7,Regulars
7279,60,10,1109.92,5,3,2,10,Loyal
7280,60,15,2217.16,5,5,4,14,Champions
7281,244,8,676.47,3,2,1,6,Regulars
7282,281,11,1292.47,2,3,3,8,Regulars
7283,215,15,3593.4900000000002,3,5,5,13,Big Spenders
7284,218,6,2162.25,3,1,4,8,Big Spenders
7285,272,8,1266.5500000000002,2,2,3,7,Regulars
7286,47,16,3978.3900000000003,5,5,5,15,Champions
7287,228,11,788.85,3,3,1,7,Regulars
7288,161,10,810.84,3,3,1,7,Regulars
7289,173,11,2373.41,3,3,4,10,Big Spenders
7290,372,9,1277.83,2,2,3,7,Regulars
7291,6,12,950.5,5,4,2,11,Loyal
7292,1085,6,2126.77,1,1,4,6,Regulars
7293,367,13,1227.67,2,4,2,8,At Risk
7294,959,6,524.92,1,1,1,3,Hibernating
7295,242,7,2731.26,3,1,5,9,Big Spenders
7296,15,10,1404.65,5,3,3,11,Loyal
7297,425,9,1528.01,2,2,3,7,Regulars
7298,37,14,1048.2,5,5,2,12,Loyal
7299,521,11,3914.7999999999997,1,3,5,9,Regulars
7300,50,10,1247.39,5,3,3,11,Loyal
7301,653,9,2270.92,1,2,4,7,Regulars
7302,610,14,2738.31,1,5,5,11,At Risk
7303,724,7,2934.7200000000003,1,1,5,7,Regulars
7304,498,10,875.37,1,3,2,6,Regulars
7305,286,10,1282.48,2,3,3,8,Regulars
7306,273,11,2159.97,2,3,4,9,Regulars
7307,257,7,1098.53,2,1,2,5,Hibernating
7308,650,18,2201.75,1,5,4,10,At Risk
7309,268,10,1452.51,2,3,3,8,Regulars
7310,9,11,1795.48,5,3,4,12,Loyal
7311,174,15,5506.06,3,5,5,13,Big Spenders
7312,131,22,2621.1899999999996,4,5,5,14,Champions
7313,172,12,2955.46,3,4,5,12,Big Spenders
7314,245,7,3981.3199999999997,3,1,5,9,Big Spenders
7315,79,14,1231.95,4,5,2,11,Loyal
7316,53,11,2532.29,5,3,4,12,Loyal
7317,127,9,1449.87,4,2,3,9,Regulars
7318,510,9,518.61,1,2,1,4,Hibernating
7319,290,6,394.19,2,1,1,4,Hibernating
7320,114,7,985.91,4,1,2,7,Regulars
7321,261,14,2033.36,2,5,4,11,At Risk
7322,253,12,570.44,2,4,1,7,At Risk
7323,12,13,1077.35,5,4,2,11,Loyal
7324,1011,9,629.57,1,2,1,4,Hibernating
7325,44,12,1197.75,5,4,2,11,Loyal
7326,69,5,707.38,4,1,1,6,Regulars
7327,162,13,879.8499999999999,3,4,2,9,Regulars
7328,212,10,764.9499999999999,3,3,1,7,Regulars
7329,615,8,591.64,1,2,1,4,Hibernating
7330,35,11,1130.99,5,3,2,10,Loyal
7331,521,6,3128.2000000000003,1,1,5,7,Regulars
7332,300,10,1211.02,2,3,2,7,Regulars
7333,262,15,2213.69,2,5,4,11,At Risk
7334,258,5,262.15999999999997,2,1,1,4,Hibernating
7335,127,7,377.03,4,1,1,6,Regulars
7336,307,7,1331.3700000000001,2,1,3,6,Regulars
7337,166,7,528.34,3,1,1,5,Regulars
7338,620,8,2663.23,1,2,5,8,Regulars
7339,939,7,622.76,1,1,1,3,Hibernating
7340,496,13,1265.81,1,4,3,8,At Risk
7341,40,11,1016.1099999999999,5,3,2,10,Loyal
7342,1322,5,165.95000000000002,1,1,1,3,Hibernating
7343,735,8,1276.15,1,2,3,6,Regulars
7344,12,8,986.18,5,2,2,9,Regulars
7345,52,12,2831.04,5,4,5,14,Champions
7346,1,12,1302.92,5,4,3,12,Loyal
7347,1118,4,1023.52,1,1,2,4,Hibernating
7348,279,6,676.8100000000001,2,1,1,4,Hibernating
7349,85,7,936.14,4,1,2,7,Regulars
7350,741,6,1102.49,1,1,2,4,Hibernating
7351,159,10,1261.78,3,3,3,9,Regulars
7352,307,15,4916.969999999999,2,5,5,12,At Risk
7353,974,11,1869.48,1,3,4,8,Regulars
7354,482,12,1585.3700000000001,1,4,3,8,At Risk
7355,387,10,1751.06,2,3,4,9,Regulars
7356,22,5,292.92,5,1,1,7,Regulars
7357,147,15,2586.46,4,5,5,14,Champions
7358,209,22,5134.98,3,5,5,13,Big Spenders
7359,101,10,1401.39,4,3,3,10,Loyal
7360,317,11,1239.81,2,3,2,7,Regulars
7361,545,9,1559.78,1,2,3,6,Regulars
7362,75,10,1080.48,4,3,2,9,Loyal
7363,307,9,980.64,2,2,2,6,Hibernating
7364,418,5,644.37,2,1,1,4,Hibernating
7365,840,8,4325.77,1,2,5,8,Regulars
7366,14,18,3999.1400000000003,5,5,5,15,Champions
7367,378,8,525.76,2,2,1,5,Hibernating
7368,342,7,1557.43,2,1,3,6,Regulars
7369,189,14,1466.67,3,5,3,11,Regulars
7370,411,16,2501.44,2,5,4,11,At Risk
7371,91,11,1629.5,4,3,3,10,Loyal
7372,21,12,1198.18,5,4,2,11,Loyal
7373,323,10,2682.39,2,3,5,10,Regulars
7374,884,12,2045.1999999999998,1,4,4,9,At Risk
7375,107,6,539.36,4,1,1,6,Regulars
7376,162,10,2589.33,3,3,5,11,Big Spenders
7377,98,8,1196.1299999999999,4,2,2,8,Regulars
7378,257,7,895.52,2,1,2,5,Hibernating
7379,288,7,1046.81,2,1,2,5,Hibernating
7380,469,9,683.47,1,2,1,4,Hibernating
7381,290,10,2601.09,2,3,5,10,Regulars
7382,468,10,1384.6399999999999,1,3,3,7,Regulars
7383,351,9,1836.65,2,2,4,8,Regulars
7384,127,11,3717.27,4,3,5,12,Loyal
7385,595,14,2064.02,1,5,4,10,At Risk
7386,181,9,1119.85,3,2,2,7,Regulars
7387,134,9,598.01,4,2,1,7,Regulars
7388,505,6,1114.49,1,1,2,4,Hibernating
7389,272,7,510.64000000000004,2,1,1,4,Hibernating
7390,89,11,1198.78,4,3,2,9,Loyal
7391,17,9,974.55,5,2,2,9,Regulars
7392,539,12,1852.06,1,4,4,9,At Risk
7393,748,8,2286.83,1,2,4,7,Regulars
7394,163,6,261.27,3,1,1,5,Regulars
7395,191,12,1304.97,3,4,3,10,Regulars
7396,250,10,2172.1,2,3,4,9,Regulars
7397,449,10,2582.14,2,3,5,10,Regulars
7398,65,13,2885.5299999999997,5,4,5,14,Champions
7399,382,13,3934.84,2,4,5,11,At Risk
7400,1,15,1844.74,5,5,4,14,Champions
7401,73,8,2243.7999999999997,4,2,4,10,Big Spenders
7402,148,9,3429.3199999999997,3,2,5,10,Big Spenders
7403,378,12,1367.5,2,4,3,9,At Risk
7404,93,11,2041.48,4,3,4,11,Loyal
7405,533,10,458.89,1,3,1,5,Regulars
7406,605,10,1250.8700000000001,1,3,3,7,Regulars
7407,93,6,800.59,4,1,1,6,Regulars
7408,444,8,1153.97,2,2,2,6,Hibernating
7409,43,13,1046.23,5,4,2,11,Loyal
7410,573,11,656.01,1,3,1,5,Regulars
7411,51,5,997.88,5,1,2,8,Regulars
7412,245,15,2154.33,3,5,4,12,Big Spenders
7413,94,9,1756.35,4,2,4,10,Big Spenders
7414,174,9,1031.78,3,2,2,7,Regulars
7415,239,11,1061.2,3,3,2,8,Regulars
7416,193,13,2200.12,3,4,4,11,Big Spenders
7417,567,13,2422.99,1,4,4,9,At Risk
7418,101,7,647.61,4,1,1,6,Regulars
7419,6,9,1208.06,5,2,2,9,Regulars
7420,208,12,1031.71,3,4,2,9,Regulars
7421,52,9,2105.46,5,2,4,11,Big Spenders
7422,589,11,1519.76,1,3,3,7,Regulars
7423,697,5,383.8,1,1,1,3,Hibernating
7424,460,4,1903.0299999999997,1,1,4,6,Regulars
7425,71,7,3170.88,4,1,5,10,Big Spenders
7426,17,16,2811.58,5,5,5,15,Champions
7427,635,8,1209.08,1,2,2,5,Hibernating
7428,136,7,691.8999999999999,4,1,1,6,Regulars
7429,0,15,1131.14,5,5,2,12,Loyal
7430,335,8,1166.48,2,2,2,6,Hibernating
7431,267,6,640.9,2,1,1,4,Hibernating
7432,30,11,2433.47,5,3,4,12,Loyal
7433,55,9,1111.22,5,2,2,9,Regulars
7434,31,7,393.49,5,1,1,7,Regulars
7435,99,10,905.55,4,3,2,9,Loyal
7436,227,10,1192.66,3,3,2,8,Regulars
7437,467,11,1818.9499999999998,1,3,4,8,Regulars
7438,98,11,3054.68,4,3,5,12,Loyal
7439,108,10,795.17,4,3,1,8,Loyal
7440,419,9,855.4200000000001,2,2,2,6,Hibernating
7441,201,9,1514.31,3,2,3,8,Regulars
7442,623,8,1489.08,1,2,3,6,Regulars
7443,115,11,3659.81,4,3,5,12,Loyal
7444,515,8,2813.95,1,2,5,8,Regulars
7445,226,14,1911.72,3,5,4,12,Big Spenders
7446,93,7,1245.1299999999999,4,1,3,8,Regulars
7447,389,12,788.72,2,4,1,7,At Risk
7448,761,10,1394.49,1,3,3,7,Regulars
7449,77,13,1784.62,4,4,4,12,Champions
7450,114,11,1429.65,4,3,3,10,Loyal
7451,296,8,679.12,2,2,1,5,Hibernating
7452,284,13,4224.99,2,4,5,11,At Risk
7453,111,11,1688.2799999999997,4,3,3,10,Loyal
7454,506,8,618.31,1,2,1,4,Hibernating
7455,809,6,1155.86,1,1,2,4,Hibernating
7456,151,3,685.3900000000001,3,1,1,5,Regulars
7457,75,11,1595.03,4,3,3,10,Loyal
7458,288,17,2596.05,2,5,5,12,At Risk
7459,822,15,2014.46,1,5,4,10,At Risk
7460,14,6,1295.9499999999998,5,1,3,9,Regulars
7461,682,9,1461.8300000000002,1,2,3,6,Regulars
7462,180,15,4234.88,3,5,5,13,Big Spenders
7463,702,8,1858.88,1,2,4,7,Regulars
7464,60,15,3008.42,5,5,5,15,Champions
7465,125,16,2382.22,4,5,4,13,Champions
7466,13,10,1422.51,5,3,3,11,Loyal
7467,1095,6,491.19,1,1,1,3,Hibernating
7468,164,8,3702.8599999999997,3,2,5,10,Big Spenders
7469,47,13,1220.87,5,4,2,11,Loyal
7470,103,6,747.47,4,1,1,6,Regulars
7471,496,10,2580.51,1,3,5,9,Regulars
7472,56,12,2016.21,5,4,4,13,Champions
7473,563,12,1259.3200000000002,1,4,3,8,At Risk
7474,495,5,998.01,1,1,2,4,Hibernating
7475,1074,4,1331.78,1,1,3,5,Regulars
7476,361,10,3066.3,2,3,5,10,Regulars
7477,536,14,1505.6399999999999,1,5,3,9,At Risk
7478,188,9,1065.9,3,2,2,7,Regulars
7479,140,11,807.9,4,3,1,8,Loyal
7480,94,16,2637.17,4,5,5,14,Champions
7481,389,12,2792.5299999999997,2,4,5,11,At Risk
7482,56,15,3887.02,5,5,5,15,Champions
7483,201,4,365.88,3,1,1,5,Regulars
7484,167,7,2008.9599999999998,3,1,4,8,Big Spenders
7485,186,6,1252.63,3,1,3,7,Regulars
7486,603,9,3561.6899999999996,1,2,5,8,Regulars
7487,264,8,996.22,2,2,2,6,Hibernating
7488,362,5,623.65,2,1,1,4,Hibernating
7489,127,9,1275.13,4,2,3,9,Regulars
7490,253,16,2970.07,2,5,5,12,At Risk
7491,698,7,2688.3,1,1,5,7,Regulars
7492,186,10,4848.799999999999,3,3,5,11,Big Spenders
7493,391,8,830.83,2,2,1,5,Hibernating
7494,104,13,2366.4300000000003,4,4,4,12,Champions
7495,164,16,5206.860000000001,3,5,5,13,Big Spenders
7496,252,14,1519.3,2,5,3,10,At Risk
7497,868,5,968.63,1,1,2,4,Hibernating
7498,241,6,2542.96,3,1,4,8,Big Spenders
7499,154,13,3243.62,3,4,5,12,Big Spenders
7500,466,5,710.7,1,1,1,3,Hibernating
7501,511,9,571.83,1,2,1,4,Hibernating
7502,93,11,4079.65,4,3,5,12,Loyal
7503,198,11,850.26,3,3,2,8,Regulars
7504,200,9,1290.36,3,2,3,8,Regulars
7505,1044,13,2848.8599999999997,1,4,5,10,At Risk
7506,16,7,294.65,5,1,1,7,Regulars
7507,193,8,1686.97,3,2,3,8,Regulars
7508,565,10,1447.75,1,3,3,7,Regulars
7509,552,9,852.32,1,2,2,5,Hibernating
7510,578,12,1722.9599999999998,1,4,3,8,At Risk
7511,1013,2,1307.08,1,1,3,5,Regulars
7512,250,11,633.07,2,3,1,6,Regulars
7513,211,8,878.33,3,2,2,7,Regulars
7514,615,6,555.1800000000001,1,1,1,3,Hibernating
7515,147,9,912.53,4,2,2,8,Regulars
7516,26,14,2184.7200000000003,5,5,4,14,Champions
7517,506,8,1150.46,1,2,2,5,Hibernating
7518,281,8,1300.11,2,2,3,7,Regulars
7519,626,5,946.9100000000001,1,1,2,4,Hibernating
7520,345,16,3261.03,2,5,5,12,At Risk
7521,453,9,1331.45,2,2,3,7,Regulars
7522,338,13,3267.67,2,4,5,11,At Risk
7523,110,8,546.29,4,2,1,7,Regulars
7524,51,13,3727.1,5,4,5,14,Champions
7525,2,12,3739.28,5,4,5,14,Champions
7526,46,11,511.65999999999997,5,3,1,9,Loyal
7527,343,14,2844.45,2,5,5,12,At Risk
7528,247,9,1089.53,3,2,2,7,Regulars
7529,415,11,1242.72,2,3,3,8,Regulars
7530,75,17,1610.4099999999999,4,5,3,12,Loyal
7531,853,4,500.98,1,1,1,3,Hibernating
7532,152,11,1655.9099999999999,3,3,3,9,Regulars
7533,137,17,4005.87,4,5,5,14,Champions
7534,10,15,2044.31,5,5,4,14,Champions
7535,659,10,1833.39,1,3,4,8,Regulars
7536,676,8,4049.8300000000004,1,2,5,8,Regulars
7537,27,7,987.8100000000001,5,1,2,8,Regulars
7538,1962,5,1331.1000000000001,1,1,3,5,Regulars
7539,163,8,1001.07,3,2,2,7,Regulars
7540,1292,10,986.04,1,3,2,6,Regulars
7541,53,13,1499.3,5,4,3,12,Loyal
7542,14,8,1029.57,5,2,2,9,Regulars
7543,614,6,407.25,1,1,1,3,Hibernating
7544,348,8,751.9200000000001,2,2,1,5,Hibernating
7545,42,8,521.04,5,2,1,8,Regulars
7546,575,8,1372.35,1,2,3,6,Regulars
7547,302,11,2949.41,2,3,5,10,Regulars
7548,195,16,2928.35,3,5,5,13,Big Spenders
7549,178,6,510.94000000000005,3,1,1,5,Regulars
7550,75,8,493.20000000000005,4,2,1,7,Regulars
7551,530,6,1805.46,1,1,4,6,Regulars
7552,327,13,997.88,2,4,2,8,At Risk
7553,976,12,1261.3700000000001,1,4,3,8,At Risk
7554,152,11,864.12,3,3,2,8,Regulars
7555,142,10,515.96,4,3,1,8,Loyal
7556,523,6,2604.89,1,1,5,7,Regulars
7557,90,10,1452.6599999999999,4,3,3,10,Loyal
7558,0,11,1239.15,5,3,2,10,Loyal
7559,526,10,3220.28,1,3,5,9,Regulars
7560,333,14,1428.02,2,5,3,10,At Risk
7561,252,13,2051.7400000000002,2,4,4,10,At Risk
7562,612,11,2090.0299999999997,1,3,4,8,Regulars
7563,60,9,1498.97,5,2,3,10,Regulars
7564,561,8,984.91,1,2,2,5,Hibernating
7565,9,7,848.18,5,1,2,8,Regulars
7566,29,10,965.9,5,3,2,10,Loyal
7567,133,16,1171.76,4,5,2,11,Loyal
7568,447,7,1097.2,2,1,2,5,Hibernating
7569,65,10,1106.81,5,3,2,10,Loyal
7570,20,12,1308.6299999999999,5,4,3,12,Loyal
7571,560,10,3226.3,1,3,5,9,Regulars
7572,21,10,841.64,5,3,1,9,Loyal
7573,1004,8,5119.26,1,2,5,8,Regulars
7574,389,12,7693.26,2,4,5,11,At Risk
7575,448,11,3392.73,2,3,5,10,Regulars
7576,84,13,1952.85,4,4,4,12,Champions
7577,101,10,1325.83,4,3,3,10,Loyal
7578,249,6,669.65,2,1,1,4,Hibernating
7579,123,15,2087.28,4,5,4,13,Champions
7580,108,15,2358.52,4,5,4,13,Champions
7581,151,12,1566.08,3,4,3,10,Regulars
7582,371,9,486.61,2,2,1,5,Hibernating
7583,349,10,3217.21,2,3,5,10,Regulars
7584,293,15,2127.71,2,5,4,11,At Risk
7585,98,11,2810.37,4,3,5,12,Loyal
7586,179,14,1595.6499999999999,3,5,3,11,Regulars
7587,389,9,4467.51,2,2,5,9,Regulars
7588,383,8,1116.79,2,2,2,6,Hibernating
7589,1116,9,755.25,1,2,1,4,Hibernating
7590,142,5,697.63,4,1,1,6,Regulars
7591,154,16,4137.889999999999,3,5,5,13,Big Spenders
7592,339,9,727.05,2,2,1,5,Hibernating
7593,241,9,4699.86,3,2,5,10,Big Spenders
7594,253,10,1971.54,2,3,4,9,Regulars
7595,215,14,2827.61,3,5,5,13,Big Spenders
7596,171,6,709.4499999999999,3,1,1,5,Regulars
7597,193,10,3631.5499999999997,3,3,5,11,Big Spenders
7598,202,5,477.20000000000005,3,1,1,5,Regulars
7599,441,13,2555.85,2,4,4,10,At Risk
7600,898,9,624.49,1,2,1,4,Hibernating
7601,1063,7,1231.3,1,1,2,4,Hibernating
7602,81,11,1081.46,4,3,2,9,Loyal
7603,56,12,3443.88,5,4,5,14,Champions
7604,620,7,2457.0299999999997,1,1,4,6,Regulars
7605,119,8,619.78,4,2,1,7,Regulars
7606,515,8,847.33,1,2,2,5,Hibernating
7607,271,7,2104.13,2,1,4,7,Regulars
7608,31,15,4613.16,5,5,5,15,Champions
7609,46,16,3676.0899999999997,5,5,5,15,Champions
7610,1079,7,1040.43,1,1,2,4,Hibernating
7611,451,14,2775.44,2,5,5,12,At Risk
7612,196,10,1279.6599999999999,3,3,3,9,Regulars
7613,264,10,854.03,2,3,2,7,Regulars
7614,154,6,2268.8399999999997,3,1,4,8,Big Spenders
7615,14,10,1205.64,5,3,2,10,Loyal
7616,414,10,4231.26,2,3,5,10,Regulars
7617,201,7,741.78,3,1,1,5,Regulars
7618,134,11,3027.46,4,3,5,12,Loyal
7619,157,9,4011.99,3,2,5,10,Big Spenders
7620,196,17,2250.77,3,5,4,12,Big Spenders
7621,81,6,951.2599999999999,4,1,2,7,Regulars
7622,216,11,1929.89,3,3,4,10,Big Spenders
7623,376,9,1520.84,2,2,3,7,Regulars
7624,87,12,1151.77,4,4,2,10,Loyal
7625,342,14,1432.1200000000001,2,5,3,10,At Risk
7626,214,6,1019.29,3,1,2,6,Regulars
7627,555,11,2116.66,1,3,4,8,Regulars
7628,46,10,1469.83,5,3,3,11,Loyal
7629,8,15,1702.41,5,5,3,13,Loyal
7630,275,11,1445.55,2,3,3,8,Regulars
7631,659,7,730.37,1,1,1,3,Hibernating
7632,136,11,902.02,4,3,2,9,Loyal
7633,257,9,774.25,2,2,1,5,Hibernating
7634,307,9,3115.59,2,2,5,9,Regulars
7635,908,12,2955.93,1,4,5,10,At Risk
7636,44,10,1666.3,5,3,3,11,Loyal
7637,256,11,2175.35,2,3,4,9,Regulars
7638,47,13,1153.46,5,4,2,11,Loyal
7639,430,12,4052.64,2,4,5,11,At Risk
7640,583,9,3781.89,1,2,5,8,Regulars
7641,660,7,1313.53,1,1,3,5,Regulars
7642,216,12,1831.62,3,4,4,11,Big Spenders
7643,200,9,4111.38,3,2,5,10,Big Spenders
7644,337,8,1768.79,2,2,4,8,Regulars
7645,43,14,2183.06,5,5,4,14,Champions
7646,389,8,1058.73,2,2,2,6,Hibernating
7647,537,9,986.75,1,2,2,5,Hibernating
7648,237,17,2671.7599999999998,3,5,5,13,Big Spenders
7649,623,7,321.75,1,1,1,3,Hibernating
7650,294,4,908.74,2,1,2,5,Hibernating
7651,734,9,3405.45,1,2,5,8,Regulars
7652,351,6,932.3799999999999,2,1,2,5,Hibernating
7653,743,6,2394.3199999999997,1,1,4,6,Regulars
7654,157,16,3491.2,3,5,5,13,Big Spenders
7655,262,13,3200.69,2,4,5,11,At Risk
7656,77,13,4707.93,4,4,5,13,Champions
7657,120,16,2427.64,4,5,4,13,Champions
7658,715,9,999.3199999999999,1,2,2,5,Hibernating
7659,279,9,706.76,2,2,1,5,Hibernating
7660,133,10,2649.6,4,3,5,12,Loyal
7661,741,8,538.24,1,2,1,4,Hibernating
7662,30,8,2473.9999999999995,5,2,4,11,Big Spenders
7663,274,10,1113.01,2,3,2,7,Regulars
7664,560,13,1309.17,1,4,3,8,At Risk
7665,10,12,1377.84,5,4,3,12,Loyal
7666,129,10,2569.69,4,3,4,11,Loyal
7667,303,12,1614.43,2,4,3,9,At Risk
7668,237,14,3403.21,3,5,5,13,Big Spenders
7669,608,7,850.23,1,1,2,4,Hibernating
7670,22,10,1026.4,5,3,2,10,Loyal
7671,518,6,1502.88,1,1,3,5,Regulars
7672,64,7,473.40000000000003,5,1,1,7,Regulars
7673,48,11,1114.99,5,3,2,10,Loyal
7674,346,4,568.09,2,1,1,4,Hibernating
7675,493,11,1406.42,1,3,3,7,Regulars
7676,179,15,4050.6300000000006,3,5,5,13,Big Spenders
7677,191,12,6937.43,3,4,5,12,Big Spenders
7678,1295,6,176.45,1,1,1,3,Hibernating
7679,563,8,1311.6299999999999,1,2,3,6,Regulars
7680,43,6,1975.3200000000002,5,1,4,10,Big Spenders
7681,73,7,1361.33,4,1,3,8,Regulars
7682,224,8,1159.53,3,2,2,7,Regulars
7683,400,8,800.96,2,2,1,5,Hibernating
7684,300,8,1060.3600000000001,2,2,2,6,Hibernating
7685,330,8,1350.93,2,2,3,7,Regulars
7686,148,18,2671.39,3,5,5,13,Big Spenders
7687,1297,10,5550.22,1,3,5,9,Regulars
7688,256,9,1426.2,2,2,3,7,Regulars
7689,28,11,3357.82,5,3,5,13,Loyal
7690,41,11,1548.63,5,3,3,11,Loyal
7691,236,16,2389.49,3,5,4,12,Big Spenders
7692,110,23,3890.5,4,5,5,14,Champions
7693,595,12,1506.22,1,4,3,8,At Risk
7694,84,11,3544.87,4,3,5,12,Loyal
7695,264,12,1076.67,2,4,2,8,At Risk
7696,498,11,2633.1,1,3,5,9,Regulars
7697,131,10,861.25,4,3,2,9,Loyal
7698,549,8,873.25,1,2,2,5,Hibernating
7699,432,10,744.3399999999999,2,3,1,6,Regulars
7700,261,17,2339.12,2,5,4,11,At Risk
7701,216,11,583.9399999999999,3,3,1,7,Regulars
7702,153,5,624.16,3,1,1,5,Regulars
7703,502,15,1560.67,1,5,3,9,At Risk
7704,922,6,423.08,1,1,1,3,Hibernating
7705,307,12,3465.85,2,4,5,11,At Risk
7706,210,16,1465.76,3,5,3,11,Regulars
7707,124,7,452.25,4,1,1,6,Regulars
7708,106,16,2924.98,4,5,5,14,Champions
7709,146,12,1288.92,4,4,3,11,Loyal
7710,892,11,1575.0500000000002,1,3,3,7,Regulars
7711,125,12,1776.6200000000001,4,4,4,12,Champions
7712,517,6,421.61,1,1,1,3,Hibernating
7713,255,9,1138.74,2,2,2,6,Hibernating
7714,68,15,1865.23,4,5,4,13,Champions
7715,588,10,2361.39,1,3,4,8,Regulars
7716,182,15,1266.54,3,5,3,11,Regulars
7717,218,10,1357.73,3,3,3,9,Regulars
7718,8,8,893.15,5,2,2,9,Regulars
7719,13,24,2325.25,5,5,4,14,Champions
7720,1509,4,162.41,1,1,1,3,Hibernating
7721,45,7,695.65,5,1,1,7,Regulars
7722,42,8,1330.9,5,2,3,10,Regulars
7723,147,9,1447.8300000000002,4,2,3,9,Regulars
7724,74,8,844.54,4,2,1,7,Regulars
7725,72,12,2924.59,4,4,5,13,Champions
7726,475,13,1544.08,1,4,3,8,At Risk
7727,41,5,620.75,5,1,1,7,Regulars
7728,69,7,760.5699999999999,4,1,1,6,Regulars
7729,136,9,1409.23,4,2,3,9,Regulars
7730,356,13,1183.3899999999999,2,4,2,8,At Risk
7731,20,11,3231.66,5,3,5,13,Loyal
7732,138,8,711.74,4,2,1,7,Regulars
7733,43,7,1160.3600000000001,5,1,2,8,Regulars
7734,124,12,503.99,4,4,1,9,Loyal
7735,192,17,3722.4300000000003,3,5,5,13,Big Spenders
7736,542,7,621.71,1,1,1,3,Hibernating
7737,355,14,906.51,2,5,2,9,At Risk
7738,365,7,1174.98,2,1,2,5,Hibernating
7739,238,7,716.31,3,1,1,5,Regulars
7740,8,12,4371.67,5,4,5,14,Champions
7741,448,8,1082.05,2,2,2,6,Hibernating
7742,53,10,3430.66,5,3,5,13,Loyal
7743,215,10,1801.99,3,3,4,10,Big Spenders
7744,696,8,689.15,1,2,1,4,Hibernating
7745,127,8,902.82,4,2,2,8,Regulars
7746,986,5,1534.8799999999999,1,1,3,5,Regulars
7747,39,12,2026.77,5,4,4,13,Champions
7748,122,7,852.1400000000001,4,1,2,7,Regulars
7749,307,12,1504.02,2,4,3,9,At Risk
7750,1,11,751.29,5,3,1,9,Loyal
7751,36,14,3579.0299999999997,5,5,5,15,Champions
7752,24,13,2265.21,5,4,4,13,Champions
7753,145,15,1071.92,4,5,2,11,Loyal
7754,21,15,4105.38,5,5,5,15,Champions
7755,111,14,1499.73,4,5,3,12,Loyal
7756,376,7,3991.51,2,1,5,8,Regulars
7757,642,12,1760.0,1,4,4,9,At Risk
7758,21,11,2859.5099999999998,5,3,5,13,Loyal
7759,15,14,3104.5699999999997,5,5,5,15,Champions
7760,114,11,1466.41,4,3,3,10,Loyal
7761,445,11,871.6800000000001,2,3,2,7,Regulars
7762,45,10,681.4200000000001,5,3,1,9,Loyal
7763,316,7,935.2,2,1,2,5,Hibernating
7764,162,12,1639.66,3,4,3,10,Regulars
7765,356,15,1420.18,2,5,3,10,At Risk
7766,61,10,850.31,5,3,2,10,Loyal
7767,27,9,1460.6999999999998,5,2,3,10,Regulars
7768,437,12,2083.37,2,4,4,10,At Risk
7769,88,13,1362.07,4,4,3,11,Loyal
7770,266,8,650.55,2,2,1,5,Hibernating
7771,7,12,1704.13,5,4,3,12,Loyal
7772,29,11,2268.32,5,3,4,12,Loyal
7773,198,18,2993.75,3,5,5,13,Big Spenders
7774,335,8,973.83,2,2,2,6,Hibernating
7775,1181,4,2463.41,1,1,4,6,Regulars
7776,361,19,2100.05,2,5,4,11,At Risk
7777,698,6,1039.61,1,1,2,4,Hibernating
7778,207,11,4668.01,3,3,5,11,Big Spenders
7779,134,11,951.76,4,3,2,9,Loyal
7780,17,7,2014.28,5,1,4,10,Big Spenders
7781,497,7,2020.49,1,1,4,6,Regulars
7782,20,8,1240.46,5,2,2,9,Regulars
7783,172,9,931.0799999999999,3,2,2,7,Regulars
7784,49,8,2213.73,5,2,4,11,Big Spenders
7785,607,10,1752.16,1,3,4,8,Regulars
7786,124,8,1560.6100000000001,4,2,3,9,Regulars
7787,0,11,1480.98,5,3,3,11,Loyal
7788,110,8,1224.1999999999998,4,2,2,8,Regulars
7789,218,6,801.25,3,1,1,5,Regulars
7790,183,13,1976.3700000000001,3,4,4,11,Big Spenders
7791,250,11,1036.35,2,3,2,7,Regulars
7792,517,15,2032.8500000000001,1,5,4,10,At Risk
7793,223,12,912.39,3,4,2,9,Regulars
7794,226,9,1900.41,3,2,4,9,Big Spenders
7795,187,10,696.4,3,3,1,7,Regulars
7796,108,10,1065.03,4,3,2,9,Loyal
7797,871,10,2881.15,1,3,5,9,Regulars
7798,180,14,2924.7400000000002,3,5,5,13,Big Spenders
7799,484,13,2758.79,1,4,5,10,At Risk
7800,505,5,596.64,1,1,1,3,Hibernating
7801,235,17,2944.03,3,5,5,13,Big Spenders
7802,300,9,1557.3,2,2,3,7,Regulars
7803,1114,9,1432.78,1,2,3,6,Regulars
7804,287,16,1238.34,2,5,2,9,At Risk
7805,218,15,4741.83,3,5,5,13,Big Spenders
7806,57,12,1862.8400000000001,5,4,4,13,Champions
7807,556,10,3295.66,1,3,5,9,Regulars
7808,42,13,3730.35,5,4,5,14,Champions
7809,593,10,899.15,1,3,2,6,Regulars
7810,119,11,1349.52,4,3,3,10,Loyal
7811,330,12,4237.72,2,4,5,11,At Risk
7812,181,14,1310.79,3,5,3,11,Regulars
7813,440,9,914.78,2,2,2,6,Hibernating
7814,306,12,3110.92,2,4,5,11,At Risk
7815,503,13,1677.6399999999999,1,4,3,8,At Risk
7816,561,7,660.1700000000001,1,1,1,3,Hibernating
7817,91,10,1411.1599999999999,4,3,3,10,Loyal
7818,111,8,1224.5,4,2,2,8,Regulars
7819,630,16,2787.17,1,5,5,11,At Risk
7820,114,13,1677.78,4,4,3,11,Loyal
7821,19,8,1744.84,5,2,4,11,Big Spenders
7822,173,11,808.16,3,3,1,7,Regulars
7823,93,12,1134.2,4,4,2,10,Loyal
7824,843,9,2238.06,1,2,4,7,Regulars
7825,626,10,1032.13,1,3,2,6,Regulars
7826,191,5,695.43,3,1,1,5,Regulars
7827,391,10,1418.5,2,3,3,8,Regulars
7828,239,9,1063.53,3,2,2,7,Regulars
7829,350,5,289.13,2,1,1,4,Hibernating
7830,21,6,622.55,5,1,1,7,Regulars
7831,142,4,1970.21,4,1,4,9,Big Spenders
7832,537,9,1532.69,1,2,3,6,Regulars
7833,25,17,1975.08,5,5,4,14,Champions
7834,371,9,636.07,2,2,1,5,Hibernating
7835,235,5,345.14,3,1,1,5,Regulars
7836,125,9,1366.21,4,2,3,9,Regulars
7837,62,11,2218.82,5,3,4,12,Loyal
7838,225,7,2345.79,3,1,4,8,Big Spenders
7839,630,7,1023.64,1,1,2,4,Hibernating
7840,239,8,3391.6099999999997,3,2,5,10,Big Spenders
7841,565,10,848.92,1,3,2,6,Regulars
7842,268,7,802.24,2,1,1,4,Hibernating
7843,286,15,1378.47,2,5,3,10,At Risk
7844,31,13,1568.54,5,4,3,12,Loyal
7845,272,11,1622.6299999999999,2,3,3,8,Regulars
7846,158,9,1910.81,3,2,4,9,Big Spenders
7847,509,12,1558.06,1,4,3,8,At Risk
7848,475,11,1116.76,1,3,2,6,Regulars
7849,157,6,673.35,3,1,1,5,Regulars
7850,4,10,623.3900000000001,5,3,1,9,Loyal
7851,135,11,1462.8700000000001,4,3,3,10,Loyal
7852,287,9,1377.6100000000001,2,2,3,7,Regulars
7853,2,9,1132.26,5,2,2,9,Regulars
7854,679,13,2941.24,1,4,5,10,At Risk
7855,321,13,1868.61,2,4,4,10,At Risk
7856,38,15,1701.6299999999999,5,5,3,13,Loyal
7857,201,10,1482.23,3,3,3,9,Regulars
7858,99,9,2103.28,4,2,4,10,Big Spenders
7859,475,7,479.68,1,1,1,3,Hibernating
7860,1341,6,1359.6799999999998,1,1,3,5,Regulars
7861,512,8,1183.88,1,2,2,5,Hibernating
7862,926,12,641.76,1,4,1,6,At Risk
7863,23,11,1745.67,5,3,4,12,Loyal
7864,847,7,898.69,1,1,2,4,Hibernating
7865,489,10,1009.01,1,3,2,6,Regulars
7866,598,10,4094.8399999999992,1,3,5,9,Regulars
7867,383,15,2069.71,2,5,4,11,At Risk
7868,79,11,735.5600000000001,4,3,1,8,Loyal
7869,147,10,1293.99,4,3,3,10,Loyal
7870,9,11,1590.01,5,3,3,11,Loyal
7871,1307,2,204.47,1,1,1,3,Hibernating
7872,111,15,6625.46,4,5,5,14,Champions
7873,223,12,3732.140000000001,3,4,5,12,Big Spenders
7874,75,17,2369.5,4,5,4,13,Champions
7875,50,9,1141.51,5,2,2,9,Regulars
7876,233,11,1382.23,3,3,3,9,Regulars
7877,163,6,879.11,3,1,2,6,Regulars
7878,248,11,3110.8500000000004,2,3,5,10,Regulars
7879,193,16,3708.19,3,5,5,13,Big Spenders
7880,101,6,557.77,4,1,1,6,Regulars
7881,251,11,886.91,2,3,2,7,Regulars
7882,1300,4,639.53,1,1,1,3,Hibernating
7883,329,6,695.39,2,1,1,4,Hibernating
7884,31,13,1939.41,5,4,4,13,Champions
7885,481,9,880.1700000000001,1,2,2,5,Hibernating
7886,1129,6,1299.6499999999999,1,1,3,5,Regulars
7887,195,3,284.88,3,1,1,5,Regulars
7888,471,8,1603.55,1,2,3,6,Regulars
7889,31,13,1549.1399999999999,5,4,3,12,Loyal
7890,32,9,1181.6299999999999,5,2,2,9,Regulars
7891,58,10,1004.44,5,3,2,10,Loyal
7892,672,8,2856.9500000000003,1,2,5,8,Regulars
7893,502,7,2547.56,1,1,4,6,Regulars
7894,173,8,1514.3700000000001,3,2,3,8,Regulars
7895,175,14,1441.4,3,5,3,11,Regulars
7896,754,10,3136.17,1,3,5,9,Regulars
7897,787,6,206.78,1,1,1,3,Hibernating
7898,9,8,517.37,5,2,1,8,Regulars
7899,716,7,575.12,1,1,1,3,Hibernating
7900,30,8,473.72,5,2,1,8,Regulars
7901,288,7,745.39,2,1,1,4,Hibernating
7902,179,15,2545.94,3,5,4,12,Big Spenders
7903,164,15,1338.87,3,5,3,11,Regulars
7904,614,13,2900.97,1,4,5,10,At Risk
7905,128,11,2534.59,4,3,4,11,Loyal
7906,176,8,847.53,3,2,2,7,Regulars
7907,168,9,888.58,3,2,2,7,Regulars
7908,455,11,1092.1000000000001,2,3,2,7,Regulars
7909,234,8,745.6,3,2,1,6,Regulars
7910,425,10,3053.7299999999996,2,3,5,10,Regulars
7911,25,9,1284.12,5,2,3,10,Regulars
7912,30,13,895.4399999999999,5,4,2,11,Loyal
7913,648,7,1039.07,1,1,2,4,Hibernating
7914,281,8,668.8199999999999,2,2,1,5,Hibernating
7915,1025,8,1010.12,1,2,2,5,Hibernating
7916,508,14,1047.5900000000001,1,5,2,8,At Risk
7917,648,3,224.33,1,1,1,3,Hibernating
7918,154,7,1043.53,3,1,2,6,Regulars
7919,165,8,713.09,3,2,1,6,Regulars
7920,118,11,1193.29,4,3,2,9,Loyal
7921,225,10,1362.81,3,3,3,9,Regulars
7922,184,10,3979.7900000000004,3,3,5,11,Big Spenders
7923,74,12,2164.95,4,4,4,12,Champions
7924,204,9,1722.68,3,2,3,8,Regulars
7925,54,11,3337.2200000000003,5,3,5,13,Loyal
7926,371,11,1222.54,2,3,2,7,Regulars
7927,102,13,2824.52,4,4,5,13,Champions
7928,907,12,3005.21,1,4,5,10,At Risk
7929,30,8,831.55,5,2,1,8,Regulars
7930,165,14,5629.330000000001,3,5,5,13,Big Spenders
7931,162,12,1028.52,3,4,2,9,Regulars
7932,94,11,2532.2799999999997,4,3,4,11,Loyal
7933,7,9,2723.77,5,2,5,12,Big Spenders
7934,152,10,1110.28,3,3,2,8,Regulars
7935,213,11,1759.4499999999998,3,3,4,10,Big Spenders
7936,1164,5,420.22,1,1,1,3,Hibernating
7937,628,7,727.04,1,1,1,3,Hibernating
7938,456,6,793.33,2,1,1,4,Hibernating
7939,93,9,1348.74,4,2,3,9,Regulars
7940,79,8,598.96,4,2,1,7,Regulars
7941,216,7,617.71,3,1,1,5,Regulars
7942,93,10,4029.96,4,3,5,12,Loyal
7943,310,7,607.2,2,1,1,4,Hibernating
7944,68,4,248.70000000000002,4,1,1,6,Regulars
7945,429,8,779.7,2,2,1,5,Hibernating
7946,142,7,578.75,4,1,1,6,Regulars
7947,258,9,862.6700000000001,2,2,2,6,Hibernating
7948,42,18,5567.97,5,5,5,15,Champions
7949,37,10,3014.3500000000004,5,3,5,13,Loyal
7950,586,12,1285.78,1,4,3,8,At Risk
7951,68,13,1695.67,4,4,3,11,Loyal
7952,707,9,1351.49,1,2,3,6,Regulars
7953,119,7,3273.59,4,1,5,10,Big Spenders
7954,200,9,1006.1,3,2,2,7,Regulars
7955,55,12,1955.55,5,4,4,13,Champions
7956,48,9,3319.2099999999996,5,2,5,12,Big Spenders
7957,178,6,1034.7,3,1,2,6,Regulars
7958,111,11,2991.0699999999997,4,3,5,12,Loyal
7959,29,9,926.12,5,2,2,9,Regulars
7960,1100,10,742.19,1,3,1,5,Regulars
7961,52,14,936.73,5,5,2,12,Loyal
7962,238,6,390.49,3,1,1,5,Regulars
7963,35,6,2435.55,5,1,4,10,Big Spenders
7964,68,9,1148.98,4,2,2,8,Regulars
7965,173,9,1594.93,3,2,3,8,Regulars
7966,255,13,1121.75,2,4,2,8,At Risk
7967,706,15,3800.46,1,5,5,11,At Risk
7968,250,4,196.61,2,1,1,4,Hibernating
7969,1246,8,2673.96,1,2,5,8,Regulars
7970,260,7,3890.1200000000003,2,1,5,8,Regulars
7971,743,11,3510.89,1,3,5,9,Regulars
7972,255,11,2030.8000000000002,2,3,4,9,Regulars
7973,577,9,2447.8599999999997,1,2,4,7,Regulars
7974,61,14,2105.42,5,5,4,14,Champions
7975,95,10,1016.61,4,3,2,9,Loyal
7976,583,8,3330.69,1,2,5,8,Regulars
7977,1140,8,821.27,1,2,1,4,Hibernating
7978,126,13,2554.76,4,4,4,12,Champions
7979,362,16,1440.18,2,5,3,10,At Risk
7980,15,7,1278.15,5,1,3,9,Regulars
7981,69,11,2421.67,4,3,4,11,Loyal
7982,470,12,4972.69,1,4,5,10,At Risk
7983,126,16,3586.8100000000004,4,5,5,14,Champions
7984,785,7,772.9300000000001,1,1,1,3,Hibernating
7985,185,11,1668.1399999999999,3,3,3,9,Regulars
7986,19,14,1044.4,5,5,2,12,Loyal
7987,19,7,489.5,5,1,1,7,Regulars
7988,238,9,767.54,3,2,1,6,Regulars
7989,234,6,340.65,3,1,1,5,Regulars
7990,344,9,752.7,2,2,1,5,Hibernating
7991,502,8,1135.8600000000001,1,2,2,5,Hibernating
7992,177,12,2106.4800000000005,3,4,4,11,Big Spenders
7993,105,13,1469.56,4,4,3,11,Loyal
7994,91,10,2049.29,4,3,4,11,Loyal
7995,91,10,1285.33,4,3,3,10,Loyal
7996,3,10,3152.69,5,3,5,13,Loyal
7997,293,5,564.57,2,1,1,4,Hibernating
7998,26,11,1666.1499999999999,5,3,3,11,Loyal
7999,331,6,2986.46,2,1,5,8,Regulars
8000,386,8,695.0699999999999,2,2,1,5,Hibernating
8001,492,6,2522.07,1,1,4,6,Regulars
8002,101,7,619.88,4,1,1,6,Regulars
8003,39,10,1798.8300000000002,5,3,4,12,Loyal
8004,543,1,296.48,1,1,1,3,Hibernating
8005,190,6,3363.3,3,1,5,9,Big Spenders
8006,455,8,1392.92,2,2,3,7,Regulars
8007,110,9,980.79,4,2,2,8,Regulars
8008,76,11,1501.77,4,3,3,10,Loyal
8009,417,9,1566.98,2,2,3,7,Regulars
8010,283,6,1412.77,2,1,3,6,Regulars
8011,114,11,3368.92,4,3,5,12,Loyal
8012,1259,6,4407.37,1,1,5,7,Regulars
8013,1346,8,777.01,1,2,1,4,Hibernating
8014,161,9,5213.219999999999,3,2,5,10,Big Spenders
8015,885,4,837.22,1,1,1,3,Hibernating
8016,587,9,1009.09,1,2,2,5,Hibernating
8017,167,15,2191.45,3,5,4,12,Big Spenders
8018,834,7,1222.85,1,1,2,4,Hibernating
8019,396,8,1448.3899999999999,2,2,3,7,Regulars
8020,10,9,573.97,5,2,1,8,Regulars
8021,154,7,654.23,3,1,1,5,Regulars
8022,518,9,1434.56,1,2,3,6,Regulars
8023,101,9,3315.1,4,2,5,11,Big Spenders
8024,119,14,3997.25,4,5,5,14,Champions
8025,154,8,1871.6,3,2,4,9,Big Spenders
8026,144,19,1714.29,4,5,3,12,Loyal
8027,64,9,2520.8700000000003,5,2,4,11,Big Spenders
8028,629,14,2289.99,1,5,4,10,At Risk
8029,715,6,937.17,1,1,2,4,Hibernating
8030,257,12,1090.97,2,4,2,8,At Risk
8031,943,6,534.13,1,1,1,3,Hibernating
8032,19,10,1091.5,5,3,2,10,Loyal
8033,226,9,1292.3899999999999,3,2,3,8,Regulars
8034,75,5,1377.03,4,1,3,8,Regulars
8035,255,10,1725.81,2,3,4,9,Regulars
8036,92,11,2915.1800000000003,4,3,5,12,Loyal
8037,10,12,4214.02,5,4,5,14,Champions
8038,233,12,3146.55,3,4,5,12,Big Spenders
8039,69,7,1752.6100000000001,4,1,4,9,Big Spenders
8040,101,9,645.47,4,2,1,7,Regulars
8041,353,9,972.14,2,2,2,6,Hibernating
8042,522,10,2123.9900000000002,1,3,4,8,Regulars
8043,52,9,2186.86,5,2,4,11,Big Spenders
8044,73,19,2336.29,4,5,4,13,Champions
8045,383,8,1472.94,2,2,3,7,Regulars
8046,67,11,1315.06,4,3,3,10,Loyal
8047,148,11,972.25,3,3,2,8,Regulars
8048,153,13,749.2900000000001,3,4,1,8,Regulars
8049,545,4,254.6,1,1,1,3,Hibernating
8050,263,10,2233.6099999999997,2,3,4,9,Regulars
8051,118,9,670.32,4,2,1,7,Regulars
8052,308,6,801.23,2,1,1,4,Hibernating
8053,37,18,3129.25,5,5,5,15,Champions
8054,61,9,1187.49,5,2,2,9,Regulars
8055,40,15,1261.6000000000001,5,5,3,13,Loyal
8056,63,18,4554.88,5,5,5,15,Champions
8057,45,14,3521.0,5,5,5,15,Champions
8058,111,12,1247.25,4,4,3,11,Loyal
8059,78,7,665.27,4,1,1,6,Regulars
8060,124,11,1067.25,4,3,2,9,Loyal
8061,674,10,2698.32,1,3,5,9,Regulars
8062,546,7,418.87,1,1,1,3,Hibernating
8063,422,9,1272.38,2,2,3,7,Regulars
8064,202,5,790.35,3,1,1,5,Regulars
8065,19,11,2386.38,5,3,4,12,Loyal
8066,92,10,814.05,4,3,1,8,Loyal
8067,225,6,667.91,3,1,1,5,Regulars
8068,239,11,2184.48,3,3,4,10,Big Spenders
8069,258,10,3636.8599999999997,2,3,5,10,Regulars
8070,66,11,2047.6499999999999,4,3,4,11,Loyal
8071,128,12,2566.03,4,4,4,12,Champions
8072,309,9,3574.5600000000004,2,2,5,9,Regulars
8073,38,16,2109.31,5,5,4,14,Champions
8074,157,8,978.93,3,2,2,7,Regulars
8075,188,19,3173.9900000000002,3,5,5,13,Big Spenders
8076,580,6,324.95,1,1,1,3,Hibernating
8077,506,9,881.83,1,2,2,5,Hibernating
8078,176,10,850.37,3,3,2,8,Regulars
8079,244,7,1892.2,3,1,4,8,Big Spenders
8080,287,5,197.91,2,1,1,4,Hibernating
8081,663,17,1963.82,1,5,4,10,At Risk
8082,300,12,2599.15,2,4,5,11,At Risk
8083,170,12,1467.49,3,4,3,10,Regulars
8084,301,6,339.22,2,1,1,4,Hibernating
8085,148,13,3663.59,3,4,5,12,Big Spenders
8086,53,12,1022.25,5,4,2,11,Loyal
8087,559,5,904.75,1,1,2,4,Hibernating
8088,94,3,743.27,4,1,1,6,Regulars
8089,37,9,745.2099999999999,5,2,1,8,Regulars
8090,162,14,1128.93,3,5,2,10,Regulars
8091,356,9,2659.57,2,2,5,9,Regulars
8092,132,12,4059.3500000000004,4,4,5,13,Champions
8093,17,7,698.61,5,1,1,7,Regulars
8094,111,14,1077.45,4,5,2,11,Loyal
8095,175,10,1312.59,3,3,3,9,Regulars
8096,257,11,1445.95,2,3,3,8,Regulars
8097,501,9,839.63,1,2,1,4,Hibernating
8098,18,8,1468.72,5,2,3,10,Regulars
8099,464,10,1182.24,1,3,2,6,Regulars
8100,224,10,2000.29,3,3,4,10,Big Spenders
8101,338,10,1091.73,2,3,2,7,Regulars
8102,816,4,512.31,1,1,1,3,Hibernating
8103,321,7,2147.13,2,1,4,7,Regulars
8104,16,15,1499.07,5,5,3,13,Loyal
8105,163,15,2212.85,3,5,4,12,Big Spenders
8106,428,11,1901.51,2,3,4,9,Regulars
8107,41,16,4388.24,5,5,5,15,Champions
8108,109,13,1836.4299999999998,4,4,4,12,Champions
8109,96,10,772.25,4,3,1,8,Loyal
8110,125,12,857.48,4,4,2,10,Loyal
8111,57,18,5299.67,5,5,5,15,Champions
8112,14,5,1193.37,5,1,2,8,Regulars
8113,436,14,1185.57,2,5,2,9,At Risk
8114,9,15,2560.84,5,5,4,14,Champions
8115,129,17,1655.35,4,5,3,12,Loyal
8116,194,9,1384.61,3,2,3,8,Regulars
8117,6,12,2783.55,5,4,5,14,Champions
8118,904,6,698.3299999999999,1,1,1,3,Hibernating
8119,528,7,702.15,1,1,1,3,Hibernating
8120,496,8,1413.61,1,2,3,6,Regulars
8121,522,7,853.58,1,1,2,4,Hibernating
8122,194,16,2734.52,3,5,5,13,Big Spenders
8123,114,10,1421.03,4,3,3,10,Loyal
8124,199,9,680.22,3,2,1,6,Regulars
8125,616,10,2878.11,1,3,5,9,Regulars
8126,194,8,686.22,3,2,1,6,Regulars
8127,243,14,3875.6899999999996,3,5,5,13,Big Spenders
8128,579,8,1923.17,1,2,4,7,Regulars
8129,25,11,973.96,5,3,2,10,Loyal
8130,625,3,357.77,1,1,1,3,Hibernating
8131,64,9,919.27,5,2,2,9,Regulars
8132,89,14,1425.6200000000001,4,5,3,12,Loyal
8133,679,13,1409.31,1,4,3,8,At Risk
8134,161,11,767.34,3,3,1,7,Regulars
8135,492,6,576.52,1,1,1,3,Hibernating
8136,530,9,2742.72,1,2,5,8,Regulars
8137,422,9,931.24,2,2,2,6,Hibernating
8138,186,10,1712.17,3,3,3,9,Regulars
8139,31,12,1714.6000000000001,5,4,3,12,Loyal
8140,748,7,1883.57,1,1,4,6,Regulars
8141,476,12,2496.1200000000003,1,4,4,9,At Risk
8142,52,10,1370.29,5,3,3,11,Loyal
8143,67,11,687.7,4,3,1,8,Loyal
8144,52,17,2092.7200000000003,5,5,4,14,Champions
8145,116,8,5073.389999999999,4,2,5,11,Big Spenders
8146,320,8,1637.3999999999999,2,2,3,7,Regulars
8147,207,8,1974.44,3,2,4,9,Big Spenders
8148,127,14,1520.73,4,5,3,12,Loyal
8149,452,10,953.15,2,3,2,7,Regulars
8150,128,8,1986.23,4,2,4,10,Big Spenders
8151,88,12,1040.07,4,4,2,10,Loyal
8152,0,10,943.84,5,3,2,10,Loyal
8153,374,10,3451.68,2,3,5,10,Regulars
8154,229,12,1749.89,3,4,4,11,Big Spenders
8155,723,8,764.97,1,2,1,4,Hibernating
8156,69,15,1226.77,4,5,2,11,Loyal
8157,89,14,1009.01,4,5,2,11,Loyal
8158,251,11,1433.44,2,3,3,8,Regulars
8159,54,8,1966.2099999999998,5,2,4,11,Big Spenders
8160,23,18,3723.4100000000003,5,5,5,15,Champions
8161,46,14,3193.9,5,5,5,15,Champions
8162,178,5,3525.4300000000003,3,1,5,9,Big Spenders
8163,18,13,1648.42,5,4,3,12,Loyal
8164,138,7,417.96,4,1,1,6,Regulars
8165,8,11,1522.9199999999998,5,3,3,11,Loyal
8166,23,11,2497.52,5,3,4,12,Loyal
8167,311,7,4643.610000000001,2,1,5,8,Regulars
8168,44,13,1901.51,5,4,4,13,Champions
8169,278,10,2702.0299999999997,2,3,5,10,Regulars
8170,54,8,1027.7,5,2,2,9,Regulars
8171,267,6,750.3199999999999,2,1,1,4,Hibernating
8172,211,2,202.96,3,1,1,5,Regulars
8173,137,10,1776.96,4,3,4,11,Loyal
8174,662,5,876.6600000000001,1,1,2,4,Hibernating
8175,178,10,1438.3400000000001,3,3,3,9,Regulars
8176,300,9,590.6899999999999,2,2,1,5,Hibernating
8177,106,13,1747.73,4,4,4,12,Champions
8178,764,11,1003.9499999999999,1,3,2,6,Regulars
8179,345,7,2438.85,2,1,4,7,Regulars
8180,149,7,3731.0099999999998,3,1,5,9,Big Spenders
8181,27,8,705.49,5,2,1,8,Regulars
8182,623,6,648.77,1,1,1,3,Hibernating
8183,785,8,3006.5099999999998,1,2,5,8,Regulars
8184,74,12,1830.31,4,4,4,12,Champions
8185,204,10,659.61,3,3,1,7,Regulars
8186,69,11,2877.96,4,3,5,12,Loyal
8187,587,9,1543.94,1,2,3,6,Regulars
8188,147,9,2282.55,4,2,4,10,Big Spenders
8189,193,8,801.5999999999999,3,2,1,6,Regulars
8190,160,11,2691.6800000000003,3,3,5,11,Big Spenders
8191,281,12,1407.36,2,4,3,9,At Risk
8192,383,12,1393.15,2,4,3,9,At Risk
8193,27,10,1838.06,5,3,4,12,Loyal
8194,135,12,674.19,4,4,1,9,Loyal
8195,221,7,2999.96,3,1,5,9,Big Spenders
8196,55,7,467.45000000000005,5,1,1,7,Regulars
8197,132,14,3940.89,4,5,5,14,Champions
8198,964,9,2374.02,1,2,4,7,Regulars
8199,211,22,2072.15,3,5,4,12,Big Spenders
8200,138,11,1758.28,4,3,4,11,Loyal
8201,391,8,579.73,2,2,1,5,Hibernating
8202,54,10,1620.6000000000001,5,3,3,11,Loyal
8203,80,12,4118.39,4,4,5,13,Champions
8204,22,8,1582.1,5,2,3,10,Regulars
8205,117,9,1235.23,4,2,2,8,Regulars
8206,419,10,2779.81,2,3,5,10,Regulars
8207,120,9,1089.33,4,2,2,8,Regulars
8208,160,15,4988.16,3,5,5,13,Big Spenders
8209,741,6,612.66,1,1,1,3,Hibernating
8210,313,11,2389.56,2,3,4,9,Regulars
8211,79,14,2452.74,4,5,4,13,Champions
8212,304,13,2557.87,2,4,4,10,At Risk
8213,140,9,3013.99,4,2,5,11,Big Spenders
8214,141,12,1350.46,4,4,3,11,Loyal
8215,344,6,423.47,2,1,1,4,Hibernating
8216,138,14,976.0799999999999,4,5,2,11,Loyal
8217,354,13,1286.14,2,4,3,9,At Risk
8218,5,13,1362.81,5,4,3,12,Loyal
8219,173,13,1931.21,3,4,4,11,Big Spenders
8220,131,15,3534.18,4,5,5,14,Champions
8221,427,10,1749.23,2,3,4,9,Regulars
8222,530,10,2867.52,1,3,5,9,Regulars
8223,21,14,3684.73,5,5,5,15,Champions
8224,24,16,1760.66,5,5,4,14,Champions
8225,286,8,1878.5900000000001,2,2,4,8,Regulars
8226,273,12,2465.02,2,4,4,10,At Risk
8227,90,10,1213.46,4,3,2,9,Loyal
8228,467,14,7016.299999999999,1,5,5,11,At Risk
8229,26,5,3337.0699999999997,5,1,5,11,Big Spenders
8230,56,9,959.1899999999999,5,2,2,9,Regulars
8231,149,10,1270.03,3,3,3,9,Regulars
8232,5,11,1543.38,5,3,3,11,Loyal
8233,595,9,694.23,1,2,1,4,Hibernating
8234,277,12,2338.8599999999997,2,4,4,10,At Risk
8235,263,11,3000.85,2,3,5,10,Regulars
8236,992,6,910.79,1,1,2,4,Hibernating
8237,481,10,1022.0600000000001,1,3,2,6,Regulars
8238,322,19,3747.23,2,5,5,12,At Risk
8239,275,10,1133.75,2,3,2,7,Regulars
8240,101,14,2251.15,4,5,4,13,Champions
8241,49,12,1109.1399999999999,5,4,2,11,Loyal
8242,509,14,945.16,1,5,2,8,At Risk
8243,59,12,4140.14,5,4,5,14,Champions
8244,68,10,920.25,4,3,2,9,Loyal
8245,122,8,843.9399999999999,4,2,1,7,Regulars
8246,1266,6,448.52000000000004,1,1,1,3,Hibernating
8247,15,9,2161.56,5,2,4,11,Big Spenders
8248,93,11,1253.95,4,3,3,10,Loyal
8249,273,13,1488.18,2,4,3,9,At Risk
8250,137,9,1957.1400000000003,4,2,4,10,Big Spenders
8251,258,12,2208.65,2,4,4,10,At Risk
8252,27,8,425.15999999999997,5,2,1,8,Regulars
8253,285,9,1599.2800000000002,2,2,3,7,Regulars
8254,77,12,1343.04,4,4,3,11,Loyal
8255,83,7,2595.6400000000003,4,1,5,10,Big Spenders
8256,859,2,269.52,1,1,1,3,Hibernating
8257,31,15,3135.8700000000003,5,5,5,15,Champions
8258,721,10,947.1099999999999,1,3,2,6,Regulars
8259,51,8,1519.28,5,2,3,10,Regulars
8260,125,13,1080.0,4,4,2,10,Loyal
8261,202,10,915.71,3,3,2,8,Regulars
8262,218,15,3239.31,3,5,5,13,Big Spenders
8263,605,11,1370.74,1,3,3,7,Regulars
8264,64,11,1925.65,5,3,4,12,Loyal
8265,485,11,4024.42,1,3,5,9,Regulars
8266,553,12,1697.89,1,4,3,8,At Risk
8267,364,5,564.9,2,1,1,4,Hibernating
8268,76,10,1794.71,4,3,4,11,Loyal
8269,76,14,2083.56,4,5,4,13,Champions
8270,526,10,1420.98,1,3,3,7,Regulars
8271,160,8,3797.6299999999997,3,2,5,10,Big Spenders
8272,6,10,2448.8199999999997,5,3,4,12,Loyal
8273,5,12,1425.36,5,4,3,12,Loyal
8274,24,9,1347.58,5,2,3,10,Regulars
8275,92,12,2589.62,4,4,5,13,Champions
8276,249,8,2184.98,2,2,4,8,Regulars
8277,511,12,4829.12,1,4,5,10,At Risk
8278,76,9,1142.51,4,2,2,8,Regulars
8279,379,5,2121.35,2,1,4,7,Regulars
8280,306,9,1158.27,2,2,2,6,Hibernating
8281,78,6,209.25,4,1,1,6,Regulars
8282,194,8,733.25,3,2,1,6,Regulars
8283,9,9,792.38,5,2,1,8,Regulars
8284,990,9,1139.25,1,2,2,5,Hibernating
8285,156,13,2538.35,3,4,4,11,Big Spenders
8286,172,16,2550.02,3,5,4,12,Big Spenders
8287,399,5,2403.05,2,1,4,7,Regulars
8288,350,9,4437.09,2,2,5,9,Regulars
8289,233,8,1442.0,3,2,3,8,Regulars
8290,308,8,673.5,2,2,1,5,Hibernating
8291,454,10,1017.4000000000001,2,3,2,7,Regulars
8292,450,10,4750.58,2,3,5,10,Regulars
8293,169,9,932.1899999999999,3,2,2,7,Regulars
8294,0,8,1205.36,5,2,2,9,Regulars
8295,392,8,3395.99,2,2,5,9,Regulars
8296,1692,6,456.47,1,1,1,3,Hibernating
8297,40,7,907.71,5,1,2,8,Regulars
8298,528,11,1501.1,1,3,3,7,Regulars
8299,741,15,3087.29,1,5,5,11,At Risk
8300,425,11,1968.05,2,3,4,9,Regulars
8301,106,8,2046.47,4,2,4,10,Big Spenders
8302,681,10,3345.76,1,3,5,9,Regulars
8303,363,8,979.7,2,2,2,6,Hibernating
8304,38,6,1548.86,5,1,3,9,Regulars
8305,135,6,631.9300000000001,4,1,1,6,Regulars
8306,536,4,744.91,1,1,1,3,Hibernating
8307,262,8,313.56,2,2,1,5,Hibernating
8308,40,12,1162.53,5,4,2,11,Loyal
8309,135,10,1785.1200000000001,4,3,4,11,Loyal
8310,38,14,3171.09,5,5,5,15,Champions
8311,530,3,151.79,1,1,1,3,Hibernating
8312,1106,7,2334.77,1,1,4,6,Regulars
8313,783,8,441.15000000000003,1,2,1,4,Hibernating
8314,315,11,2926.8999999999996,2,3,5,10,Regulars
8315,693,10,2360.9300000000003,1,3,4,8,Regulars
8316,172,13,1498.48,3,4,3,10,Regulars
8317,237,10,1777.47,3,3,4,10,Big Spenders
8318,132,12,3182.04,4,4,5,13,Champions
8319,594,7,707.78,1,1,1,3,Hibernating
8320,419,12,1596.32,2,4,3,9,At Risk
8321,91,8,526.06,4,2,1,7,Regulars
8322,74,9,2040.53,4,2,4,10,Big Spenders
8323,134,10,3658.17,4,3,5,12,Loyal
8324,105,10,1906.37,4,3,4,11,Loyal
8325,1221,8,1018.4200000000001,1,2,2,5,Hibernating
8326,625,8,1372.8,1,2,3,6,Regulars
8327,33,12,2000.69,5,4,4,13,Champions
8328,219,8,2365.62,3,2,4,9,Big Spenders
8329,105,14,1894.8899999999999,4,5,4,13,Champions
8330,112,11,3147.65,4,3,5,12,Loyal
8331,678,10,1242.1200000000001,1,3,3,7,Regulars
8332,370,5,1594.15,2,1,3,6,Regulars
8333,615,10,2439.37,1,3,4,8,Regulars
8334,393,12,4406.78,2,4,5,11,At Risk
8335,143,7,607.41,4,1,1,6,Regulars
8336,540,9,779.22,1,2,1,4,Hibernating
8337,33,10,5503.38,5,3,5,13,Loyal
8338,72,8,786.73,4,2,1,7,Regulars
8339,485,12,670.5899999999999,1,4,1,6,At Risk
8340,164,10,1355.66,3,3,3,9,Regulars
8341,345,10,2439.77,2,3,4,9,Regulars
8342,1113,8,3324.66,1,2,5,8,Regulars
8343,278,9,1387.8799999999999,2,2,3,7,Regulars
8344,90,12,1249.32,4,4,3,11,Loyal
8345,161,14,1530.89,3,5,3,11,Regulars
8346,232,10,870.58,3,3,2,8,Regulars
8347,15,11,3274.82,5,3,5,13,Loyal
8348,970,9,861.8399999999999,1,2,2,5,Hibernating
8349,510,7,816.55,1,1,1,3,Hibernating
8350,191,9,667.51,3,2,1,6,Regulars
8351,1115,5,781.04,1,1,1,3,Hibernating
8352,199,12,1811.65,3,4,4,11,Big Spenders
8353,277,7,1020.19,2,1,2,5,Hibernating
8354,708,8,2089.92,1,2,4,7,Regulars
8355,167,10,859.2,3,3,2,8,Regulars
8356,167,10,1678.1799999999998,3,3,3,9,Regulars
8357,113,9,2827.2700000000004,4,2,5,11,Big Spenders
8358,42,10,643.49,5,3,1,9,Loyal
8359,73,21,2871.9,4,5,5,14,Champions
8360,667,6,1345.76,1,1,3,5,Regulars
8361,127,10,1996.29,4,3,4,11,Loyal
8362,170,8,670.66,3,2,1,6,Regulars
8363,55,8,2152.87,5,2,4,11,Big Spenders
8364,44,10,975.88,5,3,2,10,Loyal
8365,130,8,467.52,4,2,1,7,Regulars
8366,150,9,607.12,3,2,1,6,Regulars
8367,444,9,1438.74,2,2,3,7,Regulars
8368,60,9,1055.4,5,2,2,9,Regulars
8369,43,13,1424.11,5,4,3,12,Loyal
8370,133,9,412.95,4,2,1,7,Regulars
8371,281,9,3787.54,2,2,5,9,Regulars
8372,174,8,1027.41,3,2,2,7,Regulars
8373,215,15,2278.65,3,5,4,12,Big Spenders
8374,15,7,912.4,5,1,2,8,Regulars
8375,79,7,860.83,4,1,2,7,Regulars
8376,159,10,901.96,3,3,2,8,Regulars
8377,504,8,1114.63,1,2,2,5,Hibernating
8378,86,18,3922.43,4,5,5,14,Champions
8379,433,10,3302.6499999999996,2,3,5,10,Regulars
8380,1687,7,1108.2,1,1,2,4,Hibernating
8381,295,10,1271.98,2,3,3,8,Regulars
8382,281,10,1370.02,2,3,3,8,Regulars
8383,139,9,2002.21,4,2,4,10,Big Spenders
8384,244,12,882.22,3,4,2,9,Regulars
8385,104,14,1815.8500000000001,4,5,4,13,Champions
8386,57,16,4148.969999999999,5,5,5,15,Champions
8387,180,9,606.7,3,2,1,6,Regulars
8388,887,6,813.24,1,1,1,3,Hibernating
8389,508,8,2850.8999999999996,1,2,5,8,Regulars
8390,130,11,886.37,4,3,2,9,Loyal
8391,99,13,1051.25,4,4,2,10,Loyal
8392,195,14,941.56,3,5,2,10,Regulars
8393,443,13,1240.01,2,4,2,8,At Risk
8394,216,11,4039.67,3,3,5,11,Big Spenders
8395,101,6,691.8,4,1,1,6,Regulars
8396,893,6,1822.7,1,1,4,6,Regulars
8397,479,11,872.01,1,3,2,6,Regulars
8398,492,12,2020.01,1,4,4,9,At Risk
8399,5,11,1096.59,5,3,2,10,Loyal
8400,255,10,3832.7,2,3,5,10,Regulars
8401,23,12,1706.21,5,4,3,12,Loyal
8402,82,8,842.6800000000001,4,2,1,7,Regulars
8403,572,17,1765.56,1,5,4,10,At Risk
8404,183,8,1478.47,3,2,3,8,Regulars
8405,112,17,3728.88,4,5,5,14,Champions
8406,285,5,1942.8200000000002,2,1,4,7,Regulars
8407,152,11,3417.3799999999997,3,3,5,11,Big Spenders
8408,120,14,2991.73,4,5,5,14,Champions
8409,99,13,1595.75,4,4,3,11,Loyal
8410,100,8,1519.93,4,2,3,9,Regulars
8411,281,11,1600.27,2,3,3,8,Regulars
8412,811,9,1541.76,1,2,3,6,Regulars
8413,212,12,3944.7400000000002,3,4,5,12,Big Spenders
8414,168,4,791.29,3,1,1,5,Regulars
8415,193,11,2099.94,3,3,4,10,Big Spenders
8416,42,9,706.53,5,2,1,8,Regulars
8417,148,9,1489.3600000000001,3,2,3,8,Regulars
8418,28,11,1252.73,5,3,3,11,Loyal
8419,203,8,673.2,3,2,1,6,Regulars
8420,651,8,1130.63,1,2,2,5,Hibernating
8421,36,8,1362.35,5,2,3,10,Regulars
8422,299,12,1362.79,2,4,3,9,At Risk
8423,14,10,790.47,5,3,1,9,Loyal
8424,0,7,2614.93,5,1,5,11,Big Spenders
8425,1024,7,1274.44,1,1,3,5,Regulars
8426,48,4,767.35,5,1,1,7,Regulars
8427,853,8,1236.47,1,2,2,5,Hibernating
8428,497,10,1879.7,1,3,4,8,Regulars
8429,60,7,1031.81,5,1,2,8,Regulars
8430,271,5,572.6,2,1,1,4,Hibernating
8431,348,8,1205.94,2,2,2,6,Hibernating
8432,177,10,1324.51,3,3,3,9,Regulars
8433,187,14,1790.34,3,5,4,12,Big Spenders
8434,85,8,684.4499999999999,4,2,1,7,Regulars
8435,1471,8,544.03,1,2,1,4,Hibernating
8436,309,7,1241.9299999999998,2,1,3,6,Regulars
8437,813,5,257.40999999999997,1,1,1,3,Hibernating
8438,195,7,909.4699999999999,3,1,2,6,Regulars
8439,88,9,1572.54,4,2,3,9,Regulars
8440,282,8,614.64,2,2,1,5,Hibernating
8441,726,11,3649.0800000000004,1,3,5,9,Regulars
8442,159,15,3637.6099999999997,3,5,5,13,Big Spenders
8443,574,6,688.04,1,1,1,3,Hibernating
8444,1287,11,1022.13,1,3,2,6,Regulars
8445,42,9,863.79,5,2,2,9,Regulars
8446,337,7,2246.96,2,1,4,7,Regulars
8447,35,9,697.37,5,2,1,8,Regulars
8448,109,13,1889.42,4,4,4,12,Champions
8449,32,12,1938.6599999999999,5,4,4,13,Champions
8450,292,11,2503.7,2,3,4,9,Regulars
8451,45,7,1354.92,5,1,3,9,Regulars
8452,440,13,7984.57,2,4,5,11,At Risk
8453,44,11,3254.55,5,3,5,13,Loyal
8454,28,14,2924.19,5,5,5,15,Champions
8455,650,4,712.5,1,1,1,3,Hibernating
8456,603,10,1014.48,1,3,2,6,Regulars
8457,186,10,1510.71,3,3,3,9,Regulars
8458,166,9,1051.79,3,2,2,7,Regulars
8459,399,8,471.77,2,2,1,5,Hibernating
8460,439,12,1099.9299999999998,2,4,2,8,At Risk
8461,352,13,1448.29,2,4,3,9,At Risk
8462,8,20,4500.31,5,5,5,15,Champions
8463,693,8,952.78,1,2,2,5,Hibernating
8464,492,10,1235.72,1,3,2,6,Regulars
8465,173,15,2409.2400000000002,3,5,4,12,Big Spenders
8466,477,10,1690.08,1,3,3,7,Regulars
8467,614,11,1104.05,1,3,2,6,Regulars
8468,79,16,2896.9,4,5,5,14,Champions
8469,146,7,745.51,4,1,1,6,Regulars
8470,56,14,3338.71,5,5,5,15,Champions
8471,206,11,1104.92,3,3,2,8,Regulars
8472,250,6,2303.95,2,1,4,7,Regulars
8473,560,6,445.15999999999997,1,1,1,3,Hibernating
8474,54,13,1852.93,5,4,4,13,Champions
8475,84,11,1890.3200000000002,4,3,4,11,Loyal
8476,274,13,1514.69,2,4,3,9,At Risk
8477,858,8,2149.87,1,2,4,7,Regulars
8478,343,11,931.24,2,3,2,7,Regulars
8479,2,10,866.73,5,3,2,10,Loyal
8480,1075,8,546.81,1,2,1,4,Hibernating
8481,122,13,3634.17,4,4,5,13,Champions
8482,195,11,3169.84,3,3,5,11,Big Spenders
8483,30,13,3121.41,5,4,5,14,Champions
8484,21,15,3823.1400000000003,5,5,5,15,Champions
8485,128,11,1438.0600000000002,4,3,3,10,Loyal
8486,891,7,1100.17,1,1,2,4,Hibernating
8487,192,10,733.23,3,3,1,7,Regulars
8488,269,9,4170.0599999999995,2,2,5,9,Regulars
8489,150,11,1938.35,3,3,4,10,Big Spenders
8490,46,16,2251.41,5,5,4,14,Champions
8491,424,7,2839.2200000000003,2,1,5,8,Regulars
8492,26,18,4216.14,5,5,5,15,Champions
8493,13,11,2315.6,5,3,4,12,Loyal
8494,225,8,871.33,3,2,2,7,Regulars
8495,68,8,858.44,4,2,2,8,Regulars
8496,497,7,1067.64,1,1,2,4,Hibernating
8497,789,12,3007.18,1,4,5,10,At Risk
8498,677,9,1565.4,1,2,3,6,Regulars
8499,49,17,3288.29,5,5,5,15,Champions
8500,186,13,3494.24,3,4,5,12,Big Spenders
8501,7,10,2929.9300000000003,5,3,5,13,Loyal
8502,669,6,516.56,1,1,1,3,Hibernating
8503,61,10,2459.04,5,3,4,12,Loyal
8504,383,8,1916.17,2,2,4,8,Regulars
8505,8,11,1107.68,5,3,2,10,Loyal
8506,821,6,804.78,1,1,1,3,Hibernating
8507,210,7,547.29,3,1,1,5,Regulars
8508,317,9,881.81,2,2,2,6,Hibernating
8509,65,7,4134.56,5,1,5,11,Big Spenders
8510,73,5,234.09,4,1,1,6,Regulars
8511,288,12,2259.29,2,4,4,10,At Risk
8512,281,11,1632.22,2,3,3,8,Regulars
8513,128,14,2055.34,4,5,4,13,Champions
8514,488,11,2163.48,1,3,4,8,Regulars
8515,41,9,1329.02,5,2,3,10,Regulars
8516,183,13,1233.23,3,4,2,9,Regulars
8517,24,11,1138.42,5,3,2,10,Loyal
8518,357,16,1800.19,2,5,4,11,At Risk
8519,138,11,2020.0200000000002,4,3,4,11,Loyal
8520,11,9,1264.17,5,2,3,10,Regulars
8521,140,9,1309.19,4,2,3,9,Regulars
8522,215,15,3306.68,3,5,5,13,Big Spenders
8523,81,9,689.25,4,2,1,7,Regulars
8524,177,16,5188.320000000001,3,5,5,13,Big Spenders
8525,561,9,902.48,1,2,2,5,Hibernating
8526,633,12,1506.0300000000002,1,4,3,8,At Risk
8527,53,13,3608.6499999999996,5,4,5,14,Champions
8528,594,5,367.14,1,1,1,3,Hibernating
8529,36,5,327.97999999999996,5,1,1,7,Regulars
8530,165,11,2762.45,3,3,5,11,Big Spenders
8531,23,17,2761.78,5,5,5,15,Champions
8532,301,10,1405.89,2,3,3,8,Regulars
8533,191,7,627.97,3,1,1,5,Regulars
8534,98,14,1109.3,4,5,2,11,Loyal
8535,56,12,1278.31,5,4,3,12,Loyal
8536,99,15,1553.44,4,5,3,12,Loyal
8537,917,7,2517.66,1,1,4,6,Regulars
8538,22,6,2064.07,5,1,4,10,Big Spenders
8539,246,9,974.83,3,2,2,7,Regulars
8540,94,9,1413.86,4,2,3,9,Regulars
8541,359,7,1399.07,2,1,3,6,Regulars
8542,156,14,1562.5,3,5,3,11,Regulars
8543,761,8,732.25,1,2,1,4,Hibernating
8544,321,12,1361.27,2,4,3,9,At Risk
8545,96,5,760.9499999999999,4,1,1,6,Regulars
8546,80,10,3489.79,4,3,5,12,Loyal
8547,159,10,1471.8899999999999,3,3,3,9,Regulars
8548,16,11,1068.8,5,3,2,10,Loyal
8549,152,15,2759.36,3,5,5,13,Big Spenders
8550,481,6,810.16,1,1,1,3,Hibernating
8551,46,16,1951.19,5,5,4,14,Champions
8552,577,10,662.6899999999999,1,3,1,5,Regulars
8553,249,5,639.22,2,1,1,4,Hibernating
8554,43,12,1580.1000000000001,5,4,3,12,Loyal
8555,11,12,1576.3,5,4,3,12,Loyal
8556,4,8,1897.56,5,2,4,11,Big Spenders
8557,171,11,2456.53,3,3,4,10,Big Spenders
8558,111,12,2781.3900000000003,4,4,5,13,Champions
8559,284,8,636.66,2,2,1,5,Hibernating
8560,556,10,993.0,1,3,2,6,Regulars
8561,211,11,693.45,3,3,1,7,Regulars
8562,68,16,3201.56,4,5,5,14,Champions
8563,176,8,649.34,3,2,1,6,Regulars
8564,447,6,866.84,2,1,2,5,Hibernating
8565,176,15,4739.33,3,5,5,13,Big Spenders
8566,468,11,1384.55,1,3,3,7,Regulars
8567,171,10,1103.93,3,3,2,8,Regulars
8568,415,8,1654.44,2,2,3,7,Regulars
8569,245,15,969.5699999999999,3,5,2,10,Regulars
8570,172,14,2599.6,3,5,5,13,Big Spenders
8571,70,14,1753.76,4,5,4,13,Champions
8572,114,12,2687.6000000000004,4,4,5,13,Champions
8573,574,9,1394.02,1,2,3,6,Regulars
8574,16,12,3924.1400000000003,5,4,5,14,Champions
8575,361,11,1052.52,2,3,2,7,Regulars
8576,246,8,798.95,3,2,1,6,Regulars
8577,351,8,2402.94,2,2,4,8,Regulars
8578,380,9,703.6800000000001,2,2,1,5,Hibernating
8579,91,16,2185.79,4,5,4,13,Champions
8580,209,12,1918.6899999999998,3,4,4,11,Big Spenders
8581,391,7,315.36,2,1,1,4,Hibernating
8582,575,6,944.11,1,1,2,4,Hibernating
8583,888,6,578.0,1,1,1,3,Hibernating
8584,172,9,3576.3,3,2,5,10,Big Spenders
8585,422,9,1639.6599999999999,2,2,3,7,Regulars
8586,54,13,2284.2599999999998,5,4,4,13,Champions
8587,881,7,820.21,1,1,1,3,Hibernating
8588,48,16,2316.71,5,5,4,14,Champions
8589,17,15,1846.69,5,5,4,14,Champions
8590,22,13,3324.42,5,4,5,14,Champions
8591,422,5,531.99,2,1,1,4,Hibernating
8592,171,11,3644.93,3,3,5,11,Big Spenders
8593,155,15,3592.78,3,5,5,13,Big Spenders
8594,11,19,2388.8599999999997,5,5,4,14,Champions
8595,690,7,1626.5400000000002,1,1,3,5,Regulars
8596,94,8,1913.86,4,2,4,10,Big Spenders
8597,171,8,2584.88,3,2,5,10,Big Spenders
8598,263,10,2412.46,2,3,4,9,Regulars
8599,715,8,888.62,1,2,2,5,Hibernating
8600,113,8,2570.87,4,2,4,10,Big Spenders
8601,219,14,2097.45,3,5,4,12,Big Spenders
8602,568,5,620.23,1,1,1,3,Hibernating
8603,133,16,2375.9900000000002,4,5,4,13,Champions
8604,23,10,1092.96,5,3,2,10,Loyal
8605,762,8,848.22,1,2,2,5,Hibernating
8606,196,13,1509.3,3,4,3,10,Regulars
8607,91,14,3157.33,4,5,5,14,Champions
8608,26,9,752.0500000000001,5,2,1,8,Regulars
8609,70,14,4654.59,4,5,5,14,Champions
8610,82,9,882.56,4,2,2,8,Regulars
8611,468,11,4133.9800000000005,1,3,5,9,Regulars
8612,39,8,423.57,5,2,1,8,Regulars
8613,83,12,1848.57,4,4,4,12,Champions
8614,23,9,959.3499999999999,5,2,2,9,Regulars
8615,115,12,2711.24,4,4,5,13,Champions
8616,442,8,1017.4100000000001,2,2,2,6,Hibernating
8617,621,14,3016.63,1,5,5,11,At Risk
8618,883,8,883.9100000000001,1,2,2,5,Hibernating
8619,73,14,3471.91,4,5,5,14,Champions
8620,105,11,2240.92,4,3,4,11,Loyal
8621,45,8,1107.86,5,2,2,9,Regulars
8622,869,4,179.95000000000002,1,1,1,3,Hibernating
8623,266,10,4279.43,2,3,5,10,Regulars
8624,184,17,4297.27,3,5,5,13,Big Spenders
8625,46,13,1088.37,5,4,2,11,Loyal
8626,264,8,2509.12,2,2,4,8,Regulars
8627,367,5,1088.38,2,1,2,5,Hibernating
8628,54,6,1812.1000000000001,5,1,4,10,Big Spenders
8629,238,11,1875.0500000000002,3,3,4,10,Big Spenders
8630,464,8,848.27,1,2,2,5,Hibernating
8631,363,12,2108.23,2,4,4,10,At Risk
8632,117,13,4460.09,4,4,5,13,Champions
8633,7,6,733.48,5,1,1,7,Regulars
8634,163,11,1005.28,3,3,2,8,Regulars
8635,783,6,2066.7299999999996,1,1,4,6,Regulars
8636,167,11,1843.08,3,3,4,10,Big Spenders
8637,0,13,2411.01,5,4,4,13,Champions
8638,271,9,1361.63,2,2,3,7,Regulars
8639,638,13,2542.5699999999997,1,4,4,9,At Risk
8640,427,8,1515.1,2,2,3,7,Regulars
8641,16,9,1057.79,5,2,2,9,Regulars
8642,79,7,638.5799999999999,4,1,1,6,Regulars
8643,122,9,2042.96,4,2,4,10,Big Spenders
8644,6,10,2738.62,5,3,5,13,Loyal
8645,369,10,1364.04,2,3,3,8,Regulars
8646,209,9,2359.6,3,2,4,9,Big Spenders
8647,365,10,1177.8600000000001,2,3,2,7,Regulars
8648,166,13,1178.79,3,4,2,9,Regulars
8649,462,11,1993.2600000000002,1,3,4,8,Regulars
8650,39,12,821.51,5,4,1,10,Loyal
8651,508,7,444.55,1,1,1,3,Hibernating
8652,181,11,1716.98,3,3,3,9,Regulars
8653,142,9,2701.4700000000003,4,2,5,11,Big Spenders
8654,193,10,2273.5099999999998,3,3,4,10,Big Spenders
8655,4,8,924.8399999999999,5,2,2,9,Regulars
8656,53,11,1502.66,5,3,3,11,Loyal
8657,129,11,1262.6599999999999,4,3,3,10,Loyal
8658,179,8,978.8699999999999,3,2,2,7,Regulars
8659,181,5,2181.18,3,1,4,8,Big Spenders
8660,219,9,2048.37,3,2,4,9,Big Spenders
8661,119,6,845.29,4,1,2,7,Regulars
8662,84,10,1098.4,4,3,2,9,Loyal
8663,429,7,652.1,2,1,1,4,Hibernating
8664,70,10,2291.0299999999997,4,3,4,11,Loyal
8665,219,6,668.32,3,1,1,5,Regulars
8666,314,11,1214.9,2,3,2,7,Regulars
8667,124,6,3004.41,4,1,5,10,Big Spenders
8668,564,9,966.67,1,2,2,5,Hibernating
8669,213,9,1631.8,3,2,3,8,Regulars
8670,14,6,515.07,5,1,1,7,Regulars
8671,734,12,1173.2,1,4,2,7,At Risk
8672,85,10,881.81,4,3,2,9,Loyal
8673,688,6,493.61,1,1,1,3,Hibernating
8674,578,7,988.34,1,1,2,4,Hibernating
8675,79,14,1634.52,4,5,3,12,Loyal
8676,149,16,4323.0,3,5,5,13,Big Spenders
8677,482,8,2450.76,1,2,4,7,Regulars
8678,394,6,603.37,2,1,1,4,Hibernating
8679,101,12,1013.24,4,4,2,10,Loyal
8680,549,10,1449.06,1,3,3,7,Regulars
8681,169,15,2055.88,3,5,4,12,Big Spenders
8682,219,9,2259.54,3,2,4,9,Big Spenders
8683,63,11,4431.21,5,3,5,13,Loyal
8684,184,12,1429.64,3,4,3,10,Regulars
8685,568,9,902.15,1,2,2,5,Hibernating
8686,513,8,827.63,1,2,1,4,Hibernating
8687,699,12,1968.59,1,4,4,9,At Risk
8688,628,6,544.17,1,1,1,3,Hibernating
8689,549,12,2851.98,1,4,5,10,At Risk
8690,18,7,1301.93,5,1,3,9,Regulars
8691,263,8,661.6,2,2,1,5,Hibernating
8692,149,8,685.91,3,2,1,6,Regulars
8693,233,8,1969.6599999999999,3,2,4,9,Big Spenders
8694,76,12,2222.04,4,4,4,12,Champions
8695,45,10,1292.6399999999999,5,3,3,11,Loyal
8696,541,12,3910.1800000000003,1,4,5,10,At Risk
8697,85,9,5394.25,4,2,5,11,Big Spenders
8698,236,8,1746.18,3,2,4,9,Big Spenders
8699,376,11,1408.85,2,3,3,8,Regulars
8700,56,13,3286.6,5,4,5,14,Champions
8701,6,10,1210.3400000000001,5,3,2,10,Loyal
8702,274,12,3878.23,2,4,5,11,At Risk
8703,415,9,4427.78,2,2,5,9,Regulars
8704,71,11,5849.83,4,3,5,12,Loyal
8705,19,9,1654.0900000000001,5,2,3,10,Regulars
8706,82,13,1426.07,4,4,3,11,Loyal
8707,431,11,1245.1,2,3,3,8,Regulars
8708,812,8,867.1,1,2,2,5,Hibernating
8709,394,11,765.86,2,3,1,6,Regulars
8710,299,9,1622.79,2,2,3,7,Regulars
8711,952,9,2045.69,1,2,4,7,Regulars
8712,227,12,2068.52,3,4,4,11,Big Spenders
8713,430,8,734.52,2,2,1,5,Hibernating
8714,596,12,4397.83,1,4,5,10,At Risk
8715,280,9,2161.74,2,2,4,8,Regulars
8716,226,10,1247.62,3,3,3,9,Regulars
8717,75,10,3912.68,4,3,5,12,Loyal
8718,35,10,1130.86,5,3,2,10,Loyal
8719,43,12,2860.4100000000003,5,4,5,14,Champions
8720,166,6,754.5799999999999,3,1,1,5,Regulars
8721,19,9,560.89,5,2,1,8,Regulars
8722,395,11,3980.21,2,3,5,10,Regulars
8723,175,7,860.27,3,1,2,6,Regulars
8724,68,14,2520.0,4,5,4,13,Champions
8725,67,9,1378.19,4,2,3,9,Regulars
8726,518,9,1169.44,1,2,2,5,Hibernating
8727,714,8,559.0,1,2,1,4,Hibernating
8728,135,8,1794.02,4,2,4,10,Big Spenders
8729,852,7,816.3000000000001,1,1,1,3,Hibernating
8730,454,10,2466.9,2,3,4,9,Regulars
8731,20,17,2471.82,5,5,4,14,Champions
8732,386,8,1178.18,2,2,2,6,Hibernating
8733,459,10,1726.4,2,3,4,9,Regulars
8734,428,12,810.27,2,4,1,7,At Risk
8735,147,15,4452.15,4,5,5,14,Champions
8736,38,10,2128.77,5,3,4,12,Loyal
8737,50,16,2835.4100000000003,5,5,5,15,Champions
8738,113,8,1143.46,4,2,2,8,Regulars
8739,516,10,2020.96,1,3,4,8,Regulars
8740,188,7,2009.2500000000002,3,1,4,8,Big Spenders
8741,212,9,1258.47,3,2,3,8,Regulars
8742,912,2,80.45,1,1,1,3,Hibernating
8743,232,11,930.9599999999999,3,3,2,8,Regulars
8744,101,10,1312.5,4,3,3,10,Loyal
8745,582,15,1794.69,1,5,4,10,At Risk
8746,717,9,691.3,1,2,1,4,Hibernating
8747,154,9,968.01,3,2,2,7,Regulars
8748,133,5,3429.59,4,1,5,10,Big Spenders
8749,307,11,2986.8599999999997,2,3,5,10,Regulars
8750,281,10,744.16,2,3,1,6,Regulars
8751,35,8,2160.9,5,2,4,11,Big Spenders
8752,10,10,1183.6,5,3,2,10,Loyal
8753,99,15,1441.0,4,5,3,12,Loyal
8754,57,6,910.1700000000001,5,1,2,8,Regulars
8755,723,13,3764.24,1,4,5,10,At Risk
8756,1244,6,698.29,1,1,1,3,Hibernating
8757,256,11,1092.37,2,3,2,7,Regulars
8758,31,14,1355.15,5,5,3,13,Loyal
8759,76,10,1452.3700000000001,4,3,3,10,Loyal
8760,498,8,1018.98,1,2,2,5,Hibernating
8761,433,12,3069.64,2,4,5,11,At Risk
8762,651,3,401.53999999999996,1,1,1,3,Hibernating
8763,148,11,2380.22,3,3,4,10,Big Spenders
8764,68,11,1043.42,4,3,2,9,Loyal
8765,47,8,687.29,5,2,1,8,Regulars
8766,324,7,704.9,2,1,1,4,Hibernating
8767,166,8,775.88,3,2,1,6,Regulars
8768,494,9,1842.38,1,2,4,7,Regulars
8769,525,10,1046.5,1,3,2,6,Regulars
8770,81,9,645.6700000000001,4,2,1,7,Regulars
8771,133,12,2616.97,4,4,5,13,Champions
8772,31,7,860.56,5,1,2,8,Regulars
8773,167,7,676.1,3,1,1,5,Regulars
8774,270,15,2464.73,2,5,4,11,At Risk
8775,472,10,1525.52,1,3,3,7,Regulars
8776,69,10,2543.5800000000004,4,3,4,11,Loyal
8777,205,13,3137.7599999999998,3,4,5,12,Big Spenders
8778,129,9,709.36,4,2,1,7,Regulars
8779,32,10,4198.98,5,3,5,13,Loyal
8780,140,7,696.4399999999999,4,1,1,6,Regulars
8781,203,9,791.48,3,2,1,6,Regulars
8782,234,12,4023.1099999999997,3,4,5,12,Big Spenders
8783,263,8,1320.1,2,2,3,7,Regulars
8784,3,11,3204.28,5,3,5,13,Loyal
8785,169,11,1532.46,3,3,3,9,Regulars
8786,476,7,2003.69,1,1,4,6,Regulars
8787,314,8,2310.91,2,2,4,8,Regulars
8788,147,13,3480.73,4,4,5,13,Champions
8789,459,12,1329.64,2,4,3,9,At Risk
8790,2191,6,605.06,1,1,1,3,Hibernating
8791,1489,6,768.0899999999999,1,1,1,3,Hibernating
8792,280,11,692.76,2,3,1,6,Regulars
8793,30,8,1155.99,5,2,2,9,Regulars
8794,82,10,1036.98,4,3,2,9,Loyal
8795,60,14,3847.36,5,5,5,15,Champions
8796,167,11,758.0,3,3,1,7,Regulars
8797,77,11,851.4599999999999,4,3,2,9,Loyal
8798,486,11,1473.34,1,3,3,7,Regulars
8799,90,10,1010.43,4,3,2,9,Loyal
8800,556,7,475.3,1,1,1,3,Hibernating
8801,247,7,442.68,3,1,1,5,Regulars
8802,314,10,1049.58,2,3,2,7,Regulars
8803,4,10,3474.61,5,3,5,13,Loyal
8804,958,11,1181.57,1,3,2,6,Regulars
8805,143,7,2251.18,4,1,4,9,Big Spenders
8806,385,5,1904.1399999999999,2,1,4,7,Regulars
8807,11,11,649.72,5,3,1,9,Loyal
8808,196,18,3932.1600000000003,3,5,5,13,Big Spenders
8809,164,5,369.73,3,1,1,5,Regulars
8810,287,10,1632.6399999999999,2,3,3,8,Regulars
8811,128,12,1260.6,4,4,3,11,Loyal
8812,2,11,1415.02,5,3,3,11,Loyal
8813,141,15,5018.799999999999,4,5,5,14,Champions
8814,123,8,2354.21,4,2,4,10,Big Spenders
8815,68,5,2112.26,4,1,4,9,Big Spenders
8816,156,10,1050.36,3,3,2,8,Regulars
8817,14,9,1464.79,5,2,3,10,Regulars
8818,885,5,2991.05,1,1,5,7,Regulars
8819,702,11,2714.91,1,3,5,9,Regulars
8820,266,8,940.3299999999999,2,2,2,6,Hibernating
8821,15,12,1388.59,5,4,3,12,Loyal
8822,902,10,1622.8,1,3,3,7,Regulars
8823,670,8,889.58,1,2,2,5,Hibernating
8824,90,12,3434.19,4,4,5,13,Champions
8825,41,10,1273.39,5,3,3,11,Loyal
8826,60,9,1218.81,5,2,2,9,Regulars
8827,475,9,1812.54,1,2,4,7,Regulars
8828,65,8,2258.26,5,2,4,11,Big Spenders
8829,202,10,1786.75,3,3,4,10,Big Spenders
8830,774,14,1254.35,1,5,3,9,At Risk
8831,145,14,2864.61,4,5,5,14,Champions
8832,341,18,2379.35,2,5,4,11,At Risk
8833,544,9,1371.26,1,2,3,6,Regulars
8834,100,10,1141.57,4,3,2,9,Loyal
8835,919,5,358.82,1,1,1,3,Hibernating
8836,162,10,1718.6399999999999,3,3,3,9,Regulars
8837,48,8,1990.84,5,2,4,11,Big Spenders
8838,43,13,2110.36,5,4,4,13,Champions
8839,382,12,3361.7499999999995,2,4,5,11,At Risk
8840,185,9,2328.51,3,2,4,9,Big Spenders
8841,335,9,717.81,2,2,1,5,Hibernating
8842,136,11,1129.15,4,3,2,9,Loyal
8843,164,9,1260.27,3,2,3,8,Regulars
8844,478,10,956.64,1,3,2,6,Regulars
8845,449,6,982.32,2,1,2,5,Hibernating
8846,41,10,1130.5,5,3,2,10,Loyal
8847,350,9,1454.06,2,2,3,7,Regulars
8848,248,13,3312.47,2,4,5,11,At Risk
8849,72,10,867.0,4,3,2,9,Loyal
8850,273,6,286.76,2,1,1,4,Hibernating
8851,29,9,1074.96,5,2,2,9,Regulars
8852,1084,6,1259.27,1,1,3,5,Regulars
8853,156,9,734.12,3,2,1,6,Regulars
8854,0,10,2032.0500000000002,5,3,4,12,Loyal
8855,588,10,3391.1800000000003,1,3,5,9,Regulars
8856,501,14,3807.4299999999994,1,5,5,11,At Risk
8857,9,13,990.7,5,4,2,11,Loyal
8858,120,12,2103.62,4,4,4,12,Champions
8859,395,19,4066.5,2,5,5,12,At Risk
8860,695,7,728.8299999999999,1,1,1,3,Hibernating
8861,316,11,879.97,2,3,2,7,Regulars
8862,234,11,908.61,3,3,2,8,Regulars
8863,145,16,2882.33,4,5,5,14,Champions
8864,27,11,6035.71,5,3,5,13,Loyal
8865,295,11,948.13,2,3,2,7,Regulars
8866,54,14,1370.6,5,5,3,13,Loyal
8867,154,9,1229.74,3,2,2,7,Regulars
8868,265,7,456.98,2,1,1,4,Hibernating
8869,312,6,1002.75,2,1,2,5,Hibernating
8870,32,12,1217.14,5,4,2,11,Loyal
8871,15,14,1928.7,5,5,4,14,Champions
8872,92,13,4172.72,4,4,5,13,Champions
8873,487,9,1472.94,1,2,3,6,Regulars
8874,414,11,2207.52,2,3,4,9,Regulars
8875,209,8,1076.62,3,2,2,7,Regulars
8876,172,9,2545.36,3,2,4,9,Big Spenders
8877,302,11,1452.81,2,3,3,8,Regulars
8878,15,9,823.4200000000001,5,2,1,8,Regulars
8879,39,12,1497.64,5,4,3,12,Loyal
8880,5,11,4042.3300000000004,5,3,5,13,Loyal
8881,118,16,1995.34,4,5,4,13,Champions
8882,9,14,4160.58,5,5,5,15,Champions
8883,49,8,1057.06,5,2,2,9,Regulars
8884,958,8,1141.01,1,2,2,5,Hibernating
8885,293,9,1148.16,2,2,2,6,Hibernating
8886,183,10,2138.66,3,3,4,10,Big Spenders
8887,90,12,3016.56,4,4,5,13,Champions
8888,245,11,4212.5599999999995,3,3,5,11,Big Spenders
8889,536,10,1295.45,1,3,3,7,Regulars
8890,562,12,3509.05,1,4,5,10,At Risk
8891,21,7,1257.26,5,1,3,9,Regulars
8892,295,6,742.92,2,1,1,4,Hibernating
8893,1182,6,1285.22,1,1,3,5,Regulars
8894,93,12,1374.1100000000001,4,4,3,11,Loyal
8895,355,12,1242.4099999999999,2,4,3,9,At Risk
8896,208,9,3294.4599999999996,3,2,5,10,Big Spenders
8897,99,12,1945.22,4,4,4,12,Champions
8898,252,13,2743.4,2,4,5,11,At Risk
8899,14,10,1038.96,5,3,2,10,Loyal
8900,40,4,502.11,5,1,1,7,Regulars
8901,94,14,2853.9,4,5,5,14,Champions
8902,470,10,818.6,1,3,1,5,Regulars
8903,154,6,1106.46,3,1,2,6,Regulars
8904,101,10,941.52,4,3,2,9,Loyal
8905,191,17,4137.69,3,5,5,13,Big Spenders
8906,627,11,1176.76,1,3,2,6,Regulars
8907,15,14,1164.38,5,5,2,12,Loyal
8908,172,6,876.1600000000001,3,1,2,6,Regulars
8909,663,8,778.0899999999999,1,2,1,4,Hibernating
8910,645,10,3449.65,1,3,5,9,Regulars
8911,101,11,5190.5199999999995,4,3,5,12,Loyal
8912,60,8,986.77,5,2,2,9,Regulars
8913,198,13,1702.6100000000001,3,4,3,10,Regulars
8914,1083,10,2039.3200000000002,1,3,4,8,Regulars
8915,961,6,1102.8300000000002,1,1,2,4,Hibernating
8916,172,12,1721.5,3,4,3,10,Regulars
8917,90,15,2741.83,4,5,5,14,Champions
8918,100,11,2930.12,4,3,5,12,Loyal
8919,252,7,970.85,2,1,2,5,Hibernating
8920,229,9,1233.67,3,2,2,7,Regulars
8921,142,7,680.08,4,1,1,6,Regulars
8922,103,10,1600.54,4,3,3,10,Loyal
8923,192,9,1014.72,3,2,2,7,Regulars
8924,19,13,1830.04,5,4,4,13,Champions
8925,162,7,1400.6399999999999,3,1,3,7,Regulars
8926,234,6,4001.5,3,1,5,9,Big Spenders
8927,164,8,1636.1,3,2,3,8,Regulars
8928,190,8,615.48,3,2,1,6,Regulars
8929,310,11,675.73,2,3,1,6,Regulars
8930,1436,3,572.12,1,1,1,3,Hibernating
8931,33,12,5072.83,5,4,5,14,Champions
8932,125,6,702.77,4,1,1,6,Regulars
8933,199,7,883.64,3,1,2,6,Regulars
8934,623,14,1070.48,1,5,2,8,At Risk
8935,222,12,1282.21,3,4,3,10,Regulars
8936,9,12,1754.3799999999999,5,4,4,13,Champions
8937,122,10,1325.9099999999999,4,3,3,10,Loyal
8938,144,8,1145.52,4,2,2,8,Regulars
8939,229,6,3310.0899999999992,3,1,5,9,Big Spenders
8940,91,7,1025.07,4,1,2,7,Regulars
8941,117,11,2453.91,4,3,4,11,Loyal
8942,212,9,1685.79,3,2,3,8,Regulars
8943,723,4,377.14,1,1,1,3,Hibernating
8944,72,6,1512.1599999999999,4,1,3,8,Regulars
8945,82,8,1331.63,4,2,3,9,Regulars
8946,249,7,889.97,2,1,2,5,Hibernating
8947,395,13,1022.57,2,4,2,8,At Risk
8948,13,8,1010.6800000000001,5,2,2,9,Regulars
8949,78,7,758.16,4,1,1,6,Regulars
8950,50,7,419.12,5,1,1,7,Regulars
8951,96,14,3379.44,4,5,5,14,Champions
8952,0,7,517.37,5,1,1,7,Regulars
8953,1295,10,3189.79,1,3,5,9,Regulars
8954,79,11,2650.1099999999997,4,3,5,12,Loyal
8955,105,14,3487.59,4,5,5,14,Champions
8956,156,7,292.94,3,1,1,5,Regulars
8957,446,8,852.43,2,2,2,6,Hibernating
8958,225,8,587.31,3,2,1,6,Regulars
8959,144,19,5904.88,4,5,5,14,Champions
8960,371,16,1435.84,2,5,3,10,At Risk
8961,152,15,1982.02,3,5,4,12,Big Spenders
8962,464,6,1167.27,1,1,2,4,Hibernating
8963,5,15,1485.75,5,5,3,13,Loyal
8964,89,12,4444.94,4,4,5,13,Champions
8965,739,10,801.52,1,3,1,5,Regulars
8966,36,6,2590.99,5,1,5,11,Big Spenders
8967,160,10,2009.15,3,3,4,10,Big Spenders
8968,220,17,3084.35,3,5,5,13,Big Spenders
8969,602,9,982.4200000000001,1,2,2,5,Hibernating
8970,175,8,1129.41,3,2,2,7,Regulars
8971,65,12,2918.4900000000002,5,4,5,14,Champions
8972,96,9,1410.42,4,2,3,9,Regulars
8973,264,9,827.22,2,2,1,5,Hibernating
8974,166,6,998.14,3,1,2,6,Regulars
8975,174,14,2430.5,3,5,4,12,Big Spenders
8976,19,11,1382.29,5,3,3,11,Loyal
8977,858,8,2363.31,1,2,4,7,Regulars
8978,11,10,1176.75,5,3,2,10,Loyal
8979,238,5,542.29,3,1,1,5,Regulars
8980,145,13,1178.84,4,4,2,10,Loyal
8981,46,11,1144.24,5,3,2,10,Loyal
8982,78,10,528.3299999999999,4,3,1,8,Loyal
8983,351,10,3192.77,2,3,5,10,Regulars
8984,161,14,2125.6,3,5,4,12,Big Spenders
8985,508,13,1228.53,1,4,2,7,At Risk
8986,237,9,4002.5699999999997,3,2,5,10,Big Spenders
8987,47,18,2269.23,5,5,4,14,Champions
8988,613,8,573.05,1,2,1,4,Hibernating
8989,306,14,4900.1900000000005,2,5,5,12,At Risk
8990,607,5,759.38,1,1,1,3,Hibernating
8991,127,10,897.78,4,3,2,9,Loyal
8992,16,16,3187.92,5,5,5,15,Champions
8993,202,11,983.07,3,3,2,8,Regulars
8994,234,14,1640.07,3,5,3,11,Regulars
8995,274,8,427.65,2,2,1,5,Hibernating
8996,110,11,1431.29,4,3,3,10,Loyal
8997,147,13,2722.65,4,4,5,13,Champions
8998,82,10,2028.9,4,3,4,11,Loyal
8999,261,6,515.92,2,1,1,4,Hibernating
9000,45,11,953.12,5,3,2,10,Loyal
9001,715,8,1883.04,1,2,4,7,Regulars
9002,154,11,1597.7,3,3,3,9,Regulars
9003,286,13,1780.4099999999999,2,4,4,10,At Risk
9004,368,16,3153.44,2,5,5,12,At Risk
9005,0,10,1624.48,5,3,3,11,Loyal
9006,269,7,828.0,2,1,1,4,Hibernating
9007,278,9,1911.06,2,2,4,8,Regulars
9008,203,9,4298.66,3,2,5,10,Big Spenders
9009,188,6,571.0,3,1,1,5,Regulars
9010,381,12,2429.73,2,4,4,10,At Risk
9011,522,6,863.03,1,1,2,4,Hibernating
9012,135,13,2544.33,4,4,4,12,Champions
9013,69,16,1645.81,4,5,3,12,Loyal
9014,416,11,2556.3900000000003,2,3,4,9,Regulars
9015,507,12,1290.26,1,4,3,8,At Risk
9016,18,17,3915.12,5,5,5,15,Champions
9017,773,12,2031.56,1,4,4,9,At Risk
9018,65,12,2941.13,5,4,5,14,Champions
9019,399,9,3440.85,2,2,5,9,Regulars
9020,280,11,1342.71,2,3,3,8,Regulars
9021,23,15,3476.21,5,5,5,15,Champions
9022,111,13,2630.89,4,4,5,13,Champions
9023,88,11,845.09,4,3,2,9,Loyal
9024,60,9,3347.59,5,2,5,12,Big Spenders
9025,60,10,1968.3600000000001,5,3,4,12,Loyal
9026,568,9,1070.51,1,2,2,5,Hibernating
9027,60,15,1874.35,5,5,4,14,Champions
9028,414,10,561.6899999999999,2,3,1,6,Regulars
9029,395,12,7339.79,2,4,5,11,At Risk
9030,666,10,1597.78,1,3,3,7,Regulars
9031,453,15,1586.03,2,5,3,10,At Risk
9032,103,18,2453.16,4,5,4,13,Champions
9033,613,10,1132.42,1,3,2,6,Regulars
9034,119,12,2870.1400000000003,4,4,5,13,Champions
9035,607,10,1427.23,1,3,3,7,Regulars
9036,48,9,2524.71,5,2,4,11,Big Spenders
9037,643,7,698.1,1,1,1,3,Hibernating
9038,887,8,657.8000000000001,1,2,1,4,Hibernating
9039,31,12,927.21,5,4,2,11,Loyal
9040,184,11,1205.98,3,3,2,8,Regulars
9041,415,9,584.6600000000001,2,2,1,5,Hibernating
9042,183,11,747.69,3,3,1,7,Regulars
9043,5,12,3528.19,5,4,5,14,Champions
9044,70,8,654.87,4,2,1,7,Regulars
9045,204,16,2472.9,3,5,4,12,Big Spenders
9046,417,13,2385.45,2,4,4,10,At Risk
9047,396,9,2165.84,2,2,4,8,Regulars
9048,803,12,2992.12,1,4,5,10,At Risk
9049,226,16,3504.79,3,5,5,13,Big Spenders
9050,2,11,1466.31,5,3,3,11,Loyal
9051,145,6,2517.7,4,1,4,9,Big Spenders
9052,65,7,743.96,5,1,1,7,Regulars
9053,237,9,754.12,3,2,1,6,Regulars
9054,149,9,1374.54,3,2,3,8,Regulars
9055,36,13,2169.25,5,4,4,13,Champions
9056,209,10,1328.21,3,3,3,9,Regulars
9057,365,7,1801.0299999999997,2,1,4,7,Regulars
9058,36,11,946.0300000000001,5,3,2,10,Loyal
9059,935,6,577.24,1,1,1,3,Hibernating
9060,64,8,3208.82,5,2,5,12,Big Spenders
9061,134,11,795.84,4,3,1,8,Loyal
9062,271,15,2046.73,2,5,4,11,At Risk
9063,173,10,1235.26,3,3,2,8,Regulars
9064,63,11,2068.98,5,3,4,12,Loyal
9065,396,9,1113.83,2,2,2,6,Hibernating
9066,20,11,4044.8999999999996,5,3,5,13,Loyal
9067,27,17,1679.33,5,5,3,13,Loyal
9068,123,9,2478.75,4,2,4,10,Big Spenders
9069,31,15,1339.09,5,5,3,13,Loyal
9070,504,9,990.64,1,2,2,5,Hibernating
9071,65,11,1756.9,5,3,4,12,Loyal
9072,33,13,3517.71,5,4,5,14,Champions
9073,900,7,1500.19,1,1,3,5,Regulars
9074,7,9,1480.0,5,2,3,10,Regulars
9075,57,20,2043.1,5,5,4,14,Champions
9076,46,16,2192.6800000000003,5,5,4,14,Champions
9077,17,9,830.17,5,2,1,8,Regulars
9078,595,10,1903.1100000000001,1,3,4,8,Regulars
9079,1264,5,842.1800000000001,1,1,1,3,Hibernating
9080,184,9,1280.83,3,2,3,8,Regulars
9081,1070,9,2718.55,1,2,5,8,Regulars
9082,400,14,7105.45,2,5,5,12,At Risk
9083,103,14,1514.35,4,5,3,12,Loyal
9084,300,11,1052.1,2,3,2,7,Regulars
9085,319,9,1460.06,2,2,3,7,Regulars
9086,754,7,497.1,1,1,1,3,Hibernating
9087,21,11,2892.7799999999997,5,3,5,13,Loyal
9088,725,8,797.09,1,2,1,4,Hibernating
9089,102,11,3605.1600000000003,4,3,5,12,Loyal
9090,26,12,1606.28,5,4,3,12,Loyal
9091,445,12,878.76,2,4,2,8,At Risk
9092,30,14,1095.0,5,5,2,12,Loyal
9093,514,11,1700.2800000000002,1,3,3,7,Regulars
9094,718,4,948.8900000000001,1,1,2,4,Hibernating
9095,67,7,1576.35,4,1,3,8,Regulars
9096,133,12,1620.46,4,4,3,11,Loyal
9097,281,10,2612.42,2,3,5,10,Regulars
9098,13,15,2092.72,5,5,4,14,Champions
9099,157,6,2002.25,3,1,4,8,Big Spenders
9100,156,8,1349.8899999999999,3,2,3,8,Regulars
9101,272,17,3562.17,2,5,5,12,At Risk
9102,220,17,2028.96,3,5,4,12,Big Spenders
9103,81,10,844.9000000000001,4,3,2,9,Loyal
9104,54,8,403.08,5,2,1,8,Regulars
9105,121,13,1187.6999999999998,4,4,2,10,Loyal
9106,171,12,3083.65,3,4,5,12,Big Spenders
9107,496,12,1444.46,1,4,3,8,At Risk
9108,38,19,2967.67,5,5,5,15,Champions
9109,82,10,1520.03,4,3,3,10,Loyal
9110,7,18,3346.04,5,5,5,15,Champions
9111,328,6,477.5,2,1,1,4,Hibernating
9112,195,7,335.71999999999997,3,1,1,5,Regulars
9113,74,6,552.55,4,1,1,6,Regulars
9114,436,6,514.4,2,1,1,4,Hibernating
9115,32,11,3191.52,5,3,5,13,Loyal
9116,549,13,1434.01,1,4,3,8,At Risk
9117,497,11,4627.759999999999,1,3,5,9,Regulars
9118,6,12,1475.01,5,4,3,12,Loyal
9119,175,10,1172.98,3,3,2,8,Regulars
9120,1343,7,1151.4199999999998,1,1,2,4,Hibernating
9121,55,11,2626.87,5,3,5,13,Loyal
9122,23,6,521.71,5,1,1,7,Regulars
9123,175,11,1120.59,3,3,2,8,Regulars
9124,82,16,5946.57,4,5,5,14,Champions
9125,110,6,2557.69,4,1,4,9,Big Spenders
9126,779,10,2830.69,1,3,5,9,Regulars
9127,79,8,729.2800000000001,4,2,1,7,Regulars
9128,390,8,1134.59,2,2,2,6,Hibernating
9129,312,13,1635.3,2,4,3,9,At Risk
9130,128,16,5328.38,4,5,5,14,Champions
9131,250,7,1320.3899999999999,2,1,3,6,Regulars
9132,668,16,1388.6299999999999,1,5,3,9,At Risk
9133,472,10,3954.8,1,3,5,9,Regulars
9134,76,13,3214.6800000000003,4,4,5,13,Champions
9135,4,9,2330.68,5,2,4,11,Big Spenders
9136,192,11,991.63,3,3,2,8,Regulars
9137,65,7,1286.21,5,1,3,9,Regulars
9138,6,9,2079.2999999999997,5,2,4,11,Big Spenders
9139,207,10,1542.84,3,3,3,9,Regulars
9140,128,13,1366.65,4,4,3,11,Loyal
9141,113,13,1131.34,4,4,2,10,Loyal
9142,125,10,1112.95,4,3,2,9,Loyal
9143,175,8,1048.3,3,2,2,7,Regulars
9144,81,14,3237.89,4,5,5,14,Champions
9145,72,10,2004.3999999999999,4,3,4,11,Loyal
9146,52,10,1725.01,5,3,3,11,Loyal
9147,633,11,660.01,1,3,1,5,Regulars
9148,82,9,1387.29,4,2,3,9,Regulars
9149,271,15,2174.38,2,5,4,11,At Risk
9150,421,13,2036.8899999999999,2,4,4,10,At Risk
9151,75,14,1777.72,4,5,4,13,Champions
9152,233,10,1894.29,3,3,4,10,Big Spenders
9153,153,11,3448.01,3,3,5,11,Big Spenders
9154,732,7,761.74,1,1,1,3,Hibernating
9155,94,17,3105.88,4,5,5,14,Champions
9156,217,8,2195.24,3,2,4,9,Big Spenders
9157,288,10,1930.1499999999999,2,3,4,9,Regulars
9158,399,8,1575.03,2,2,3,7,Regulars
9159,349,5,635.5699999999999,2,1,1,4,Hibernating
9160,17,12,1353.81,5,4,3,12,Loyal
9161,231,5,725.31,3,1,1,5,Regulars
9162,118,8,2254.34,4,2,4,10,Big Spenders
9163,306,18,6707.030000000001,2,5,5,12,At Risk
9164,314,7,1551.6299999999999,2,1,3,6,Regulars
9165,473,13,5669.780000000001,1,4,5,10,At Risk
9166,217,10,369.19,3,3,1,7,Regulars
9167,168,12,2046.96,3,4,4,11,Big Spenders
9168,264,11,1136.94,2,3,2,7,Regulars
9169,49,13,2842.55,5,4,5,14,Champions
9170,309,9,5382.110000000001,2,2,5,9,Regulars
9171,3,7,875.83,5,1,2,8,Regulars
9172,274,12,1275.56,2,4,3,9,At Risk
9173,213,10,1481.8000000000002,3,3,3,9,Regulars
9174,375,8,872.3399999999999,2,2,2,6,Hibernating
9175,165,15,1799.3,3,5,4,12,Big Spenders
9176,142,8,1889.91,4,2,4,10,Big Spenders
9177,666,7,468.02,1,1,1,3,Hibernating
9178,573,9,1692.82,1,2,3,6,Regulars
9179,425,8,2262.57,2,2,4,8,Regulars
9180,61,9,1076.57,5,2,2,9,Regulars
9181,83,11,3684.47,4,3,5,12,Loyal
9182,43,11,1681.16,5,3,3,11,Loyal
9183,931,14,3440.47,1,5,5,11,At Risk
9184,669,10,2251.23,1,3,4,8,Regulars
9185,169,12,2421.59,3,4,4,11,Big Spenders
9186,305,10,1727.69,2,3,4,9,Regulars
9187,761,9,1304.57,1,2,3,6,Regulars
9188,22,10,697.29,5,3,1,9,Loyal
9189,118,13,3171.8599999999997,4,4,5,13,Champions
9190,47,11,3449.2,5,3,5,13,Loyal
9191,302,18,2447.44,2,5,4,11,At Risk
9192,442,11,1309.8600000000001,2,3,3,8,Regulars
9193,4,6,1250.47,5,1,3,9,Regulars
9194,57,19,4313.179999999999,5,5,5,15,Champions
9195,18,12,2091.94,5,4,4,13,Champions
9196,52,9,3221.19,5,2,5,12,Big Spenders
9197,4,10,1324.07,5,3,3,11,Loyal
9198,427,17,1826.64,2,5,4,11,At Risk
9199,145,9,1099.43,4,2,2,8,Regulars
9200,523,6,396.52,1,1,1,3,Hibernating
9201,255,13,1562.26,2,4,3,9,At Risk
9202,75,5,1688.0,4,1,3,8,Regulars
9203,46,10,1104.6000000000001,5,3,2,10,Loyal
9204,112,10,3625.3100000000004,4,3,5,12,Loyal
9205,105,13,1158.52,4,4,2,10,Loyal
9206,1,11,4225.61,5,3,5,13,Loyal
9207,1,11,1947.6200000000001,5,3,4,12,Loyal
9208,97,22,3477.94,4,5,5,14,Champions
9209,57,8,2165.18,5,2,4,11,Big Spenders
9210,538,6,2133.96,1,1,4,6,Regulars
9211,352,6,975.24,2,1,2,5,Hibernating
9212,441,8,848.8599999999999,2,2,2,6,Hibernating
9213,187,4,247.44,3,1,1,5,Regulars
9214,41,13,1494.84,5,4,3,12,Loyal
9215,90,7,396.46999999999997,4,1,1,6,Regulars
9216,649,6,459.13,1,1,1,3,Hibernating
9217,154,15,3888.37,3,5,5,13,Big Spenders
9218,235,13,1624.79,3,4,3,10,Regulars
9219,702,11,2024.15,1,3,4,8,Regulars
9220,33,5,624.79,5,1,1,7,Regulars
9221,342,11,1511.24,2,3,3,8,Regulars
9222,12,13,1160.48,5,4,2,11,Loyal
9223,153,9,1441.46,3,2,3,8,Regulars
9224,74,13,3558.5299999999997,4,4,5,13,Champions
9225,60,12,1536.3799999999999,5,4,3,12,Loyal
9226,201,13,1275.67,3,4,3,10,Regulars
9227,22,11,2909.56,5,3,5,13,Loyal
9228,916,5,3598.11,1,1,5,7,Regulars
9229,279,6,3926.9400000000005,2,1,5,8,Regulars
9230,832,7,2203.15,1,1,4,6,Regulars
9231,107,7,903.98,4,1,2,7,Regulars
9232,112,11,2819.12,4,3,5,12,Loyal
9233,176,13,4622.78,3,4,5,12,Big Spenders
9234,66,9,767.63,4,2,1,7,Regulars
9235,54,10,2486.5,5,3,4,12,Loyal
9236,173,8,1998.53,3,2,4,9,Big Spenders
9237,263,9,1005.1899999999999,2,2,2,6,Hibernating
9238,520,6,1103.04,1,1,2,4,Hibernating
9239,223,12,3006.86,3,4,5,12,Big Spenders
9240,330,5,484.22,2,1,1,4,Hibernating
9241,50,11,472.43,5,3,1,9,Loyal
9242,228,14,2132.4,3,5,4,12,Big Spenders
9243,261,16,4868.67,2,5,5,12,At Risk
9244,342,9,435.03999999999996,2,2,1,5,Hibernating
9245,37,10,1167.37,5,3,2,10,Loyal
9246,53,11,1287.9,5,3,3,11,Loyal
9247,557,8,570.56,1,2,1,4,Hibernating
9248,140,14,3404.37,4,5,5,14,Champions
9249,104,7,1219.11,4,1,2,7,Regulars
9250,85,12,839.88,4,4,1,9,Loyal
9251,251,9,2155.64,2,2,4,8,Regulars
9252,4,16,3653.24,5,5,5,15,Champions
9253,318,8,531.54,2,2,1,5,Hibernating
9254,46,11,1217.53,5,3,2,10,Loyal
9255,194,13,1721.6200000000001,3,4,3,10,Regulars
9256,350,7,909.4299999999998,2,1,2,5,Hibernating
9257,219,10,1485.13,3,3,3,9,Regulars
9258,173,10,866.88,3,3,2,8,Regulars
9259,765,7,3161.0,1,1,5,7,Regulars
9260,255,8,1542.96,2,2,3,7,Regulars
9261,204,6,2745.36,3,1,5,9,Big Spenders
9262,148,9,3183.34,3,2,5,10,Big Spenders
9263,321,10,1116.63,2,3,2,7,Regulars
9264,108,13,1864.65,4,4,4,12,Champions
9265,244,14,2053.16,3,5,4,12,Big Spenders
9266,235,16,4049.7300000000005,3,5,5,13,Big Spenders
9267,204,8,2562.52,3,2,4,9,Big Spenders
9268,73,8,660.0600000000001,4,2,1,7,Regulars
9269,108,8,1454.27,4,2,3,9,Regulars
9270,534,4,1677.19,1,1,3,5,Regulars
9271,208,12,1303.67,3,4,3,10,Regulars
9272,95,9,2477.6,4,2,4,10,Big Spenders
9273,970,7,679.24,1,1,1,3,Hibernating
9274,508,12,1502.54,1,4,3,8,At Risk
9275,59,13,1562.01,5,4,3,12,Loyal
9276,718,11,1060.43,1,3,2,6,Regulars
9277,250,9,872.3,2,2,2,6,Hibernating
9278,15,8,2501.44,5,2,4,11,Big Spenders
9279,258,10,1335.58,2,3,3,8,Regulars
9280,62,8,962.27,5,2,2,9,Regulars
9281,545,7,3715.92,1,1,5,7,Regulars
9282,844,11,2767.48,1,3,5,9,Regulars
9283,48,9,4590.32,5,2,5,12,Big Spenders
9284,113,18,2381.25,4,5,4,13,Champions
9285,362,5,409.47,2,1,1,4,Hibernating
9286,5,7,705.05,5,1,1,7,Regulars
9287,788,6,737.19,1,1,1,3,Hibernating
9288,22,17,3238.23,5,5,5,15,Champions
9289,196,4,372.95000000000005,3,1,1,5,Regulars
9290,480,9,735.18,1,2,1,4,Hibernating
9291,100,11,959.91,4,3,2,9,Loyal
9292,99,9,1326.07,4,2,3,9,Regulars
9293,586,10,962.4200000000001,1,3,2,6,Regulars
9294,504,10,1277.06,1,3,3,7,Regulars
9295,907,6,495.06,1,1,1,3,Hibernating
9296,67,17,1673.97,4,5,3,12,Loyal
9297,449,11,1505.29,2,3,3,8,Regulars
9298,8,6,3080.38,5,1,5,11,Big Spenders
9299,360,11,3962.4100000000003,2,3,5,10,Regulars
9300,545,7,549.44,1,1,1,3,Hibernating
9301,104,17,3037.31,4,5,5,14,Champions
9302,64,15,1646.33,5,5,3,13,Loyal
9303,272,10,2643.56,2,3,5,10,Regulars
9304,31,16,4524.3099999999995,5,5,5,15,Champions
9305,172,11,1419.34,3,3,3,9,Regulars
9306,165,15,3656.75,3,5,5,13,Big Spenders
9307,573,9,482.69,1,2,1,4,Hibernating
9308,54,6,574.86,5,1,1,7,Regulars
9309,451,12,2708.08,2,4,5,11,At Risk
9310,0,15,3079.0,5,5,5,15,Champions
9311,75,12,1732.23,4,4,4,12,Champions
9312,146,16,1589.72,4,5,3,12,Loyal
9313,99,14,1412.23,4,5,3,12,Loyal
9314,507,10,1899.0,1,3,4,8,Regulars
9315,71,7,557.7,4,1,1,6,Regulars
9316,253,15,2439.25,2,5,4,11,At Risk
9317,96,13,1411.53,4,4,3,11,Loyal
9318,480,11,797.1999999999999,1,3,1,5,Regulars
9319,169,9,1852.53,3,2,4,9,Big Spenders
9320,542,5,434.22,1,1,1,3,Hibernating
9321,97,10,1664.0900000000001,4,3,3,10,Loyal
9322,569,5,395.77,1,1,1,3,Hibernating
9323,208,5,263.03,3,1,1,5,Regulars
9324,1762,5,398.71,1,1,1,3,Hibernating
9325,184,14,3349.4100000000003,3,5,5,13,Big Spenders
9326,1,12,1626.4099999999999,5,4,3,12,Loyal
9327,47,13,2534.87,5,4,4,13,Champions
9328,26,11,828.91,5,3,1,9,Loyal
9329,124,12,2941.91,4,4,5,13,Champions
9330,174,7,719.02,3,1,1,5,Regulars
9331,21,14,1885.54,5,5,4,14,Champions
9332,238,6,505.28000000000003,3,1,1,5,Regulars
9333,37,13,2442.43,5,4,4,13,Champions
9334,1,11,2898.16,5,3,5,13,Loyal
9335,118,13,2042.1799999999998,4,4,4,12,Champions
9336,561,12,1046.75,1,4,2,7,At Risk
9337,70,10,825.31,4,3,1,8,Loyal
9338,144,9,1354.17,4,2,3,9,Regulars
9339,69,10,774.65,4,3,1,8,Loyal
9340,1195,1,67.07000000000001,1,1,1,3,Hibernating
9341,107,9,3917.81,4,2,5,11,Big Spenders
9342,305,13,1590.07,2,4,3,9,At Risk
9343,128,13,2384.54,4,4,4,12,Champions
9344,555,13,3675.46,1,4,5,10,At Risk
9345,145,10,1036.87,4,3,2,9,Loyal
9346,229,15,3985.29,3,5,5,13,Big Spenders
9347,589,8,1134.8999999999999,1,2,2,5,Hibernating
9348,50,16,1344.74,5,5,3,13,Loyal
9349,102,10,652.04,4,3,1,8,Loyal
9350,1056,5,446.5,1,1,1,3,Hibernating
9351,390,6,480.58,2,1,1,4,Hibernating
9352,125,16,7736.49,4,5,5,14,Champions
9353,361,9,1862.1,2,2,4,8,Regulars
9354,65,12,1348.01,5,4,3,12,Loyal
9355,109,10,809.86,4,3,1,8,Loyal
9356,503,10,1096.86,1,3,2,6,Regulars
9357,237,10,1094.1399999999999,3,3,2,8,Regulars
9358,87,13,1535.1499999999999,4,4,3,11,Loyal
9359,57,8,1861.1599999999999,5,2,4,11,Big Spenders
9360,551,11,2494.05,1,3,4,8,Regulars
9361,106,9,1839.35,4,2,4,10,Big Spenders
9362,21,12,3486.0499999999997,5,4,5,14,Champions
9363,218,12,1516.54,3,4,3,10,Regulars
9364,659,8,921.98,1,2,2,5,Hibernating
9365,243,13,2951.0299999999997,3,4,5,12,Big Spenders
9366,6,10,867.46,5,3,2,10,Loyal
9367,350,9,2937.49,2,2,5,9,Regulars
9368,228,10,1042.34,3,3,2,8,Regulars
9369,363,10,1584.94,2,3,3,8,Regulars
9370,29,17,1727.83,5,5,4,14,Champions
9371,45,10,787.3000000000001,5,3,1,9,Loyal
9372,349,11,2207.66,2,3,4,9,Regulars
9373,261,7,1388.28,2,1,3,6,Regulars
9374,47,11,1518.51,5,3,3,11,Loyal
9375,94,15,3559.4900000000002,4,5,5,14,Champions
9376,192,10,732.39,3,3,1,7,Regulars
9377,42,11,2560.81,5,3,4,12,Loyal
9378,104,15,4582.2699999999995,4,5,5,14,Champions
9379,307,15,2053.2999999999997,2,5,4,11,At Risk
9380,35,8,2143.28,5,2,4,11,Big Spenders
9381,188,10,840.8100000000001,3,3,1,7,Regulars
9382,685,11,2130.85,1,3,4,8,Regulars
9383,6,12,2866.26,5,4,5,14,Champions
9384,731,9,1753.4700000000003,1,2,4,7,Regulars
9385,180,12,954.03,3,4,2,9,Regulars
9386,73,11,1291.4099999999999,4,3,3,10,Loyal
9387,84,8,2491.88,4,2,4,10,Big Spenders
9388,368,7,3604.85,2,1,5,8,Regulars
9389,23,7,644.23,5,1,1,7,Regulars
9390,48,12,2308.58,5,4,4,13,Champions
9391,84,8,515.55,4,2,1,7,Regulars
9392,208,5,816.09,3,1,1,5,Regulars
9393,181,19,5279.7699999999995,3,5,5,13,Big Spenders
9394,268,13,2360.5,2,4,4,10,At Risk
9395,10,9,2802.81,5,2,5,12,Big Spenders
9396,335,16,3320.88,2,5,5,12,At Risk
9397,437,7,2506.5699999999997,2,1,4,7,Regulars
9398,141,8,1191.85,4,2,2,8,Regulars
9399,629,13,1634.71,1,4,3,8,At Risk
9400,217,8,1160.01,3,2,2,7,Regulars
9401,473,5,1240.58,1,1,2,4,Hibernating
9402,101,12,1781.43,4,4,4,12,Champions
9403,99,7,1283.2,4,1,3,8,Regulars
9404,193,9,1222.98,3,2,2,7,Regulars
9405,245,10,2495.7,3,3,4,10,Big Spenders
9406,1380,4,335.89000000000004,1,1,1,3,Hibernating
9407,151,8,1317.82,3,2,3,8,Regulars
9408,306,15,5526.57,2,5,5,12,At Risk
9409,110,11,2406.77,4,3,4,11,Loyal
9410,565,16,2473.0699999999997,1,5,4,10,At Risk
9411,584,3,189.06,1,1,1,3,Hibernating
9412,541,17,3496.2,1,5,5,11,At Risk
9413,98,13,2964.2,4,4,5,13,Champions
9414,74,9,954.9799999999999,4,2,2,8,Regulars
9415,237,9,732.83,3,2,1,6,Regulars
9416,108,10,2870.8500000000004,4,3,5,12,Loyal
9417,55,12,2368.92,5,4,4,13,Champions
9418,208,13,2177.0699999999997,3,4,4,11,Big Spenders
9419,285,13,1138.25,2,4,2,8,At Risk
9420,197,12,1338.3500000000001,3,4,3,10,Regulars
9421,23,6,2849.2,5,1,5,11,Big Spenders
9422,139,6,620.44,4,1,1,6,Regulars
9423,232,11,976.89,3,3,2,8,Regulars
9424,52,12,1528.69,5,4,3,12,Loyal
9425,438,11,1774.54,2,3,4,9,Regulars
9426,331,14,1203.12,2,5,2,9,At Risk
9427,87,18,2191.32,4,5,4,13,Champions
9428,67,11,1452.3700000000001,4,3,3,10,Loyal
9429,54,7,588.37,5,1,1,7,Regulars
9430,7,15,1681.25,5,5,3,13,Loyal
9431,206,9,1688.3300000000002,3,2,3,8,Regulars
9432,23,10,813.76,5,3,1,9,Loyal
9433,209,10,1347.19,3,3,3,9,Regulars
9434,95,14,2750.74,4,5,5,14,Champions
9435,146,12,1235.46,4,4,2,10,Loyal
9436,161,7,505.9,3,1,1,5,Regulars
9437,175,12,1323.43,3,4,3,10,Regulars
9438,397,7,473.21000000000004,2,1,1,4,Hibernating
9439,271,9,1226.61,2,2,2,6,Hibernating
9440,215,9,1506.6000000000001,3,2,3,8,Regulars
9441,14,13,2027.63,5,4,4,13,Champions
9442,202,16,1054.25,3,5,2,10,Regulars
9443,369,5,1204.71,2,1,2,5,Hibernating
9444,146,11,1064.06,4,3,2,9,Loyal
9445,168,11,1981.4699999999998,3,3,4,10,Big Spenders
9446,672,5,321.91999999999996,1,1,1,3,Hibernating
9447,85,10,1634.73,4,3,3,10,Loyal
9448,217,8,645.28,3,2,1,6,Regulars
9449,208,15,2363.69,3,5,4,12,Big Spenders
9450,386,9,518.59,2,2,1,5,Hibernating
9451,272,15,1428.15,2,5,3,10,At Risk
9452,562,9,2676.2700000000004,1,2,5,8,Regulars
9453,456,8,1026.32,2,2,2,6,Hibernating
9454,474,13,1984.7299999999998,1,4,4,9,At Risk
9455,209,11,927.52,3,3,2,8,Regulars
9456,151,14,1034.29,3,5,2,10,Regulars
9457,27,17,7525.78,5,5,5,15,Champions
9458,17,12,1836.44,5,4,4,13,Champions
9459,51,13,1649.67,5,4,3,12,Loyal
9460,539,14,2198.44,1,5,4,10,At Risk
9461,72,7,573.8299999999999,4,1,1,6,Regulars
9462,44,8,1005.9,5,2,2,9,Regulars
9463,55,16,3292.44,5,5,5,15,Champions
9464,69,15,2633.87,4,5,5,14,Champions
9465,619,12,1991.8600000000001,1,4,4,9,At Risk
9466,251,15,2626.27,2,5,5,12,At Risk
9467,750,7,942.02,1,1,2,4,Hibernating
9468,326,11,823.13,2,3,1,6,Regulars
9469,79,8,869.68,4,2,2,8,Regulars
9470,54,15,4145.92,5,5,5,15,Champions
9471,579,7,1143.07,1,1,2,4,Hibernating
9472,701,10,1450.25,1,3,3,7,Regulars
9473,323,13,2560.0299999999997,2,4,4,10,At Risk
9474,174,10,1039.11,3,3,2,8,Regulars
9475,21,11,1834.28,5,3,4,12,Loyal
9476,86,19,3378.23,4,5,5,14,Champions
9477,262,12,1198.21,2,4,2,8,At Risk
9478,159,12,2809.25,3,4,5,12,Big Spenders
9479,155,8,896.38,3,2,2,7,Regulars
9480,218,11,3542.18,3,3,5,11,Big Spenders
9481,400,12,1180.44,2,4,2,8,At Risk
9482,381,14,1533.89,2,5,3,10,At Risk
9483,437,9,2498.12,2,2,4,8,Regulars
9484,196,7,418.7,3,1,1,5,Regulars
9485,34,8,578.0,5,2,1,8,Regulars
9486,66,14,3148.34,4,5,5,14,Champions
9487,39,12,2685.29,5,4,5,14,Champions
9488,256,9,1956.35,2,2,4,8,Regulars
9489,176,14,2087.4900000000002,3,5,4,12,Big Spenders
9490,102,5,407.65,4,1,1,6,Regulars
9491,50,13,2324.19,5,4,4,13,Champions
9492,290,11,1871.5,2,3,4,9,Regulars
9493,72,11,2748.44,4,3,5,12,Loyal
9494,400,9,1132.91,2,2,2,6,Hibernating
9495,18,12,2410.76,5,4,4,13,Champions
9496,818,11,824.34,1,3,1,5,Regulars
9497,42,7,1281.01,5,1,3,9,Regulars
9498,1140,9,1283.19,1,2,3,6,Regulars
9499,575,10,1215.03,1,3,2,6,Regulars
9500,129,8,3372.99,4,2,5,11,Big Spenders
9501,93,15,3011.38,4,5,5,14,Champions
9502,207,15,1423.19,3,5,3,11,Regulars
9503,108,9,2576.05,4,2,5,11,Big Spenders
9504,420,13,5237.54,2,4,5,11,At Risk
9505,100,13,1882.91,4,4,4,12,Champions
9506,73,10,1149.72,4,3,2,9,Loyal
9507,124,18,3201.51,4,5,5,14,Champions
9508,59,8,1939.94,5,2,4,11,Big Spenders
9509,1378,9,1011.5600000000001,1,2,2,5,Hibernating
9510,303,8,830.98,2,2,1,5,Hibernating
9511,111,11,1260.76,4,3,3,10,Loyal
9512,3,16,2037.09,5,5,4,14,Champions
9513,352,10,713.5799999999999,2,3,1,6,Regulars
9514,299,13,1533.4299999999998,2,4,3,9,At Risk
9515,677,3,196.18,1,1,1,3,Hibernating
9516,91,6,670.19,4,1,1,6,Regulars
9517,46,9,4508.66,5,2,5,12,Big Spenders
9518,66,7,567.9399999999999,4,1,1,6,Regulars
9519,172,4,1492.12,3,1,3,7,Regulars
9520,531,12,848.31,1,4,2,7,At Risk
9521,243,11,1171.88,3,3,2,8,Regulars
9522,99,8,632.4300000000001,4,2,1,7,Regulars
9523,455,13,4179.88,2,4,5,11,At Risk
9524,107,12,2326.76,4,4,4,12,Champions
9525,309,17,3084.2799999999997,2,5,5,12,At Risk
9526,407,8,839.62,2,2,1,5,Hibernating
9527,181,16,4092.5299999999997,3,5,5,13,Big Spenders
9528,209,11,2776.88,3,3,5,11,Big Spenders
9529,464,7,857.6400000000001,1,1,2,4,Hibernating
9530,294,13,3521.1699999999996,2,4,5,11,At Risk
9531,708,13,1180.01,1,4,2,7,At Risk
9532,119,10,1333.11,4,3,3,10,Loyal
9533,348,8,1106.98,2,2,2,6,Hibernating
9534,20,8,945.3199999999999,5,2,2,9,Regulars
9535,192,8,1247.8700000000001,3,2,3,8,Regulars
9536,299,11,1637.1,2,3,3,8,Regulars
9537,187,9,681.45,3,2,1,6,Regulars
9538,63,9,1219.33,5,2,2,9,Regulars
9539,74,3,224.07999999999998,4,1,1,6,Regulars
9540,34,12,1884.9,5,4,4,13,Champions
9541,524,12,1635.23,1,4,3,8,At Risk
9542,186,10,666.04,3,3,1,7,Regulars
9543,196,10,885.2900000000001,3,3,2,8,Regulars
9544,339,13,3402.31,2,4,5,11,At Risk
9545,784,8,1665.6499999999999,1,2,3,6,Regulars
9546,929,4,629.8800000000001,1,1,1,3,Hibernating
9547,70,18,2441.96,4,5,4,13,Champions
9548,441,11,3853.55,2,3,5,10,Regulars
9549,95,6,968.59,4,1,2,7,Regulars
9550,310,7,2677.4900000000002,2,1,5,8,Regulars
9551,535,8,987.75,1,2,2,5,Hibernating
9552,369,9,775.64,2,2,1,5,Hibernating
9553,21,12,1782.48,5,4,4,13,Champions
9554,960,7,1428.17,1,1,3,5,Regulars
9555,212,14,2749.13,3,5,5,13,Big Spenders
9556,483,8,477.92,1,2,1,4,Hibernating
9557,244,8,3010.92,3,2,5,10,Big Spenders
9558,46,12,2195.15,5,4,4,13,Champions
9559,330,10,1699.6799999999998,2,3,3,8,Regulars
9560,1103,3,462.92999999999995,1,1,1,3,Hibernating
9561,415,12,1299.38,2,4,3,9,At Risk
9562,134,10,1483.02,4,3,3,10,Loyal
9563,218,8,479.3,3,2,1,6,Regulars
9564,393,12,1536.13,2,4,3,9,At Risk
9565,235,9,1723.1800000000003,3,2,3,8,Regulars
9566,45,16,2352.92,5,5,4,14,Champions
9567,56,12,1050.99,5,4,2,11,Loyal
9568,917,8,1417.82,1,2,3,6,Regulars
9569,138,14,2227.2799999999997,4,5,4,13,Champions
9570,293,20,2471.25,2,5,4,11,At Risk
9571,231,9,452.87,3,2,1,6,Regulars
9572,716,8,1200.09,1,2,2,5,Hibernating
9573,128,10,2753.58,4,3,5,12,Loyal
9574,46,10,3120.27,5,3,5,13,Loyal
9575,94,17,3705.17,4,5,5,14,Champions
9576,248,7,3253.86,2,1,5,8,Regulars
9577,23,8,3476.88,5,2,5,12,Big Spenders
9578,24,12,1229.45,5,4,2,11,Loyal
9579,1906,5,3003.18,1,1,5,7,Regulars
9580,117,15,1937.09,4,5,4,13,Champions
9581,166,11,5907.58,3,3,5,11,Big Spenders
9582,221,6,389.53,3,1,1,5,Regulars
9583,273,13,1812.53,2,4,4,10,At Risk
9584,785,12,1040.28,1,4,2,7,At Risk
9585,354,8,2148.89,2,2,4,8,Regulars
9586,509,7,1496.57,1,1,3,5,Regulars
9587,45,8,1200.95,5,2,2,9,Regulars
9588,218,12,3634.55,3,4,5,12,Big Spenders
9589,329,9,1800.22,2,2,4,8,Regulars
9590,342,5,564.5600000000001,2,1,1,4,Hibernating
9591,8,13,2183.13,5,4,4,13,Champions
9592,128,12,2420.16,4,4,4,12,Champions
9593,468,16,3348.68,1,5,5,11,At Risk
9594,610,7,1903.7199999999998,1,1,4,6,Regulars
9595,500,13,1692.97,1,4,3,8,At Risk
9596,522,8,649.99,1,2,1,4,Hibernating
9597,14,17,2592.84,5,5,5,15,Champions
9598,34,13,4414.570000000001,5,4,5,14,Champions
9599,13,8,881.69,5,2,2,9,Regulars
9600,399,5,982.6999999999998,2,1,2,5,Hibernating
9601,685,7,448.74,1,1,1,3,Hibernating
9602,129,10,1048.21,4,3,2,9,Loyal
9603,80,10,831.5699999999999,4,3,1,8,Loyal
9604,279,5,1026.69,2,1,2,5,Hibernating
9605,307,9,3213.69,2,2,5,9,Regulars
9606,199,10,3854.26,3,3,5,11,Big Spenders
9607,547,4,435.89,1,1,1,3,Hibernating
9608,352,11,676.45,2,3,1,6,Regulars
9609,239,11,4055.9300000000003,3,3,5,11,Big Spenders
9610,118,8,2622.13,4,2,5,11,Big Spenders
9611,24,13,6424.92,5,4,5,14,Champions
9612,760,8,907.27,1,2,2,5,Hibernating
9613,27,10,2935.1800000000003,5,3,5,13,Loyal
9614,120,10,809.02,4,3,1,8,Loyal
9615,875,11,822.0999999999999,1,3,1,5,Regulars
9616,95,8,369.65,4,2,1,7,Regulars
9617,426,9,1243.87,2,2,3,7,Regulars
9618,300,12,4510.17,2,4,5,11,At Risk
9619,353,7,984.97,2,1,2,5,Hibernating
9620,324,7,1124.29,2,1,2,5,Hibernating
9621,65,12,814.0600000000001,5,4,1,10,Loyal
9622,57,9,1345.63,5,2,3,10,Regulars
9623,113,8,1085.3899999999999,4,2,2,8,Regulars
9624,333,14,1559.6000000000001,2,5,3,10,At Risk
9625,61,11,870.28,5,3,2,10,Loyal
9626,284,9,1389.0,2,2,3,7,Regulars
9627,558,14,1789.1899999999998,1,5,4,10,At Risk
9628,1215,5,423.76,1,1,1,3,Hibernating
9629,126,11,727.82,4,3,1,8,Loyal
9630,310,9,1218.9199999999998,2,2,2,6,Hibernating
9631,118,13,1604.59,4,4,3,11,Loyal
9632,566,10,3046.82,1,3,5,9,Regulars
9633,73,8,594.3399999999999,4,2,1,7,Regulars
9634,2,14,3872.9300000000003,5,5,5,15,Champions
9635,178,12,1956.05,3,4,4,11,Big Spenders
9636,60,12,1496.1799999999998,5,4,3,12,Loyal
9637,15,7,1148.33,5,1,2,8,Regulars
9638,650,10,2746.55,1,3,5,9,Regulars
9639,180,7,1612.33,3,1,3,7,Regulars
9640,221,16,1862.33,3,5,4,12,Big Spenders
9641,143,11,1757.03,4,3,4,11,Loyal
9642,277,6,377.57,2,1,1,4,Hibernating
9643,167,12,2016.9099999999999,3,4,4,11,Big Spenders
9644,809,5,637.35,1,1,1,3,Hibernating
9645,611,4,1016.98,1,1,2,4,Hibernating
9646,175,8,382.86,3,2,1,6,Regulars
9647,233,6,4679.679999999999,3,1,5,9,Big Spenders
9648,758,7,886.8100000000001,1,1,2,4,Hibernating
9649,540,12,2760.1400000000003,1,4,5,10,At Risk
9650,456,11,1184.52,2,3,2,7,Regulars
9651,477,13,2746.9900000000002,1,4,5,10,At Risk
9652,762,4,412.07,1,1,1,3,Hibernating
9653,277,8,2236.41,2,2,4,8,Regulars
9654,0,13,1625.8,5,4,3,12,Loyal
9655,16,4,214.49,5,1,1,7,Regulars
9656,204,9,3255.46,3,2,5,10,Big Spenders
9657,149,9,1002.12,3,2,2,7,Regulars
9658,360,13,1543.39,2,4,3,9,At Risk
9659,15,11,3095.9500000000003,5,3,5,13,Loyal
9660,101,10,2649.25,4,3,5,12,Loyal
9661,143,12,2239.55,4,4,4,12,Champions
9662,243,10,1462.7,3,3,3,9,Regulars
9663,6,6,548.98,5,1,1,7,Regulars
9664,23,6,418.53,5,1,1,7,Regulars
9665,75,13,5045.62,4,4,5,13,Champions
9666,49,8,541.53,5,2,1,8,Regulars
9667,305,17,2329.8,2,5,4,11,At Risk
9668,163,11,2374.5299999999997,3,3,4,10,Big Spenders
9669,213,16,2151.59,3,5,4,12,Big Spenders
9670,248,11,1163.15,2,3,2,7,Regulars
9671,561,9,1517.8400000000001,1,2,3,6,Regulars
9672,274,6,833.84,2,1,1,4,Hibernating
9673,59,13,2390.73,5,4,4,13,Champions
9674,489,7,1135.67,1,1,2,4,Hibernating
9675,716,14,3428.94,1,5,5,11,At Risk
9676,495,10,3268.72,1,3,5,9,Regulars
9677,91,10,1184.24,4,3,2,9,Loyal
9678,102,7,300.40999999999997,4,1,1,6,Regulars
9679,1231,6,826.87,1,1,1,3,Hibernating
9680,95,10,2769.2599999999998,4,3,5,12,Loyal
9681,158,14,2998.11,3,5,5,13,Big Spenders
9682,52,11,2421.29,5,3,4,12,Loyal
9683,208,8,1630.8,3,2,3,8,Regulars
9684,124,14,3338.39,4,5,5,14,Champions
9685,108,7,2855.5099999999998,4,1,5,10,Big Spenders
9686,20,11,561.6,5,3,1,9,Loyal
9687,212,13,2145.79,3,4,4,11,Big Spenders
9688,180,13,2359.95,3,4,4,11,Big Spenders
9689,138,8,526.47,4,2,1,7,Regulars
9690,47,8,391.03999999999996,5,2,1,8,Regulars
9691,0,10,1070.59,5,3,2,10,Loyal
9692,248,12,2317.29,2,4,4,10,At Risk
9693,15,8,494.28000000000003,5,2,1,8,Regulars
9694,1011,7,820.05,1,1,1,3,Hibernating
9695,2,14,3912.44,5,5,5,15,Champions
9696,221,11,1098.6200000000001,3,3,2,8,Regulars
9697,15,9,2336.23,5,2,4,11,Big Spenders
9698,105,16,2804.21,4,5,5,14,Champions
9699,6,10,2340.4,5,3,4,12,Loyal
9700,751,6,531.23,1,1,1,3,Hibernating
9701,230,11,2125.38,3,3,4,10,Big Spenders
9702,178,11,1819.99,3,3,4,10,Big Spenders
9703,357,10,3088.94,2,3,5,10,Regulars
9704,487,8,2072.62,1,2,4,7,Regulars
9705,235,16,2497.8,3,5,4,12,Big Spenders
9706,237,12,1258.83,3,4,3,10,Regulars
9707,688,8,4069.72,1,2,5,8,Regulars
9708,497,14,1550.1599999999999,1,5,3,9,At Risk
9709,678,13,969.55,1,4,2,7,At Risk
9710,148,11,1713.0900000000001,3,3,3,9,Regulars
9711,96,12,1074.44,4,4,2,10,Loyal
9712,568,8,1155.55,1,2,2,5,Hibernating
9713,1,8,2350.14,5,2,4,11,Big Spenders
9714,505,6,435.44,1,1,1,3,Hibernating
9715,44,11,3317.34,5,3,5,13,Loyal
9716,192,10,1224.17,3,3,2,8,Regulars
9717,6,12,3843.7799999999997,5,4,5,14,Champions
9718,110,19,3261.8,4,5,5,14,Champions
9719,31,10,2289.26,5,3,4,12,Loyal
9720,115,8,1038.87,4,2,2,8,Regulars
9721,177,17,1688.6299999999999,3,5,3,11,Regulars
9722,121,19,4097.3,4,5,5,14,Champions
9723,249,7,379.90999999999997,2,1,1,4,Hibernating
9724,141,15,4036.8999999999996,4,5,5,14,Champions
9725,884,7,963.4499999999999,1,1,2,4,Hibernating
9726,54,12,1561.8,5,4,3,12,Loyal
9727,88,6,457.58,4,1,1,6,Regulars
9728,361,12,1917.37,2,4,4,10,At Risk
9729,572,13,2775.39,1,4,5,10,At Risk
9730,396,10,974.3000000000001,2,3,2,7,Regulars
9731,393,11,966.6,2,3,2,7,Regulars
9732,191,14,2012.78,3,5,4,12,Big Spenders
9733,838,11,2703.56,1,3,5,9,Regulars
9734,101,12,1252.32,4,4,3,11,Loyal
9735,553,12,1457.74,1,4,3,8,At Risk
9736,299,15,1439.59,2,5,3,10,At Risk
9737,112,11,2556.83,4,3,4,11,Loyal
9738,362,10,1030.11,2,3,2,7,Regulars
9739,169,10,3187.3199999999997,3,3,5,11,Big Spenders
9740,132,9,955.3499999999999,4,2,2,8,Regulars
9741,542,11,1154.48,1,3,2,6,Regulars
9742,506,10,1307.18,1,3,3,7,Regulars
9743,30,11,1959.9299999999998,5,3,4,12,Loyal
9744,168,13,2000.94,3,4,4,11,Big Spenders
9745,274,7,2456.8199999999997,2,1,4,7,Regulars
9746,174,11,907.49,3,3,2,8,Regulars
9747,14,5,868.84,5,1,2,8,Regulars
9748,187,8,1461.92,3,2,3,8,Regulars
9749,63,13,3664.81,5,4,5,14,Champions
9750,10,16,2404.63,5,5,4,14,Champions
9751,199,10,1321.42,3,3,3,9,Regulars
9752,220,10,2372.0,3,3,4,10,Big Spenders
9753,2,9,832.18,5,2,1,8,Regulars
9754,261,13,3490.9900000000002,2,4,5,11,At Risk
9755,121,9,5194.070000000001,4,2,5,11,Big Spenders
9756,50,16,1495.16,5,5,3,13,Loyal
9757,169,13,2125.66,3,4,4,11,Big Spenders
9758,95,7,1014.04,4,1,2,7,Regulars
9759,151,7,364.04999999999995,3,1,1,5,Regulars
9760,172,11,1662.97,3,3,3,9,Regulars
9761,705,11,3302.81,1,3,5,9,Regulars
9762,1,12,1048.33,5,4,2,11,Loyal
9763,255,10,1014.06,2,3,2,7,Regulars
9764,124,7,569.89,4,1,1,6,Regulars
9765,64,7,737.4599999999999,5,1,1,7,Regulars
9766,238,16,2455.54,3,5,4,12,Big Spenders
9767,287,13,2823.2799999999997,2,4,5,11,At Risk
9768,59,10,1052.8500000000001,5,3,2,10,Loyal
9769,193,7,479.36,3,1,1,5,Regulars
9770,25,6,842.71,5,1,1,7,Regulars
9771,99,11,2803.54,4,3,5,12,Loyal
9772,75,10,1358.56,4,3,3,10,Loyal
9773,23,8,1050.85,5,2,2,9,Regulars
9774,14,13,3357.02,5,4,5,14,Champions
9775,133,11,986.78,4,3,2,9,Loyal
9776,0,12,3427.12,5,4,5,14,Champions
9777,626,6,617.5999999999999,1,1,1,3,Hibernating
9778,110,14,3610.79,4,5,5,14,Champions
9779,40,10,1139.87,5,3,2,10,Loyal
9780,110,9,2008.02,4,2,4,10,Big Spenders
9781,138,14,1231.44,4,5,2,11,Loyal
9782,71,8,661.88,4,2,1,7,Regulars
9783,488,11,1276.7799999999997,1,3,3,7,Regulars
9784,148,15,2560.15,3,5,4,12,Big Spenders
9785,531,3,556.34,1,1,1,3,Hibernating
9786,312,12,2337.2,2,4,4,10,At Risk
9787,52,10,1444.45,5,3,3,11,Loyal
9788,553,9,1060.83,1,2,2,5,Hibernating
9789,139,13,2172.81,4,4,4,12,Champions
9790,319,7,651.14,2,1,1,4,Hibernating
9791,240,5,3226.91,3,1,5,9,Big Spenders
9792,102,8,2721.32,4,2,5,11,Big Spenders
9793,122,13,1995.89,4,4,4,12,Champions
9794,54,9,2318.12,5,2,4,11,Big Spenders
9795,337,8,1571.75,2,2,3,7,Regulars
9796,467,9,755.74,1,2,1,4,Hibernating
9797,90,11,2349.17,4,3,4,11,Loyal
9798,196,11,1246.24,3,3,3,9,Regulars
9799,132,8,813.72,4,2,1,7,Regulars
9800,74,11,3165.35,4,3,5,12,Loyal
9801,224,11,1545.5,3,3,3,9,Regulars
9802,498,13,856.8,1,4,2,7,At Risk
9803,158,6,1405.57,3,1,3,7,Regulars
9804,265,13,3675.7400000000002,2,4,5,11,At Risk
9805,255,14,2931.35,2,5,5,12,At Risk
9806,264,8,567.71,2,2,1,5,Hibernating
9807,1275,4,749.0799999999999,1,1,1,3,Hibernating
9808,22,13,1693.05,5,4,3,12,Loyal
9809,98,13,1378.96,4,4,3,11,Loyal
9810,110,6,657.99,4,1,1,6,Regulars
9811,485,12,2152.0099999999998,1,4,4,9,At Risk
9812,463,8,770.38,1,2,1,4,Hibernating
9813,530,13,1512.07,1,4,3,8,At Risk
9814,105,14,2703.77,4,5,5,14,Champions
9815,119,9,521.08,4,2,1,7,Regulars
9816,53,14,1901.9599999999998,5,5,4,14,Champions
9817,551,13,2128.47,1,4,4,9,At Risk
9818,142,9,586.0500000000001,4,2,1,7,Regulars
9819,224,9,1211.4599999999998,3,2,2,7,Regulars
9820,97,12,1472.48,4,4,3,11,Loyal
9821,151,7,1383.04,3,1,3,7,Regulars
9822,569,7,247.45,1,1,1,3,Hibernating
9823,615,9,824.49,1,2,1,4,Hibernating
9824,237,10,1334.83,3,3,3,9,Regulars
9825,130,12,2674.25,4,4,5,13,Champions
9826,82,7,677.8,4,1,1,6,Regulars
9827,54,11,2936.97,5,3,5,13,Loyal
9828,199,9,3437.46,3,2,5,10,Big Spenders
9829,517,7,553.43,1,1,1,3,Hibernating
9830,559,13,2060.9,1,4,4,9,At Risk
9831,202,9,3303.1499999999996,3,2,5,10,Big Spenders
9832,118,8,922.4200000000001,4,2,2,8,Regulars
9833,461,15,2619.14,1,5,5,11,At Risk
9834,246,10,1170.78,3,3,2,8,Regulars
9835,205,15,1089.02,3,5,2,10,Regulars
9836,109,6,841.37,4,1,1,6,Regulars
9837,123,12,973.24,4,4,2,10,Loyal
9838,52,12,1020.6500000000001,5,4,2,11,Loyal
9839,302,11,1699.2,2,3,3,8,Regulars
9840,156,7,2901.0199999999995,3,1,5,9,Big Spenders
9841,146,9,643.81,4,2,1,7,Regulars
9842,702,9,1556.79,1,2,3,6,Regulars
9843,115,10,1330.3,4,3,3,10,Loyal
9844,96,13,2695.63,4,4,5,13,Champions
9845,895,9,1773.0,1,2,4,7,Regulars
9846,144,13,2244.63,4,4,4,12,Champions
9847,230,7,2659.25,3,1,5,9,Big Spenders
9848,127,8,1696.75,4,2,3,9,Regulars
9849,111,15,2013.5,4,5,4,13,Champions
9850,196,4,337.44,3,1,1,5,Regulars
9851,19,8,827.1,5,2,1,8,Regulars
9852,118,7,481.75,4,1,1,6,Regulars
9853,13,19,5084.759999999999,5,5,5,15,Champions
9854,17,15,1423.4,5,5,3,13,Loyal
9855,54,11,2398.75,5,3,4,12,Loyal
9856,501,11,1941.8899999999999,1,3,4,8,Regulars
9857,32,12,3221.65,5,4,5,14,Champions
9858,70,13,1325.6399999999999,4,4,3,11,Loyal
9859,435,9,2154.37,2,2,4,8,Regulars
9860,112,6,881.0699999999999,4,1,2,7,Regulars
9861,149,15,2737.12,3,5,5,13,Big Spenders
9862,119,8,1455.72,4,2,3,9,Regulars
9863,205,17,5811.75,3,5,5,13,Big Spenders
9864,1,6,422.94,5,1,1,7,Regulars
9865,862,9,1230.1,1,2,2,5,Hibernating
9866,274,10,6455.2,2,3,5,10,Regulars
9867,67,7,797.3,4,1,1,6,Regulars
9868,258,11,738.87,2,3,1,6,Regulars
9869,99,12,1429.61,4,4,3,11,Loyal
9870,102,9,767.87,4,2,1,7,Regulars
9871,4,9,1528.94,5,2,3,10,Regulars
9872,116,10,2434.41,4,3,4,11,Loyal
9873,78,9,4221.48,4,2,5,11,Big Spenders
9874,162,3,251.47,3,1,1,5,Regulars
9875,660,7,2989.7999999999997,1,1,5,7,Regulars
9876,181,10,1622.24,3,3,3,9,Regulars
9877,300,9,825.68,2,2,1,5,Hibernating
9878,446,9,816.78,2,2,1,5,Hibernating
9879,98,7,941.5,4,1,2,7,Regulars
9880,209,10,843.12,3,3,1,7,Regulars
9881,15,11,2661.28,5,3,5,13,Loyal
9882,990,5,356.14,1,1,1,3,Hibernating
9883,106,13,2960.5,4,4,5,13,Champions
9884,183,10,1589.74,3,3,3,9,Regulars
9885,141,14,1433.58,4,5,3,12,Loyal
9886,39,8,1165.24,5,2,2,9,Regulars
9887,45,7,1277.23,5,1,3,9,Regulars
9888,259,11,1332.8200000000002,2,3,3,8,Regulars
9889,446,11,2908.9199999999996,2,3,5,10,Regulars
9890,47,8,2341.38,5,2,4,11,Big Spenders
9891,2,14,2858.21,5,5,5,15,Champions
9892,18,10,3189.09,5,3,5,13,Loyal
9893,216,15,4269.66,3,5,5,13,Big Spenders
9894,878,9,885.59,1,2,2,5,Hibernating
9895,70,12,3570.01,4,4,5,13,Champions
9896,211,13,1333.8899999999999,3,4,3,10,Regulars
9897,156,8,855.03,3,2,2,7,Regulars
9898,51,10,935.92,5,3,2,10,Loyal
9899,220,14,2333.44,3,5,4,12,Big Spenders
9900,61,6,1531.5300000000002,5,1,3,9,Regulars
9901,231,7,220.74,3,1,1,5,Regulars
9902,140,13,917.38,4,4,2,10,Loyal
9903,484,2,239.87,1,1,1,3,Hibernating
9904,716,7,947.78,1,1,2,4,Hibernating
9905,193,13,3148.27,3,4,5,12,Big Spenders
9906,230,7,1006.0799999999999,3,1,2,6,Regulars
9907,428,10,600.75,2,3,1,6,Regulars
9908,69,12,2388.17,4,4,4,12,Champions
9909,231,12,1391.52,3,4,3,10,Regulars
9910,112,11,1401.52,4,3,3,10,Loyal
9911,20,9,1346.62,5,2,3,10,Regulars
9912,83,14,1118.81,4,5,2,11,Loyal
9913,30,9,1358.95,5,2,3,10,Regulars
9914,165,9,1104.7,3,2,2,7,Regulars
9915,1071,2,360.23,1,1,1,3,Hibernating
9916,125,9,2625.25,4,2,5,11,Big Spenders
9917,262,12,3435.59,2,4,5,11,At Risk
9918,103,12,3169.79,4,4,5,13,Champions
9919,855,6,591.01,1,1,1,3,Hibernating
9920,95,9,1161.76,4,2,2,8,Regulars
9921,416,6,416.48,2,1,1,4,Hibernating
9922,175,15,2593.59,3,5,5,13,Big Spenders
9923,251,14,2505.95,2,5,4,11,At Risk
9924,16,17,2100.27,5,5,4,14,Champions
9925,511,11,1328.51,1,3,3,7,Regulars
9926,127,7,860.04,4,1,2,7,Regulars
9927,83,11,871.65,4,3,2,9,Loyal
9928,282,15,3509.78,2,5,5,12,At Risk
9929,229,12,1227.5500000000002,3,4,2,9,Regulars
9930,21,10,1882.38,5,3,4,12,Loyal
9931,203,4,718.71,3,1,1,5,Regulars
9932,350,7,826.98,2,1,1,4,Hibernating
9933,60,18,1804.75,5,5,4,14,Champions
9934,13,9,2385.0299999999997,5,2,4,11,Big Spenders
9935,327,5,857.53,2,1,2,5,Hibernating
9936,88,13,1123.1499999999999,4,4,2,10,Loyal
9937,50,12,1332.46,5,4,3,12,Loyal
9938,111,10,2669.61,4,3,5,12,Loyal
9939,698,6,567.11,1,1,1,3,Hibernating
9940,134,13,1837.38,4,4,4,12,Champions
9941,187,13,2490.31,3,4,4,11,Big Spenders
9942,9,8,721.49,5,2,1,8,Regulars
9943,18,8,1306.3700000000001,5,2,3,10,Regulars
9944,25,16,2906.61,5,5,5,15,Champions
9945,180,6,360.39,3,1,1,5,Regulars
9946,360,12,1164.22,2,4,2,8,At Risk
9947,38,16,3890.65,5,5,5,15,Champions
9948,0,12,1955.1799999999998,5,4,4,13,Champions
9949,124,14,2568.73,4,5,4,13,Champions
9950,92,11,2779.49,4,3,5,12,Loyal
9951,42,14,1730.46,5,5,4,14,Champions
9952,203,9,1437.64,3,2,3,8,Regulars
9953,196,5,557.67,3,1,1,5,Regulars
9954,1372,4,1325.01,1,1,3,5,Regulars
9955,630,8,1644.75,1,2,3,6,Regulars
9956,131,9,5109.83,4,2,5,11,Big Spenders
9957,383,2,480.34999999999997,2,1,1,4,Hibernating
9958,45,16,2329.13,5,5,4,14,Champions
9959,129,14,1223.77,4,5,2,11,Loyal
9960,480,8,1152.07,1,2,2,5,Hibernating
9961,374,6,1270.04,2,1,3,6,Regulars
9962,261,11,1220.71,2,3,2,7,Regulars
9963,275,7,1221.69,2,1,2,5,Hibernating
9964,64,8,1690.6699999999998,5,2,3,10,Regulars
9965,55,14,5985.53,5,5,5,15,Champions
9966,534,11,1177.48,1,3,2,6,Regulars
9967,546,9,970.1700000000001,1,2,2,5,Hibernating
9968,341,9,1074.1499999999999,2,2,2,6,Hibernating
9969,190,14,1707.8200000000002,3,5,3,11,Regulars
9970,102,14,5759.4,4,5,5,14,Champions
9971,419,11,1041.4,2,3,2,7,Regulars
9972,313,9,1058.5900000000001,2,2,2,6,Hibernating
9973,98,4,304.59,4,1,1,6,Regulars
9974,305,16,1274.86,2,5,3,10,At Risk
9975,756,8,364.17999999999995,1,2,1,4,Hibernating
9976,1,7,3785.63,5,1,5,11,Big Spenders
9977,280,7,621.7,2,1,1,4,Hibernating
9978,7,15,3532.24,5,5,5,15,Champions
9979,490,12,2584.4900000000002,1,4,5,10,At Risk
9980,205,15,3755.48,3,5,5,13,Big Spenders
9981,26,7,1524.52,5,1,3,9,Regulars
9982,626,5,640.71,1,1,1,3,Hibernating
9983,546,19,3367.43,1,5,5,11,At Risk
9984,238,15,2855.9799999999996,3,5,5,13,Big Spenders
9985,52,9,1823.3,5,2,4,11,Big Spenders
9986,134,8,1507.57,4,2,3,9,Regulars
9987,265,4,309.11999999999995,2,1,1,4,Hibernating
9988,154,7,3129.65,3,1,5,9,Big Spenders
9989,27,10,2744.1,5,3,5,13,Loyal
9990,303,6,475.59000000000003,2,1,1,4,Hibernating
9991,3,9,3051.89,5,2,5,12,Big Spenders
9992,80,11,1110.44,4,3,2,9,Loyal
9993,100,11,2267.4500000000003,4,3,4,11,Loyal
9994,209,13,2018.98,3,4,4,11,Big Spenders
9995,238,11,2237.87,3,3,4,10,Big Spenders
9996,280,14,1499.05,2,5,3,10,At Risk
9997,28,9,5904.0,5,2,5,12,Big Spenders
9998,820,11,2421.88,1,3,4,8,Regulars
9999,4,12,1336.03,5,4,3,12,Loyal
10000,114,8,623.61,4,2,1,7,Regulars
10001,684,8,654.97,1,2,1,4,Hibernating
10002,20,10,1646.5900000000001,5,3,3,11,Loyal
10003,92,12,890.5200000000001,4,4,2,10,Loyal
10004,56,7,1444.38,5,1,3,9,Regulars
10005,48,6,1282.12,5,1,3,9,Regulars
10006,124,7,1857.55,4,1,4,9,Big Spenders
10007,577,11,1189.8000000000002,1,3,2,6,Regulars
10008,87,13,2579.46,4,4,5,13,Champions
10009,83,16,4175.3,4,5,5,14,Champions
10010,33,9,1479.34,5,2,3,10,Regulars
10011,664,9,1448.46,1,2,3,6,Regulars
10012,168,19,2694.37,3,5,5,13,Big Spenders
10013,2058,2,410.25,1,1,1,3,Hibernating
10014,92,15,2008.8899999999999,4,5,4,13,Champions
10015,169,11,693.91,3,3,1,7,Regulars
10016,321,7,1023.37,2,1,2,5,Hibernating
10017,218,8,1018.09,3,2,2,7,Regulars
10018,352,11,1280.25,2,3,3,8,Regulars
10019,278,11,1213.1,2,3,2,7,Regulars
10020,385,16,1843.74,2,5,4,11,At Risk
10021,317,9,763.85,2,2,1,5,Hibernating
10022,100,19,4082.17,4,5,5,14,Champions
10023,270,14,1456.49,2,5,3,10,At Risk
10024,147,9,1735.3300000000002,4,2,4,10,Big Spenders
10025,154,20,2340.48,3,5,4,12,Big Spenders
10026,198,10,998.01,3,3,2,8,Regulars
10027,225,7,3189.45,3,1,5,9,Big Spenders
10028,107,4,305.45,4,1,1,6,Regulars
10029,95,9,2738.55,4,2,5,11,Big Spenders
10030,157,12,1476.22,3,4,3,10,Regulars
10031,945,8,613.29,1,2,1,4,Hibernating
10032,791,7,2688.63,1,1,5,7,Regulars
10033,445,9,1086.04,2,2,2,6,Hibernating
10034,129,14,1837.49,4,5,4,13,Champions
10035,90,6,707.29,4,1,1,6,Regulars
10036,449,11,1051.97,2,3,2,7,Regulars
10037,252,8,1359.38,2,2,3,7,Regulars
10038,99,11,1303.72,4,3,3,10,Loyal
10039,258,17,2348.84,2,5,4,11,At Risk
10040,70,7,958.79,4,1,2,7,Regulars
10041,144,11,1355.6499999999999,4,3,3,10,Loyal
10042,50,12,1362.2,5,4,3,12,Loyal
10043,188,10,906.6800000000001,3,3,2,8,Regulars
10044,225,7,640.26,3,1,1,5,Regulars
10045,153,11,754.27,3,3,1,7,Regulars
10046,148,13,1564.46,3,4,3,10,Regulars
10047,966,12,1438.12,1,4,3,8,At Risk
10048,237,13,1026.64,3,4,2,9,Regulars
10049,689,7,971.34,1,1,2,4,Hibernating
10050,90,10,1995.0600000000002,4,3,4,11,Loyal
10051,20,15,1916.73,5,5,4,14,Champions
10052,91,9,526.1,4,2,1,7,Regulars
10053,943,3,138.54000000000002,1,1,1,3,Hibernating
10054,44,12,3309.4100000000003,5,4,5,14,Champions
10055,301,7,601.74,2,1,1,4,Hibernating
10056,818,8,1685.0700000000002,1,2,3,6,Regulars
10057,1147,6,1657.59,1,1,3,5,Regulars
10058,123,10,876.5,4,3,2,9,Loyal
10059,1063,7,745.42,1,1,1,3,Hibernating
10060,139,8,1063.08,4,2,2,8,Regulars
10061,206,7,798.14,3,1,1,5,Regulars
10062,52,12,1691.8300000000002,5,4,3,12,Loyal
10063,3,14,3178.5099999999998,5,5,5,15,Champions
10064,354,5,3452.53,2,1,5,8,Regulars
10065,2392,2,35.95,1,1,1,3,Hibernating
10066,27,13,2916.7,5,4,5,14,Champions
10067,52,15,2623.89,5,5,5,15,Champions
10068,90,7,870.28,4,1,2,7,Regulars
10069,368,12,2276.14,2,4,4,10,At Risk
10070,231,11,1078.2,3,3,2,8,Regulars
10071,529,6,955.0500000000001,1,1,2,4,Hibernating
10072,40,16,2009.92,5,5,4,14,Champions
10073,57,12,2129.01,5,4,4,13,Champions
10074,538,6,418.47,1,1,1,3,Hibernating
10075,204,13,2361.92,3,4,4,11,Big Spenders
10076,35,16,6348.83,5,5,5,15,Champions
10077,166,14,1233.78,3,5,2,10,Regulars
10078,1002,8,1036.99,1,2,2,5,Hibernating
10079,25,10,1250.3500000000001,5,3,3,11,Loyal
10080,475,9,767.46,1,2,1,4,Hibernating
10081,192,13,3926.17,3,4,5,12,Big Spenders
10082,54,6,734.03,5,1,1,7,Regulars
10083,68,9,1211.1200000000001,4,2,2,8,Regulars
10084,108,6,1093.81,4,1,2,7,Regulars
10085,778,10,1028.19,1,3,2,6,Regulars
10086,15,7,732.5,5,1,1,7,Regulars
10087,122,12,2649.5299999999997,4,4,5,13,Champions
10088,109,13,1677.01,4,4,3,11,Loyal
10089,59,12,3666.16,5,4,5,14,Champions
10090,200,10,2162.26,3,3,4,10,Big Spenders
10091,230,8,2358.33,3,2,4,9,Big Spenders
10092,39,10,1806.41,5,3,4,12,Loyal
10093,250,9,1569.43,2,2,3,7,Regulars
10094,883,5,729.92,1,1,1,3,Hibernating
10095,556,6,4421.53,1,1,5,7,Regulars
10096,28,7,664.11,5,1,1,7,Regulars
10097,38,12,1362.46,5,4,3,12,Loyal
10098,121,8,2146.36,4,2,4,10,Big Spenders
10099,238,9,2051.48,3,2,4,9,Big Spenders
10100,214,11,1017.26,3,3,2,8,Regulars
10101,39,11,1514.2499999999998,5,3,3,11,Loyal
10102,622,15,3545.33,1,5,5,11,At Risk
10103,83,14,2988.95,4,5,5,14,Champions
10104,211,13,2291.97,3,4,4,11,Big Spenders
10105,555,10,1351.41,1,3,3,7,Regulars
10106,337,6,641.02,2,1,1,4,Hibernating
10107,242,11,1327.1,3,3,3,9,Regulars
10108,348,7,1401.63,2,1,3,6,Regulars
10109,92,14,3464.21,4,5,5,14,Champions
10110,454,13,3194.17,2,4,5,11,At Risk
10111,246,12,1528.6699999999998,3,4,3,10,Regulars
10112,1525,5,510.76,1,1,1,3,Hibernating
10113,316,9,1961.26,2,2,4,8,Regulars
10114,252,7,1738.06,2,1,4,7,Regulars
10115,696,12,1901.63,1,4,4,9,At Risk
10116,735,4,172.37,1,1,1,3,Hibernating
10117,351,9,784.0,2,2,1,5,Hibernating
10118,26,9,949.62,5,2,2,9,Regulars
10119,559,11,1415.45,1,3,3,7,Regulars
10120,150,10,1669.3400000000001,3,3,3,9,Regulars
10121,1397,5,442.94,1,1,1,3,Hibernating
10122,228,20,4359.72,3,5,5,13,Big Spenders
10123,275,11,766.1700000000001,2,3,1,6,Regulars
10124,728,8,1114.31,1,2,2,5,Hibernating
10125,424,6,339.46000000000004,2,1,1,4,Hibernating
10126,245,7,1795.83,3,1,4,8,Big Spenders
10127,51,9,1409.69,5,2,3,10,Regulars
10128,697,9,1827.26,1,2,4,7,Regulars
10129,234,10,3293.46,3,3,5,11,Big Spenders
10130,2335,2,135.68,1,1,1,3,Hibernating
10131,74,12,1161.6100000000001,4,4,2,10,Loyal
10132,101,12,3487.42,4,4,5,13,Champions
10133,198,17,3864.73,3,5,5,13,Big Spenders
10134,272,12,1800.93,2,4,4,10,At Risk
10135,117,8,571.41,4,2,1,7,Regulars
10136,191,9,1076.93,3,2,2,7,Regulars
10137,154,12,3441.82,3,4,5,12,Big Spenders
10138,46,12,2461.26,5,4,4,13,Champions
10139,349,13,4241.95,2,4,5,11,At Risk
10140,159,14,1989.16,3,5,4,12,Big Spenders
10141,176,15,2355.2,3,5,4,12,Big Spenders
10142,40,12,3426.1800000000003,5,4,5,14,Champions
10143,338,8,489.41,2,2,1,5,Hibernating
10144,69,9,2116.8500000000004,4,2,4,10,Big Spenders
10145,149,10,1129.47,3,3,2,8,Regulars
10146,571,8,2148.7,1,2,4,7,Regulars
10147,9,14,2615.22,5,5,5,15,Champions
10148,161,9,1285.28,3,2,3,8,Regulars
10149,432,8,863.02,2,2,2,6,Hibernating
10150,298,10,1936.15,2,3,4,9,Regulars
10151,101,8,687.53,4,2,1,7,Regulars
10152,298,13,3421.7599999999998,2,4,5,11,At Risk
10153,100,12,1505.4,4,4,3,11,Loyal
10154,588,6,1280.65,1,1,3,5,Regulars
10155,245,8,703.68,3,2,1,6,Regulars
10156,201,15,3349.6600000000003,3,5,5,13,Big Spenders
10157,237,14,1013.16,3,5,2,10,Regulars
10158,13,10,592.41,5,3,1,9,Loyal
10159,99,13,1135.49,4,4,2,10,Loyal
10160,101,6,378.15,4,1,1,6,Regulars
10161,475,6,3404.7500000000005,1,1,5,7,Regulars
10162,111,8,1878.55,4,2,4,10,Big Spenders
10163,133,6,1142.64,4,1,2,7,Regulars
10164,490,9,1405.8999999999999,1,2,3,6,Regulars
10165,611,5,392.37,1,1,1,3,Hibernating
10166,21,13,1582.78,5,4,3,12,Loyal
10167,249,12,1360.7,2,4,3,9,At Risk
10168,300,9,1290.25,2,2,3,7,Regulars
10169,442,5,506.66,2,1,1,4,Hibernating
10170,312,12,497.25,2,4,1,7,At Risk
10171,288,14,1741.09,2,5,4,11,At Risk
10172,630,9,871.85,1,2,2,5,Hibernating
10173,473,10,2827.03,1,3,5,9,Regulars
10174,245,7,1143.63,3,1,2,6,Regulars
10175,354,14,898.12,2,5,2,9,At Risk
10176,52,8,781.27,5,2,1,8,Regulars
10177,84,12,4328.48,4,4,5,13,Champions
10178,53,15,2677.27,5,5,5,15,Champions
10179,583,13,1895.36,1,4,4,9,At Risk
10180,456,14,3082.9500000000003,2,5,5,12,At Risk
10181,1291,7,1222.6,1,1,2,4,Hibernating
10182,1250,7,623.56,1,1,1,3,Hibernating
10183,129,11,1432.28,4,3,3,10,Loyal
10184,724,8,1584.2300000000002,1,2,3,6,Regulars
10185,304,9,5182.88,2,2,5,9,Regulars
10186,96,13,2239.64,4,4,4,12,Champions
10187,218,11,1110.15,3,3,2,8,Regulars
10188,240,5,325.20000000000005,3,1,1,5,Regulars
10189,238,11,3375.45,3,3,5,11,Big Spenders
10190,127,7,2118.98,4,1,4,9,Big Spenders
10191,614,7,530.36,1,1,1,3,Hibernating
10192,119,13,1587.75,4,4,3,11,Loyal
10193,128,11,1636.0900000000001,4,3,3,10,Loyal
10194,191,7,1107.28,3,1,2,6,Regulars
10195,527,10,4724.46,1,3,5,9,Regulars
10196,318,11,397.51,2,3,1,6,Regulars
10197,3,15,2827.99,5,5,5,15,Champions
10198,157,11,3390.31,3,3,5,11,Big Spenders
10199,259,16,4468.11,2,5,5,12,At Risk
10200,1034,7,2687.8300000000004,1,1,5,7,Regulars
10201,204,9,4213.5199999999995,3,2,5,10,Big Spenders
10202,140,8,2441.64,4,2,4,10,Big Spenders
10203,157,13,2194.13,3,4,4,11,Big Spenders
10204,418,10,985.02,2,3,2,7,Regulars
10205,65,6,552.91,5,1,1,7,Regulars
10206,135,5,1284.6399999999999,4,1,3,8,Regulars
10207,141,12,1216.37,4,4,2,10,Loyal
10208,398,7,316.16,2,1,1,4,Hibernating
10209,57,14,1933.13,5,5,4,14,Champions
10210,124,12,2138.48,4,4,4,12,Champions
10211,142,13,1362.14,4,4,3,11,Loyal
10212,414,7,603.74,2,1,1,4,Hibernating
10213,114,16,3271.3300000000004,4,5,5,14,Champions
10214,24,9,1438.32,5,2,3,10,Regulars
10215,882,9,2285.84,1,2,4,7,Regulars
10216,231,5,830.24,3,1,1,5,Regulars
10217,36,12,1384.3799999999999,5,4,3,12,Loyal
10218,573,8,580.4200000000001,1,2,1,4,Hibernating
10219,333,13,1938.8600000000001,2,4,4,10,At Risk
10220,103,10,1285.92,4,3,3,10,Loyal
10221,19,15,1237.38,5,5,2,12,Loyal
10222,750,16,2144.04,1,5,4,10,At Risk
10223,225,6,1865.4799999999998,3,1,4,8,Big Spenders
10224,54,13,968.93,5,4,2,11,Loyal
10225,719,6,1526.61,1,1,3,5,Regulars
10226,132,15,2525.96,4,5,4,13,Champions
10227,17,9,811.3,5,2,1,8,Regulars
10228,32,13,1279.63,5,4,3,12,Loyal
10229,84,12,1027.74,4,4,2,10,Loyal
10230,129,11,1066.86,4,3,2,9,Loyal
10231,1842,3,615.38,1,1,1,3,Hibernating
10232,30,15,1081.89,5,5,2,12,Loyal
10233,31,13,2353.87,5,4,4,13,Champions
10234,57,9,2832.56,5,2,5,12,Big Spenders
10235,220,12,1332.6599999999999,3,4,3,10,Regulars
10236,17,9,622.36,5,2,1,8,Regulars
10237,12,17,1937.62,5,5,4,14,Champions
10238,237,10,1102.21,3,3,2,8,Regulars
10239,462,15,1494.93,1,5,3,9,At Risk
10240,34,11,2834.27,5,3,5,13,Loyal
10241,629,9,741.81,1,2,1,4,Hibernating
10242,551,8,1267.75,1,2,3,6,Regulars
10243,14,11,3928.9299999999994,5,3,5,13,Loyal
10244,124,12,1202.59,4,4,2,10,Loyal
10245,21,16,2645.32,5,5,5,15,Champions
10246,193,9,1201.14,3,2,2,7,Regulars
10247,942,5,401.73999999999995,1,1,1,3,Hibernating
10248,481,12,2901.37,1,4,5,10,At Risk
10249,158,14,4464.7300000000005,3,5,5,13,Big Spenders
10250,536,11,1084.37,1,3,2,6,Regulars
10251,1296,5,2330.5,1,1,4,6,Regulars
10252,34,10,2014.9899999999998,5,3,4,12,Loyal
10253,40,11,1326.94,5,3,3,11,Loyal
10254,97,16,1455.95,4,5,3,12,Loyal
10255,361,15,2632.56,2,5,5,12,At Risk
10256,492,10,1908.17,1,3,4,8,Regulars
10257,25,6,589.6800000000001,5,1,1,7,Regulars
10258,235,10,1895.85,3,3,4,10,Big Spenders
10259,484,6,1653.71,1,1,3,5,Regulars
10260,228,9,1766.97,3,2,4,9,Big Spenders
10261,5,9,2904.75,5,2,5,12,Big Spenders
10262,13,11,985.6800000000001,5,3,2,10,Loyal
10263,153,18,3052.3199999999997,3,5,5,13,Big Spenders
10264,466,8,1047.65,1,2,2,5,Hibernating
10265,507,10,928.41,1,3,2,6,Regulars
10266,162,10,763.25,3,3,1,7,Regulars
10267,100,9,2505.72,4,2,4,10,Big Spenders
10268,187,13,2150.65,3,4,4,11,Big Spenders
10269,30,11,1841.6,5,3,4,12,Loyal
10270,155,8,1584.3000000000002,3,2,3,8,Regulars
10271,103,9,2405.96,4,2,4,10,Big Spenders
10272,259,9,953.3,2,2,2,6,Hibernating
10273,620,17,1538.5,1,5,3,9,At Risk
10274,810,7,1908.8799999999999,1,1,4,6,Regulars
10275,164,11,2693.4,3,3,5,11,Big Spenders
10276,670,9,1031.31,1,2,2,5,Hibernating
10277,45,10,1671.22,5,3,3,11,Loyal
10278,175,11,1286.22,3,3,3,9,Regulars
10279,213,9,1603.92,3,2,3,8,Regulars
10280,120,6,383.21000000000004,4,1,1,6,Regulars
10281,54,11,1597.93,5,3,3,11,Loyal
10282,159,12,1337.38,3,4,3,10,Regulars
10283,165,9,2437.46,3,2,4,9,Big Spenders
10284,355,9,1893.18,2,2,4,8,Regulars
10285,677,12,1193.1899999999998,1,4,2,7,At Risk
10286,679,9,1836.1,1,2,4,7,Regulars
10287,127,13,2125.21,4,4,4,12,Champions
10288,216,10,1354.71,3,3,3,9,Regulars
10289,247,9,1290.9099999999999,3,2,3,8,Regulars
10290,266,16,1849.27,2,5,4,11,At Risk
10291,48,11,802.88,5,3,1,9,Loyal
10292,345,14,2318.23,2,5,4,11,At Risk
10293,180,12,2181.58,3,4,4,11,Big Spenders
10294,20,14,3907.94,5,5,5,15,Champions
10295,227,14,2452.1,3,5,4,12,Big Spenders
10296,42,9,1160.67,5,2,2,9,Regulars
10297,607,13,3691.4300000000003,1,4,5,10,At Risk
10298,236,5,471.25,3,1,1,5,Regulars
10299,101,10,870.5999999999999,4,3,2,9,Loyal
10300,165,10,4202.04,3,3,5,11,Big Spenders
10301,39,11,4088.9000000000005,5,3,5,13,Loyal
10302,140,5,194.18,4,1,1,6,Regulars
10303,85,15,1665.14,4,5,3,12,Loyal
10304,229,12,4035.8999999999996,3,4,5,12,Big Spenders
10305,484,12,1790.11,1,4,4,9,At Risk
10306,552,8,2764.0199999999995,1,2,5,8,Regulars
10307,582,14,1349.76,1,5,3,9,At Risk
10308,203,6,1366.25,3,1,3,7,Regulars
10309,462,8,1925.0,1,2,4,7,Regulars
10310,804,12,1801.17,1,4,4,9,At Risk
10311,1177,4,250.38,1,1,1,3,Hibernating
10312,166,11,2594.11,3,3,5,11,Big Spenders
10313,345,14,1871.5800000000002,2,5,4,11,At Risk
10314,143,11,1249.1100000000001,4,3,3,10,Loyal
10315,568,9,928.62,1,2,2,5,Hibernating
10316,58,12,1424.86,5,4,3,12,Loyal
10317,126,17,1850.3799999999999,4,5,4,13,Champions
10318,226,12,1373.77,3,4,3,10,Regulars
10319,19,13,1549.49,5,4,3,12,Loyal
10320,220,12,1253.8,3,4,3,10,Regulars
10321,513,12,1028.3500000000001,1,4,2,7,At Risk
10322,30,11,1941.24,5,3,4,12,Loyal
10323,612,5,841.56,1,1,1,3,Hibernating
10324,162,8,688.16,3,2,1,6,Regulars
10325,429,9,4189.36,2,2,5,9,Regulars
10326,718,9,1238.72,1,2,2,5,Hibernating
10327,1060,9,828.0600000000001,1,2,1,4,Hibernating
10328,83,16,2550.88,4,5,4,13,Champions
10329,302,15,2367.13,2,5,4,11,At Risk
10330,647,5,358.98,1,1,1,3,Hibernating
10331,34,12,4368.3,5,4,5,14,Champions
10332,96,8,2024.6800000000003,4,2,4,10,Big Spenders
10333,1442,6,493.84,1,1,1,3,Hibernating
10334,73,6,961.21,4,1,2,7,Regulars
10335,174,4,488.91999999999996,3,1,1,5,Regulars
10336,42,11,1126.5,5,3,2,10,Loyal
10337,97,13,1102.75,4,4,2,10,Loyal
10338,486,9,921.08,1,2,2,5,Hibernating
10339,276,11,1085.72,2,3,2,7,Regulars
10340,30,12,1451.18,5,4,3,12,Loyal
10341,608,10,2014.33,1,3,4,8,Regulars
10342,364,14,3896.7000000000003,2,5,5,12,At Risk
10343,12,13,3188.7400000000002,5,4,5,14,Champions
10344,100,16,5240.88,4,5,5,14,Champions
10345,122,10,1809.6599999999999,4,3,4,11,Loyal
10346,38,12,2323.81,5,4,4,13,Champions
10347,138,12,4276.9,4,4,5,13,Champions
10348,31,14,3245.12,5,5,5,15,Champions
10349,62,10,1191.31,5,3,2,10,Loyal
10350,121,14,1492.75,4,5,3,12,Loyal
10351,105,9,1565.8799999999999,4,2,3,9,Regulars
10352,54,6,1286.2800000000002,5,1,3,9,Regulars
10353,195,10,1349.6,3,3,3,9,Regulars
10354,156,14,4901.4800000000005,3,5,5,13,Big Spenders
10355,368,14,1713.1,2,5,3,10,At Risk
10356,81,13,2343.74,4,4,4,12,Champions
10357,172,8,597.7,3,2,1,6,Regulars
10358,28,11,3405.61,5,3,5,13,Loyal
10359,299,9,701.4599999999999,2,2,1,5,Hibernating
10360,253,9,3641.91,2,2,5,9,Regulars
10361,191,11,2554.1800000000003,3,3,4,10,Big Spenders
10362,443,12,1671.69,2,4,3,9,At Risk
10363,173,13,2362.9300000000003,3,4,4,11,Big Spenders
10364,199,7,3504.49,3,1,5,9,Big Spenders
10365,29,12,2156.7599999999998,5,4,4,13,Champions
10366,73,10,2797.3,4,3,5,12,Loyal
10367,283,9,777.0699999999999,2,2,1,5,Hibernating
10368,395,9,807.75,2,2,1,5,Hibernating
10369,519,10,1516.09,1,3,3,7,Regulars
10370,323,11,1503.8799999999999,2,3,3,8,Regulars
10371,584,15,3217.63,1,5,5,11,At Risk
10372,122,11,879.3800000000001,4,3,2,9,Loyal
10373,142,11,1438.06,4,3,3,10,Loyal
10374,50,7,3179.1200000000003,5,1,5,11,Big Spenders
10375,646,9,783.46,1,2,1,4,Hibernating
10376,565,8,1178.3300000000002,1,2,2,5,Hibernating
10377,1935,3,202.42000000000002,1,1,1,3,Hibernating
10378,149,6,659.1700000000001,3,1,1,5,Regulars
10379,237,10,3497.95,3,3,5,11,Big Spenders
10380,400,7,1091.21,2,1,2,5,Hibernating
10381,168,9,5719.7300000000005,3,2,5,10,Big Spenders
10382,316,6,881.22,2,1,2,5,Hibernating
10383,47,11,794.56,5,3,1,9,Loyal
10384,568,6,460.90999999999997,1,1,1,3,Hibernating
10385,274,8,642.34,2,2,1,5,Hibernating
10386,431,15,1090.24,2,5,2,9,At Risk
10387,1028,4,657.53,1,1,1,3,Hibernating
10388,587,6,2182.11,1,1,4,6,Regulars
10389,144,7,765.1700000000001,4,1,1,6,Regulars
10390,179,15,1676.8700000000001,3,5,3,11,Regulars
10391,588,7,793.23,1,1,1,3,Hibernating
10392,268,7,602.4599999999999,2,1,1,4,Hibernating
10393,529,7,622.8399999999999,1,1,1,3,Hibernating
10394,96,9,1305.82,4,2,3,9,Regulars
10395,143,12,1192.06,4,4,2,10,Loyal
10396,404,5,443.36,2,1,1,4,Hibernating
10397,147,16,1732.8700000000001,4,5,4,13,Champions
10398,212,14,2032.1399999999999,3,5,4,12,Big Spenders
10399,809,12,2136.59,1,4,4,9,At Risk
10400,371,12,1374.56,2,4,3,9,At Risk
10401,199,12,1225.66,3,4,2,9,Regulars
10402,882,10,1505.48,1,3,3,7,Regulars
10403,1092,8,428.55,1,2,1,4,Hibernating
10404,199,14,2385.5,3,5,4,12,Big Spenders
10405,292,15,3145.9900000000002,2,5,5,12,At Risk
10406,801,5,1602.1,1,1,3,5,Regulars
10407,41,8,1537.8899999999999,5,2,3,10,Regulars
10408,91,15,7024.22,4,5,5,14,Champions
10409,557,9,1946.21,1,2,4,7,Regulars
10410,85,10,2196.12,4,3,4,11,Loyal
10411,248,11,608.96,2,3,1,6,Regulars
10412,105,9,2608.21,4,2,5,11,Big Spenders
10413,151,6,4095.23,3,1,5,9,Big Spenders
10414,252,11,3236.17,2,3,5,10,Regulars
10415,520,5,1017.54,1,1,2,4,Hibernating
10416,95,11,4143.67,4,3,5,12,Loyal
10417,106,7,957.86,4,1,2,7,Regulars
10418,1072,9,915.29,1,2,2,5,Hibernating
10419,456,9,1118.8700000000001,2,2,2,6,Hibernating
10420,131,8,964.73,4,2,2,8,Regulars
10421,963,7,546.29,1,1,1,3,Hibernating
10422,637,8,2728.13,1,2,5,8,Regulars
10423,191,13,1293.93,3,4,3,10,Regulars
10424,60,11,1642.97,5,3,3,11,Loyal
10425,72,13,1717.62,4,4,3,11,Loyal
10426,101,8,538.94,4,2,1,7,Regulars
10427,278,12,1240.29,2,4,2,8,At Risk
10428,176,12,1868.2599999999998,3,4,4,11,Big Spenders
10429,285,10,2465.96,2,3,4,9,Regulars
10430,195,14,2651.15,3,5,5,13,Big Spenders
10431,1015,3,1454.98,1,1,3,5,Regulars
10432,277,14,2976.4,2,5,5,12,At Risk
10433,1080,9,1299.4,1,2,3,6,Regulars
10434,598,12,2555.83,1,4,4,9,At Risk
10435,485,8,1673.68,1,2,3,6,Regulars
10436,393,11,1399.81,2,3,3,8,Regulars
10437,102,6,494.18,4,1,1,6,Regulars
10438,110,11,4521.14,4,3,5,12,Loyal
10439,620,13,787.61,1,4,1,6,At Risk
10440,129,8,1370.2299999999998,4,2,3,9,Regulars
10441,822,5,1986.2599999999998,1,1,4,6,Regulars
10442,608,9,1241.79,1,2,3,6,Regulars
10443,37,9,1723.4299999999998,5,2,3,10,Regulars
10444,303,9,1239.07,2,2,2,6,Hibernating
10445,264,13,1431.72,2,4,3,9,At Risk
10446,24,16,1664.03,5,5,3,13,Loyal
10447,432,12,755.85,2,4,1,7,At Risk
10448,22,9,793.53,5,2,1,8,Regulars
10449,142,14,2387.19,4,5,4,13,Champions
10450,7,17,3295.12,5,5,5,15,Champions
10451,327,8,979.18,2,2,2,6,Hibernating
10452,47,14,1829.4499999999998,5,5,4,14,Champions
10453,26,8,1797.61,5,2,4,11,Big Spenders
10454,38,11,1554.69,5,3,3,11,Loyal
10455,107,11,975.82,4,3,2,9,Loyal
10456,237,8,625.41,3,2,1,6,Regulars
10457,201,11,1184.51,3,3,2,8,Regulars
10458,30,14,1533.48,5,5,3,13,Loyal
10459,86,11,1104.51,4,3,2,9,Loyal
10460,322,8,2851.0,2,2,5,9,Regulars
10461,302,10,2950.6,2,3,5,10,Regulars
10462,1351,8,521.83,1,2,1,4,Hibernating
10463,400,8,1049.62,2,2,2,6,Hibernating
10464,400,9,1429.77,2,2,3,7,Regulars
10465,235,5,318.50000000000006,3,1,1,5,Regulars
10466,414,5,834.07,2,1,1,4,Hibernating
10467,527,14,2930.59,1,5,5,11,At Risk
10468,82,12,1136.6999999999998,4,4,2,10,Loyal
10469,326,13,966.05,2,4,2,8,At Risk
10470,367,14,1118.06,2,5,2,9,At Risk
10471,464,15,5391.33,1,5,5,11,At Risk
10472,316,9,2743.96,2,2,5,9,Regulars
10473,297,6,802.25,2,1,1,4,Hibernating
10474,643,14,3898.5,1,5,5,11,At Risk
10475,64,9,1505.6200000000001,5,2,3,10,Regulars
10476,251,4,466.05,2,1,1,4,Hibernating
10477,111,12,1175.25,4,4,2,10,Loyal
10478,542,8,729.33,1,2,1,4,Hibernating
10479,513,15,1908.67,1,5,4,10,At Risk
10480,218,13,2944.7299999999996,3,4,5,12,Big Spenders
10481,316,7,527.61,2,1,1,4,Hibernating
10482,44,17,4070.8500000000004,5,5,5,15,Champions
10483,537,7,1708.3300000000002,1,1,3,5,Regulars
10484,292,8,1114.72,2,2,2,6,Hibernating
10485,11,15,2890.42,5,5,5,15,Champions
10486,771,9,2787.0599999999995,1,2,5,8,Regulars
10487,128,9,2102.16,4,2,4,10,Big Spenders
10488,6,13,1928.0300000000002,5,4,4,13,Champions
10489,70,11,1536.94,4,3,3,10,Loyal
10490,22,11,1485.27,5,3,3,11,Loyal
10491,214,11,1680.53,3,3,3,9,Regulars
10492,436,8,1503.65,2,2,3,7,Regulars
10493,101,6,326.53000000000003,4,1,1,6,Regulars
10494,156,10,1189.75,3,3,2,8,Regulars
10495,104,3,556.98,4,1,1,6,Regulars
10496,178,8,898.79,3,2,2,7,Regulars
10497,307,16,2729.75,2,5,5,12,At Risk
10498,151,9,1746.56,3,2,4,9,Big Spenders
10499,125,9,708.3299999999999,4,2,1,7,Regulars
10500,206,10,1553.73,3,3,3,9,Regulars
10501,513,12,1252.72,1,4,3,8,At Risk
10502,1422,6,862.52,1,1,2,4,Hibernating
10503,224,11,1568.18,3,3,3,9,Regulars
10504,278,14,4512.71,2,5,5,12,At Risk
10505,690,10,3667.65,1,3,5,9,Regulars
10506,600,7,1828.36,1,1,4,6,Regulars
10507,614,10,1309.91,1,3,3,7,Regulars
10508,76,15,1218.55,4,5,2,11,Loyal
10509,67,12,1588.1899999999998,4,4,3,11,Loyal
10510,23,7,896.6600000000001,5,1,2,8,Regulars
10511,17,7,2221.37,5,1,4,10,Big Spenders
10512,236,10,1306.54,3,3,3,9,Regulars
10513,286,15,5423.44,2,5,5,12,At Risk
10514,10,9,1967.5099999999998,5,2,4,11,Big Spenders
10515,435,9,907.0,2,2,2,6,Hibernating
10516,318,10,825.6500000000001,2,3,1,6,Regulars
10517,53,16,6168.76,5,5,5,15,Champions
10518,12,14,3186.83,5,5,5,15,Champions
10519,727,6,1359.13,1,1,3,5,Regulars
10520,726,10,1404.76,1,3,3,7,Regulars
10521,54,16,1736.55,5,5,4,14,Champions
10522,140,13,1848.68,4,4,4,12,Champions
10523,294,7,605.28,2,1,1,4,Hibernating
10524,69,15,1978.96,4,5,4,13,Champions
10525,287,7,1878.68,2,1,4,7,Regulars
10526,141,9,1402.3,4,2,3,9,Regulars
10527,491,11,1502.1,1,3,3,7,Regulars
10528,92,7,695.45,4,1,1,6,Regulars
10529,48,10,3158.6000000000004,5,3,5,13,Loyal
10530,520,4,630.5500000000001,1,1,1,3,Hibernating
10531,101,8,1549.42,4,2,3,9,Regulars
10532,211,12,1343.54,3,4,3,10,Regulars
10533,408,8,1063.6000000000001,2,2,2,6,Hibernating
10534,129,8,1012.3299999999999,4,2,2,8,Regulars
10535,41,9,703.6,5,2,1,8,Regulars
10536,483,10,2078.83,1,3,4,8,Regulars
10537,232,8,554.82,3,2,1,6,Regulars
10538,72,10,2210.71,4,3,4,11,Loyal
10539,495,18,4056.02,1,5,5,11,At Risk
10540,211,10,2866.81,3,3,5,11,Big Spenders
10541,1099,8,834.58,1,2,1,4,Hibernating
10542,84,14,1743.14,4,5,4,13,Champions
10543,412,9,1178.55,2,2,2,6,Hibernating
10544,199,7,434.46999999999997,3,1,1,5,Regulars
10545,330,9,687.3,2,2,1,5,Hibernating
10546,202,7,535.61,3,1,1,5,Regulars
10547,373,12,2776.2,2,4,5,11,At Risk
10548,30,8,817.76,5,2,1,8,Regulars
10549,59,4,426.26000000000005,5,1,1,7,Regulars
10550,88,9,622.15,4,2,1,7,Regulars
10551,220,10,1940.57,3,3,4,10,Big Spenders
10552,267,11,2077.34,2,3,4,9,Regulars
10553,411,8,1106.45,2,2,2,6,Hibernating
10554,23,17,4401.94,5,5,5,15,Champions
10555,234,10,1967.3,3,3,4,10,Big Spenders
10556,255,10,6124.52,2,3,5,10,Regulars
10557,266,10,870.16,2,3,2,7,Regulars
10558,455,9,2138.0,2,2,4,8,Regulars
10559,25,9,3603.46,5,2,5,12,Big Spenders
10560,134,9,2468.8399999999997,4,2,4,10,Big Spenders
10561,404,10,1484.5500000000002,2,3,3,8,Regulars
10562,73,10,798.98,4,3,1,8,Loyal
10563,614,8,982.13,1,2,2,5,Hibernating
10564,53,9,767.99,5,2,1,8,Regulars
10565,1007,9,1627.76,1,2,3,6,Regulars
10566,395,5,894.96,2,1,2,5,Hibernating
10567,48,12,1472.79,5,4,3,12,Loyal
10568,683,9,756.58,1,2,1,4,Hibernating
10569,75,10,1272.26,4,3,3,10,Loyal
10570,45,10,721.71,5,3,1,9,Loyal
10571,257,11,4701.03,2,3,5,10,Regulars
10572,117,11,1184.85,4,3,2,9,Loyal
10573,117,10,1834.12,4,3,4,11,Loyal
10574,227,19,4838.52,3,5,5,13,Big Spenders
10575,347,15,3130.31,2,5,5,12,At Risk
10576,459,11,726.8199999999999,2,3,1,6,Regulars
10577,564,7,819.51,1,1,1,3,Hibernating
10578,148,8,1224.16,3,2,2,7,Regulars
10579,51,11,2347.8199999999997,5,3,4,12,Loyal
10580,145,8,629.3199999999999,4,2,1,7,Regulars
10581,646,17,6432.15,1,5,5,11,At Risk
10582,193,15,1578.58,3,5,3,11,Regulars
10583,189,11,3017.08,3,3,5,11,Big Spenders
10584,292,10,2614.29,2,3,5,10,Regulars
10585,12,10,693.4499999999999,5,3,1,9,Loyal
10586,496,7,1705.6399999999999,1,1,3,5,Regulars
10587,55,12,2047.49,5,4,4,13,Champions
10588,288,12,1278.55,2,4,3,9,At Risk
10589,202,6,589.96,3,1,1,5,Regulars
10590,276,13,2220.15,2,4,4,10,At Risk
10591,215,10,1625.47,3,3,3,9,Regulars
10592,0,15,4538.700000000001,5,5,5,15,Champions
10593,75,14,1617.19,4,5,3,12,Loyal
10594,165,10,1004.72,3,3,2,8,Regulars
10595,476,11,1077.35,1,3,2,6,Regulars
10596,153,10,1161.3,3,3,2,8,Regulars
10597,155,8,1368.32,3,2,3,8,Regulars
10598,99,6,2417.46,4,1,4,9,Big Spenders
10599,57,14,1281.1100000000001,5,5,3,13,Loyal
10600,829,6,765.45,1,1,1,3,Hibernating
10601,500,9,682.41,1,2,1,4,Hibernating
10602,233,10,1065.26,3,3,2,8,Regulars
10603,128,7,840.39,4,1,1,6,Regulars
10604,38,13,1177.6599999999999,5,4,2,11,Loyal
10605,350,14,2269.13,2,5,4,11,At Risk
10606,119,11,1723.31,4,3,3,10,Loyal
10607,65,7,627.02,5,1,1,7,Regulars
10608,125,16,3646.8199999999997,4,5,5,14,Champions
10609,434,9,2023.25,2,2,4,8,Regulars
10610,187,12,1590.71,3,4,3,10,Regulars
10611,1501,7,1073.15,1,1,2,4,Hibernating
10612,443,9,794.6,2,2,1,5,Hibernating
10613,305,11,2102.66,2,3,4,9,Regulars
10614,16,12,1474.66,5,4,3,12,Loyal
10615,49,16,1957.74,5,5,4,14,Champions
10616,1285,10,4143.57,1,3,5,9,Regulars
10617,1204,10,2000.11,1,3,4,8,Regulars
10618,1,14,2434.19,5,5,4,14,Champions
10619,867,13,1674.11,1,4,3,8,At Risk
10620,103,8,972.2,4,2,2,8,Regulars
10621,24,10,2720.18,5,3,5,13,Loyal
10622,154,10,1660.28,3,3,3,9,Regulars
10623,355,11,1205.43,2,3,2,7,Regulars
10624,26,8,929.73,5,2,2,9,Regulars
10625,1499,6,2584.19,1,1,5,7,Regulars
10626,59,10,2382.84,5,3,4,12,Loyal
10627,42,16,1878.71,5,5,4,14,Champions
10628,115,13,4409.46,4,4,5,13,Champions
10629,60,12,1219.7800000000002,5,4,2,11,Loyal
10630,193,14,1548.99,3,5,3,11,Regulars
10631,91,6,502.66,4,1,1,6,Regulars
10632,914,5,1040.03,1,1,2,4,Hibernating
10633,124,9,1844.53,4,2,4,10,Big Spenders
10634,132,11,1841.23,4,3,4,11,Loyal
10635,207,15,2398.06,3,5,4,12,Big Spenders
10636,167,9,991.24,3,2,2,7,Regulars
10637,351,18,3841.23,2,5,5,12,At Risk
10638,112,12,1239.3,4,4,2,10,Loyal
10639,1176,4,161.51999999999998,1,1,1,3,Hibernating
10640,202,9,1001.31,3,2,2,7,Regulars
10641,176,8,1682.44,3,2,3,8,Regulars
10642,121,8,1782.75,4,2,4,10,Big Spenders
10643,455,9,1010.74,2,2,2,6,Hibernating
10644,226,13,1093.3,3,4,2,9,Regulars
10645,541,12,1740.84,1,4,4,9,At Risk
10646,64,11,2116.64,5,3,4,12,Loyal
10647,607,11,3327.4300000000003,1,3,5,9,Regulars
10648,481,6,1663.25,1,1,3,5,Regulars
10649,122,11,1141.23,4,3,2,9,Loyal
10650,126,8,1740.09,4,2,4,10,Big Spenders
10651,815,5,2206.25,1,1,4,6,Regulars
10652,104,14,2125.51,4,5,4,13,Champions
10653,67,12,4134.75,4,4,5,13,Champions
10654,1,10,1669.99,5,3,3,11,Loyal
10655,11,13,1551.4199999999998,5,4,3,12,Loyal
10656,386,9,2827.71,2,2,5,9,Regulars
10657,145,19,9407.66,4,5,5,14,Champions
10658,206,9,1104.6,3,2,2,7,Regulars
10659,226,8,587.6,3,2,1,6,Regulars
10660,411,7,838.11,2,1,1,4,Hibernating
10661,128,11,1370.57,4,3,3,10,Loyal
10662,82,10,1299.47,4,3,3,10,Loyal
10663,36,13,1410.02,5,4,3,12,Loyal
10664,73,14,1918.41,4,5,4,13,Champions
10665,12,7,654.01,5,1,1,7,Regulars
10666,146,10,2329.95,4,3,4,11,Loyal
10667,234,15,1472.71,3,5,3,11,Regulars
10668,877,7,676.43,1,1,1,3,Hibernating
10669,74,12,1847.06,4,4,4,12,Champions
10670,337,10,2791.87,2,3,5,10,Regulars
10671,0,13,1981.3600000000001,5,4,4,13,Champions
10672,1007,9,1342.1499999999999,1,2,3,6,Regulars
10673,1342,4,561.0,1,1,1,3,Hibernating
10674,46,12,778.01,5,4,1,10,Loyal
10675,771,11,2248.34,1,3,4,8,Regulars
10676,277,6,660.87,2,1,1,4,Hibernating
10677,195,13,1725.18,3,4,3,10,Regulars
10678,78,12,2956.29,4,4,5,13,Champions
10679,1,11,988.73,5,3,2,10,Loyal
10680,482,8,1576.15,1,2,3,6,Regulars
10681,288,7,800.0300000000001,2,1,1,4,Hibernating
10682,448,7,832.31,2,1,1,4,Hibernating
10683,62,7,1048.73,5,1,2,8,Regulars
10684,20,12,3056.84,5,4,5,14,Champions
10685,191,5,296.99,3,1,1,5,Regulars
10686,68,13,1538.43,4,4,3,11,Loyal
10687,694,5,785.62,1,1,1,3,Hibernating
10688,170,12,1506.21,3,4,3,10,Regulars
10689,656,13,2115.33,1,4,4,9,At Risk
10690,126,7,4213.110000000001,4,1,5,10,Big Spenders
10691,344,9,1525.99,2,2,3,7,Regulars
10692,355,12,3254.56,2,4,5,11,At Risk
10693,267,5,690.15,2,1,1,4,Hibernating
10694,1250,7,1218.86,1,1,2,4,Hibernating
10695,705,10,1241.85,1,3,3,7,Regulars
10696,209,5,849.19,3,1,2,6,Regulars
10697,193,8,838.04,3,2,1,6,Regulars
10698,867,7,779.96,1,1,1,3,Hibernating
10699,16,10,2396.02,5,3,4,12,Loyal
10700,109,9,2195.88,4,2,4,10,Big Spenders
10701,12,11,1024.3600000000001,5,3,2,10,Loyal
10702,403,12,3508.59,2,4,5,11,At Risk
10703,234,10,838.08,3,3,1,7,Regulars
10704,1422,5,589.77,1,1,1,3,Hibernating
10705,184,7,904.77,3,1,2,6,Regulars
10706,149,15,1686.17,3,5,3,11,Regulars
10707,753,11,2483.2599999999998,1,3,4,8,Regulars
10708,1075,5,481.88,1,1,1,3,Hibernating
10709,94,8,593.96,4,2,1,7,Regulars
10710,198,11,2644.4500000000003,3,3,5,11,Big Spenders
10711,237,9,1229.06,3,2,2,7,Regulars
10712,573,11,1228.11,1,3,2,6,Regulars
10713,116,12,4241.67,4,4,5,13,Champions
10714,66,5,705.29,4,1,1,6,Regulars
10715,468,8,424.63,1,2,1,4,Hibernating
10716,150,13,2687.02,3,4,5,12,Big Spenders
10717,28,17,3563.65,5,5,5,15,Champions
10718,63,14,2075.57,5,5,4,14,Champions
10719,160,14,3579.34,3,5,5,13,Big Spenders
10720,94,7,618.62,4,1,1,6,Regulars
10721,305,10,1339.12,2,3,3,8,Regulars
10722,134,11,1628.47,4,3,3,10,Loyal
10723,876,9,1357.3899999999999,1,2,3,6,Regulars
10724,1978,2,114.45,1,1,1,3,Hibernating
10725,85,11,1491.15,4,3,3,10,Loyal
10726,131,10,1527.54,4,3,3,10,Loyal
10727,101,12,6859.15,4,4,5,13,Champions
10728,2215,3,519.82,1,1,1,3,Hibernating
10729,184,7,882.8000000000001,3,1,2,6,Regulars
10730,489,5,364.15,1,1,1,3,Hibernating
10731,40,15,1723.9399999999998,5,5,3,13,Loyal
10732,467,10,2525.25,1,3,4,8,Regulars
10733,454,13,2065.36,2,4,4,10,At Risk
10734,21,5,381.45,5,1,1,7,Regulars
10735,591,9,3569.1699999999996,1,2,5,8,Regulars
10736,329,14,4772.68,2,5,5,12,At Risk
10737,33,10,1575.0700000000002,5,3,3,11,Loyal
10738,156,11,1267.27,3,3,3,9,Regulars
10739,437,13,4076.17,2,4,5,11,At Risk
10740,57,12,1200.3200000000002,5,4,2,11,Loyal
10741,645,6,850.9000000000001,1,1,2,4,Hibernating
10742,58,9,1862.84,5,2,4,11,Big Spenders
10743,37,15,2271.4900000000002,5,5,4,14,Champions
10744,138,7,919.6500000000001,4,1,2,7,Regulars
10745,226,10,1430.3100000000002,3,3,3,9,Regulars
10746,244,10,1499.4099999999999,3,3,3,9,Regulars
10747,196,4,449.87,3,1,1,5,Regulars
10748,126,7,1409.1999999999998,4,1,3,8,Regulars
10749,159,8,736.69,3,2,1,6,Regulars
10750,471,11,1115.37,1,3,2,6,Regulars
10751,75,11,1136.33,4,3,2,9,Loyal
10752,372,9,665.43,2,2,1,5,Hibernating
10753,172,10,1456.17,3,3,3,9,Regulars
10754,535,10,896.7,1,3,2,6,Regulars
10755,100,11,1724.99,4,3,3,10,Loyal
10756,458,7,723.26,2,1,1,4,Hibernating
10757,102,12,3727.94,4,4,5,13,Champions
10758,500,6,976.3900000000001,1,1,2,4,Hibernating
10759,164,7,360.61,3,1,1,5,Regulars
10760,75,16,1926.86,4,5,4,13,Champions
10761,358,7,2371.6000000000004,2,1,4,7,Regulars
10762,520,18,3287.0099999999998,1,5,5,11,At Risk
10763,54,7,2943.2799999999997,5,1,5,11,Big Spenders
10764,238,8,2940.2,3,2,5,10,Big Spenders
10765,95,11,2963.58,4,3,5,12,Loyal
10766,129,14,1730.77,4,5,4,13,Champions
10767,116,15,2136.69,4,5,4,13,Champions
10768,196,14,1086.8999999999999,3,5,2,10,Regulars
10769,691,10,2176.47,1,3,4,8,Regulars
10770,272,9,1051.61,2,2,2,6,Hibernating
10771,123,12,927.6899999999999,4,4,2,10,Loyal
10772,238,12,818.35,3,4,1,8,Regulars
10773,747,5,170.0,1,1,1,3,Hibernating
10774,9,10,1081.77,5,3,2,10,Loyal
10775,12,10,1071.32,5,3,2,10,Loyal
10776,294,15,1104.35,2,5,2,9,At Risk
10777,400,10,838.42,2,3,1,6,Regulars
10778,566,11,2333.72,1,3,4,8,Regulars
10779,21,12,2153.56,5,4,4,13,Champions
10780,45,10,1064.66,5,3,2,10,Loyal
10781,202,11,843.9200000000001,3,3,1,7,Regulars
10782,202,9,2024.19,3,2,4,9,Big Spenders
10783,83,16,3327.1,4,5,5,14,Champions
10784,310,11,2643.37,2,3,5,10,Regulars
10785,665,9,1651.98,1,2,3,6,Regulars
10786,98,10,879.21,4,3,2,9,Loyal
10787,105,9,1522.8700000000001,4,2,3,9,Regulars
10788,579,8,1261.68,1,2,3,6,Regulars
10789,85,6,2998.67,4,1,5,10,Big Spenders
10790,583,5,728.99,1,1,1,3,Hibernating
10791,831,6,893.72,1,1,2,4,Hibernating
10792,5,9,3778.7699999999995,5,2,5,12,Big Spenders
10793,332,11,981.42,2,3,2,7,Regulars
10794,454,11,2242.0099999999998,2,3,4,9,Regulars
10795,493,13,1743.8899999999999,1,4,4,9,At Risk
10796,363,15,1945.99,2,5,4,11,At Risk
10797,274,11,1063.22,2,3,2,7,Regulars
10798,262,9,1123.5,2,2,2,6,Hibernating
10799,1001,7,676.0899999999999,1,1,1,3,Hibernating
10800,26,13,1216.1100000000001,5,4,2,11,Loyal
10801,380,7,454.71000000000004,2,1,1,4,Hibernating
10802,105,10,1934.82,4,3,4,11,Loyal
10803,103,10,1380.49,4,3,3,10,Loyal
10804,196,12,1196.3,3,4,2,9,Regulars
10805,224,14,1354.27,3,5,3,11,Regulars
10806,135,6,921.54,4,1,2,7,Regulars
10807,153,11,1574.3600000000001,3,3,3,9,Regulars
10808,105,9,1317.0900000000001,4,2,3,9,Regulars
10809,600,12,1473.05,1,4,3,8,At Risk
10810,190,10,1706.3200000000002,3,3,3,9,Regulars
10811,258,10,1189.04,2,3,2,7,Regulars
10812,195,12,2827.97,3,4,5,12,Big Spenders
10813,204,11,2119.69,3,3,4,10,Big Spenders
10814,188,9,1608.69,3,2,3,8,Regulars
10815,842,9,2578.3999999999996,1,2,5,8,Regulars
10816,296,13,1243.56,2,4,3,9,At Risk
10817,284,6,571.64,2,1,1,4,Hibernating
10818,885,7,1234.75,1,1,2,4,Hibernating
10819,65,9,1321.02,5,2,3,10,Regulars
10820,190,13,1073.18,3,4,2,9,Regulars
10821,604,16,2133.3399999999997,1,5,4,10,At Risk
10822,46,7,3803.27,5,1,5,11,Big Spenders
10823,192,8,1832.5000000000002,3,2,4,9,Big Spenders
10824,35,11,1441.51,5,3,3,11,Loyal
10825,416,7,710.45,2,1,1,4,Hibernating
10826,59,8,2447.18,5,2,4,11,Big Spenders
10827,179,12,1838.9099999999999,3,4,4,11,Big Spenders
10828,10,20,2636.13,5,5,5,15,Champions
10829,954,8,947.14,1,2,2,5,Hibernating
10830,434,15,1700.5,2,5,3,10,At Risk
10831,137,11,1491.29,4,3,3,10,Loyal
10832,10,9,1255.35,5,2,3,10,Regulars
10833,27,9,1235.99,5,2,2,9,Regulars
10834,705,6,1711.97,1,1,3,5,Regulars
10835,98,9,1442.08,4,2,3,9,Regulars
10836,147,9,1428.17,4,2,3,9,Regulars
10837,50,8,964.96,5,2,2,9,Regulars
10838,1169,4,176.97,1,1,1,3,Hibernating
10839,123,12,3080.89,4,4,5,13,Champions
10840,160,9,468.03,3,2,1,6,Regulars
10841,52,12,1032.41,5,4,2,11,Loyal
10842,91,11,1060.03,4,3,2,9,Loyal
10843,306,8,461.65,2,2,1,5,Hibernating
10844,735,7,809.94,1,1,1,3,Hibernating
10845,17,11,1145.8,5,3,2,10,Loyal
10846,44,17,1858.91,5,5,4,14,Champions
10847,258,10,3903.0,2,3,5,10,Regulars
10848,280,8,757.9399999999999,2,2,1,5,Hibernating
10849,367,6,838.59,2,1,1,4,Hibernating
10850,284,13,1198.27,2,4,2,8,At Risk
10851,20,11,2966.7200000000003,5,3,5,13,Loyal
10852,584,9,1162.3899999999999,1,2,2,5,Hibernating
10853,122,8,2085.94,4,2,4,10,Big Spenders
10854,426,8,1291.55,2,2,3,7,Regulars
10855,172,10,1055.58,3,3,2,8,Regulars
10856,490,6,1324.67,1,1,3,5,Regulars
10857,319,7,676.38,2,1,1,4,Hibernating
10858,246,8,1525.4,3,2,3,8,Regulars
10859,140,9,1114.53,4,2,2,8,Regulars
10860,437,9,1235.97,2,2,2,6,Hibernating
10861,265,8,3895.46,2,2,5,9,Regulars
10862,685,7,1772.12,1,1,4,6,Regulars
10863,307,11,2138.9300000000003,2,3,4,9,Regulars
10864,123,15,2574.99,4,5,5,14,Champions
10865,600,6,728.49,1,1,1,3,Hibernating
10866,194,7,564.44,3,1,1,5,Regulars
10867,813,6,558.86,1,1,1,3,Hibernating
10868,186,6,771.86,3,1,1,5,Regulars
10869,235,8,797.96,3,2,1,6,Regulars
10870,191,7,543.83,3,1,1,5,Regulars
10871,91,11,1136.46,4,3,2,9,Loyal
10872,311,11,1022.1700000000001,2,3,2,7,Regulars
10873,150,11,1001.3,3,3,2,8,Regulars
10874,372,13,2336.51,2,4,4,10,At Risk
10875,70,9,1959.64,4,2,4,10,Big Spenders
10876,167,9,1052.8400000000001,3,2,2,7,Regulars
10877,85,17,2295.9900000000002,4,5,4,13,Champions
10878,355,9,2871.24,2,2,5,9,Regulars
10879,122,14,5755.33,4,5,5,14,Champions
10880,233,16,2668.9300000000003,3,5,5,13,Big Spenders
10881,394,10,1738.83,2,3,4,9,Regulars
10882,191,8,1062.04,3,2,2,7,Regulars
10883,675,7,1729.72,1,1,4,6,Regulars
10884,22,13,1688.23,5,4,3,12,Loyal
10885,153,9,3826.59,3,2,5,10,Big Spenders
10886,447,8,498.7,2,2,1,5,Hibernating
10887,121,9,1006.68,4,2,2,8,Regulars
10888,265,12,1139.2,2,4,2,8,At Risk
10889,276,8,1789.0600000000002,2,2,4,8,Regulars
10890,54,9,3816.19,5,2,5,12,Big Spenders
10891,357,8,1321.93,2,2,3,7,Regulars
10892,59,12,3383.2599999999998,5,4,5,14,Champions
10893,1030,11,1932.11,1,3,4,8,Regulars
10894,37,13,1787.5399999999997,5,4,4,13,Champions
10895,229,11,3525.12,3,3,5,11,Big Spenders
10896,208,12,1143.5,3,4,2,9,Regulars
10897,456,13,2095.9,2,4,4,10,At Risk
10898,457,9,1216.7,2,2,2,6,Hibernating
10899,127,12,2826.9900000000002,4,4,5,13,Champions
10900,42,15,1065.57,5,5,2,12,Loyal
10901,227,9,3821.5,3,2,5,10,Big Spenders
10902,515,8,2022.0700000000002,1,2,4,7,Regulars
10903,183,11,905.84,3,3,2,8,Regulars
10904,118,7,2459.2200000000003,4,1,4,9,Big Spenders
10905,111,12,3497.08,4,4,5,13,Champions
10906,793,10,3560.7,1,3,5,9,Regulars
10907,223,11,1889.85,3,3,4,10,Big Spenders
10908,118,14,1821.33,4,5,4,13,Champions
10909,311,5,313.93,2,1,1,4,Hibernating
10910,207,9,667.86,3,2,1,6,Regulars
10911,361,8,978.7399999999999,2,2,2,6,Hibernating
10912,104,8,629.77,4,2,1,7,Regulars
10913,104,9,1723.95,4,2,3,9,Regulars
10914,90,14,1912.66,4,5,4,13,Champions
10915,226,14,1546.36,3,5,3,11,Regulars
10916,174,14,4226.7699999999995,3,5,5,13,Big Spenders
10917,149,12,1298.96,3,4,3,10,Regulars
10918,1409,2,83.58000000000001,1,1,1,3,Hibernating
10919,168,8,1537.41,3,2,3,8,Regulars
10920,156,10,938.7,3,3,2,8,Regulars
10921,124,10,2330.04,4,3,4,11,Loyal
10922,79,15,3306.82,4,5,5,14,Champions
10923,170,10,585.1500000000001,3,3,1,7,Regulars
10924,188,9,3788.77,3,2,5,10,Big Spenders
10925,216,16,1685.3,3,5,3,11,Regulars
10926,125,4,455.62999999999994,4,1,1,6,Regulars
10927,484,13,855.92,1,4,2,7,At Risk
10928,45,11,1789.42,5,3,4,12,Loyal
10929,99,11,1575.15,4,3,3,10,Loyal
10930,21,10,1256.44,5,3,3,11,Loyal
10931,63,13,1993.6,5,4,4,13,Champions
10932,139,6,1523.26,4,1,3,8,Regulars
10933,308,7,904.02,2,1,2,5,Hibernating
10934,934,11,4143.72,1,3,5,9,Regulars
10935,226,6,1250.17,3,1,3,7,Regulars
10936,797,13,3427.97,1,4,5,10,At Risk
10937,322,6,745.1,2,1,1,4,Hibernating
10938,787,6,725.06,1,1,1,3,Hibernating
10939,96,11,3366.02,4,3,5,12,Loyal
10940,2,11,3056.2999999999997,5,3,5,13,Loyal
10941,567,8,949.39,1,2,2,5,Hibernating
10942,211,10,2130.84,3,3,4,10,Big Spenders
10943,24,9,1689.68,5,2,3,10,Regulars
10944,177,6,2457.65,3,1,4,8,Big Spenders
10945,199,16,1887.4399999999998,3,5,4,12,Big Spenders
10946,19,11,1042.3,5,3,2,10,Loyal
10947,6,8,2319.71,5,2,4,11,Big Spenders
10948,231,10,812.86,3,3,1,7,Regulars
10949,783,11,1139.91,1,3,2,6,Regulars
10950,384,11,2238.97,2,3,4,9,Regulars
10951,6,9,988.32,5,2,2,9,Regulars
10952,110,9,723.64,4,2,1,7,Regulars
10953,249,12,1915.66,2,4,4,10,At Risk
10954,126,14,1233.49,4,5,2,11,Loyal
10955,30,14,4615.429999999999,5,5,5,15,Champions
10956,368,6,1141.5800000000002,2,1,2,5,Hibernating
10957,6,10,1314.4,5,3,3,11,Loyal
10958,82,12,4782.82,4,4,5,13,Champions
10959,306,4,806.5400000000001,2,1,1,4,Hibernating
10960,364,7,713.6,2,1,1,4,Hibernating
10961,97,11,1220.55,4,3,2,9,Loyal
10962,457,8,1358.41,2,2,3,7,Regulars
10963,213,7,679.65,3,1,1,5,Regulars
10964,168,11,1398.6499999999999,3,3,3,9,Regulars
10965,11,12,1294.95,5,4,3,12,Loyal
10966,489,10,910.0799999999999,1,3,2,6,Regulars
10967,211,11,1244.51,3,3,3,9,Regulars
10968,159,10,4057.85,3,3,5,11,Big Spenders
10969,442,13,3899.68,2,4,5,11,At Risk
10970,945,7,892.13,1,1,2,4,Hibernating
10971,543,7,902.5699999999999,1,1,2,4,Hibernating
10972,118,16,2071.26,4,5,4,13,Champions
10973,230,8,906.45,3,2,2,7,Regulars
10974,237,12,1908.45,3,4,4,11,Big Spenders
10975,144,10,1416.59,4,3,3,10,Loyal
10976,238,12,2179.16,3,4,4,11,Big Spenders
10977,77,9,1230.84,4,2,2,8,Regulars
10978,266,14,928.67,2,5,2,9,At Risk
10979,107,10,1203.83,4,3,2,9,Loyal
10980,561,5,1204.52,1,1,2,4,Hibernating
10981,323,15,1669.81,2,5,3,10,At Risk
10982,72,8,1122.89,4,2,2,8,Regulars
10983,317,10,1206.8400000000001,2,3,2,7,Regulars
10984,795,8,844.22,1,2,1,4,Hibernating
10985,34,16,2472.5,5,5,4,14,Champions
10986,124,12,3129.02,4,4,5,13,Champions
10987,1104,14,3633.21,1,5,5,11,At Risk
10988,138,12,1217.26,4,4,2,10,Loyal
10989,75,14,3512.03,4,5,5,14,Champions
10990,261,10,1029.08,2,3,2,7,Regulars
10991,193,5,666.19,3,1,1,5,Regulars
10992,332,14,4158.81,2,5,5,12,At Risk
10993,401,9,852.0899999999999,2,2,2,6,Hibernating
10994,589,10,872.8100000000001,1,3,2,6,Regulars
10995,66,15,5254.38,4,5,5,14,Champions
10996,71,14,3122.99,4,5,5,14,Champions
10997,734,12,1284.77,1,4,3,8,At Risk
10998,326,13,4540.54,2,4,5,11,At Risk
10999,602,15,5652.85,1,5,5,11,At Risk
11000,302,9,3310.02,2,2,5,9,Regulars
11001,142,7,656.63,4,1,1,6,Regulars
11002,213,7,519.95,3,1,1,5,Regulars
11003,421,9,2085.6,2,2,4,8,Regulars
11004,63,9,1498.92,5,2,3,10,Regulars
11005,604,11,905.32,1,3,2,6,Regulars
11006,143,14,1427.3899999999999,4,5,3,12,Loyal
11007,57,9,986.27,5,2,2,9,Regulars
11008,268,10,2302.0699999999997,2,3,4,9,Regulars
11009,41,10,773.0,5,3,1,9,Loyal
11010,388,9,615.81,2,2,1,5,Hibernating
11011,211,8,2319.2900000000004,3,2,4,9,Big Spenders
11012,91,13,1959.13,4,4,4,12,Champions
11013,11,10,895.66,5,3,2,10,Loyal
11014,835,11,1428.0500000000002,1,3,3,7,Regulars
11015,170,13,2563.16,3,4,4,11,Big Spenders
11016,7,11,611.6700000000001,5,3,1,9,Loyal
11017,420,11,4415.51,2,3,5,10,Regulars
11018,564,13,3711.7599999999998,1,4,5,10,At Risk
11019,10,10,1454.88,5,3,3,11,Loyal
11020,916,7,2145.49,1,1,4,6,Regulars
11021,264,11,586.53,2,3,1,6,Regulars
11022,4,15,3949.87,5,5,5,15,Champions
11023,670,9,2074.78,1,2,4,7,Regulars
11024,220,12,1679.2,3,4,3,10,Regulars
11025,79,8,1156.3600000000001,4,2,2,8,Regulars
11026,211,14,1819.9699999999998,3,5,4,12,Big Spenders
11027,446,12,2395.3399999999997,2,4,4,10,At Risk
11028,65,11,654.02,5,3,1,9,Loyal
11029,58,14,1516.93,5,5,3,13,Loyal
11030,441,8,912.14,2,2,2,6,Hibernating
11031,150,20,3684.56,3,5,5,13,Big Spenders
11032,229,12,1134.32,3,4,2,9,Regulars
11033,311,9,2949.89,2,2,5,9,Regulars
11034,229,11,1567.51,3,3,3,9,Regulars
11035,13,8,895.4599999999999,5,2,2,9,Regulars
11036,814,7,991.2299999999999,1,1,2,4,Hibernating
11037,166,11,4096.04,3,3,5,11,Big Spenders
11038,350,11,933.6299999999999,2,3,2,7,Regulars
11039,129,8,1209.04,4,2,2,8,Regulars
11040,91,13,2326.45,4,4,4,12,Champions
11041,31,13,1489.72,5,4,3,12,Loyal
11042,101,9,2286.38,4,2,4,10,Big Spenders
11043,376,7,1006.99,2,1,2,5,Hibernating
11044,56,13,1084.15,5,4,2,11,Loyal
11045,321,7,2563.77,2,1,4,7,Regulars
11046,473,11,1920.34,1,3,4,8,Regulars
11047,544,11,3894.09,1,3,5,9,Regulars
11048,453,13,1388.5,2,4,3,9,At Risk
11049,492,17,2379.6800000000003,1,5,4,10,At Risk
11050,1044,7,566.15,1,1,1,3,Hibernating
11051,187,12,4795.54,3,4,5,12,Big Spenders
11052,206,10,2101.6800000000003,3,3,4,10,Big Spenders
11053,110,9,3488.52,4,2,5,11,Big Spenders
11054,150,10,1523.46,3,3,3,9,Regulars
11055,547,12,823.93,1,4,1,6,At Risk
11056,1313,6,1532.77,1,1,3,5,Regulars
11057,17,5,632.54,5,1,1,7,Regulars
11058,101,5,590.22,4,1,1,6,Regulars
11059,90,10,3813.8699999999994,4,3,5,12,Loyal
11060,218,5,420.3999999999999,3,1,1,5,Regulars
11061,832,10,1392.76,1,3,3,7,Regulars
11062,265,9,1055.92,2,2,2,6,Hibernating
11063,195,12,3142.2599999999998,3,4,5,12,Big Spenders
11064,133,20,2805.5,4,5,5,14,Champions
11065,103,8,406.87,4,2,1,7,Regulars
11066,179,17,2349.12,3,5,4,12,Big Spenders
11067,138,8,529.89,4,2,1,7,Regulars
11068,50,14,1104.25,5,5,2,12,Loyal
11069,152,8,1739.08,3,2,4,9,Big Spenders
11070,152,12,1286.51,3,4,3,10,Regulars
11071,110,10,1948.1,4,3,4,11,Loyal
11072,493,9,850.87,1,2,2,5,Hibernating
11073,388,8,1894.55,2,2,4,8,Regulars
11074,233,11,1371.3,3,3,3,9,Regulars
11075,703,4,489.57,1,1,1,3,Hibernating
11076,50,13,1802.3700000000001,5,4,4,13,Champions
11077,50,17,1258.06,5,5,3,13,Loyal
11078,143,11,1501.66,4,3,3,10,Loyal
11079,137,14,1061.32,4,5,2,11,Loyal
11080,141,9,4644.01,4,2,5,11,Big Spenders
11081,175,10,1209.8000000000002,3,3,2,8,Regulars
11082,446,3,253.73000000000002,2,1,1,4,Hibernating
11083,235,8,982.68,3,2,2,7,Regulars
11084,119,12,4234.16,4,4,5,13,Champions
11085,250,8,875.81,2,2,2,6,Hibernating
11086,236,7,2427.92,3,1,4,8,Big Spenders
11087,6,11,1535.9399999999998,5,3,3,11,Loyal
11088,263,10,1755.45,2,3,4,9,Regulars
11089,2,14,1115.46,5,5,2,12,Loyal
11090,218,13,1105.26,3,4,2,9,Regulars
11091,10,11,1669.66,5,3,3,11,Loyal
11092,42,10,1198.65,5,3,2,10,Loyal
11093,132,10,2937.01,4,3,5,12,Loyal
11094,149,10,993.0,3,3,2,8,Regulars
11095,72,11,1151.82,4,3,2,9,Loyal
11096,128,8,1841.06,4,2,4,10,Big Spenders
11097,627,10,1325.68,1,3,3,7,Regulars
11098,60,11,2655.8500000000004,5,3,5,13,Loyal
11099,127,7,831.8800000000001,4,1,1,6,Regulars
11100,119,10,2736.66,4,3,5,12,Loyal
11101,352,13,1019.13,2,4,2,8,At Risk
11102,1438,10,3481.4800000000005,1,3,5,9,Regulars
11103,302,12,2448.5,2,4,4,10,At Risk
11104,447,10,1694.01,2,3,3,8,Regulars
11105,144,8,1252.0800000000002,4,2,3,9,Regulars
11106,704,11,725.85,1,3,1,5,Regulars
11107,102,10,1312.54,4,3,3,10,Loyal
11108,149,12,1476.76,3,4,3,10,Regulars
11109,538,8,900.94,1,2,2,5,Hibernating
11110,177,9,2150.32,3,2,4,9,Big Spenders
11111,295,11,1998.05,2,3,4,9,Regulars
11112,371,7,2341.6400000000003,2,1,4,7,Regulars
11113,455,14,3066.91,2,5,5,12,At Risk
11114,180,10,1056.84,3,3,2,8,Regulars
11115,156,14,1669.95,3,5,3,11,Regulars
11116,201,7,1595.89,3,1,3,7,Regulars
11117,424,15,1314.4099999999999,2,5,3,10,At Risk
11118,444,12,1184.47,2,4,2,8,At Risk
11119,112,7,761.95,4,1,1,6,Regulars
11120,245,7,1030.51,3,1,2,6,Regulars
11121,125,10,2535.14,4,3,4,11,Loyal
11122,368,7,1457.8000000000002,2,1,3,6,Regulars
11123,1078,8,1482.16,1,2,3,6,Regulars
11124,790,7,1303.8,1,1,3,5,Regulars
11125,48,17,2388.2400000000002,5,5,4,14,Champions
11126,523,11,1403.98,1,3,3,7,Regulars
11127,241,17,2406.63,3,5,4,12,Big Spenders
11128,75,8,642.69,4,2,1,7,Regulars
11129,443,9,1330.01,2,2,3,7,Regulars
11130,52,12,4138.47,5,4,5,14,Champions
11131,372,9,935.5799999999999,2,2,2,6,Hibernating
11132,1005,8,3601.4500000000003,1,2,5,8,Regulars
11133,268,12,1533.51,2,4,3,9,At Risk
11134,116,12,1990.31,4,4,4,12,Champions
11135,165,9,821.11,3,2,1,6,Regulars
11136,11,12,3194.09,5,4,5,14,Champions
11137,124,11,3964.8,4,3,5,12,Loyal
11138,43,12,1612.46,5,4,3,12,Loyal
11139,537,15,2139.74,1,5,4,10,At Risk
11140,644,8,704.05,1,2,1,4,Hibernating
11141,140,18,1956.98,4,5,4,13,Champions
11142,1316,8,1407.3200000000002,1,2,3,6,Regulars
11143,82,7,2724.75,4,1,5,10,Big Spenders
11144,1221,4,975.07,1,1,2,4,Hibernating
11145,671,8,2661.42,1,2,5,8,Regulars
11146,195,12,1224.8899999999999,3,4,2,9,Regulars
11147,522,8,960.69,1,2,2,5,Hibernating
11148,774,8,3495.3699999999994,1,2,5,8,Regulars
11149,253,10,1244.32,2,3,3,8,Regulars
11150,86,10,3782.91,4,3,5,12,Loyal
11151,20,11,728.86,5,3,1,9,Loyal
11152,1053,6,2273.5499999999997,1,1,4,6,Regulars
11153,49,10,1881.52,5,3,4,12,Loyal
11154,222,8,958.12,3,2,2,7,Regulars
11155,14,7,1010.16,5,1,2,8,Regulars
11156,84,6,376.15,4,1,1,6,Regulars
11157,57,10,1516.42,5,3,3,11,Loyal
11158,201,10,679.95,3,3,1,7,Regulars
11159,558,12,2903.42,1,4,5,10,At Risk
11160,105,14,2474.02,4,5,4,13,Champions
11161,108,15,1617.13,4,5,3,12,Loyal
11162,191,10,654.28,3,3,1,7,Regulars
11163,617,10,3357.1400000000003,1,3,5,9,Regulars
11164,36,13,1288.6599999999999,5,4,3,12,Loyal
11165,432,8,902.51,2,2,2,6,Hibernating
11166,195,9,631.73,3,2,1,6,Regulars
11167,35,7,881.25,5,1,2,8,Regulars
11168,8,16,1828.1000000000001,5,5,4,14,Champions
11169,585,11,1131.04,1,3,2,6,Regulars
11170,315,8,1098.06,2,2,2,6,Hibernating
11171,382,11,803.35,2,3,1,6,Regulars
11172,224,10,6632.06,3,3,5,11,Big Spenders
11173,64,8,2087.32,5,2,4,11,Big Spenders
11174,1497,8,1299.5900000000001,1,2,3,6,Regulars
11175,356,10,813.15,2,3,1,6,Regulars
11176,301,10,963.6300000000001,2,3,2,7,Regulars
11177,105,13,2938.8,4,4,5,13,Champions
11178,290,10,1174.82,2,3,2,7,Regulars
11179,8,11,1221.0,5,3,2,10,Loyal
11180,226,9,975.21,3,2,2,7,Regulars
11181,211,18,4106.71,3,5,5,13,Big Spenders
11182,299,8,774.63,2,2,1,5,Hibernating
11183,70,8,1815.1299999999999,4,2,4,10,Big Spenders
11184,100,9,973.11,4,2,2,8,Regulars
11185,109,12,1268.95,4,4,3,11,Loyal
11186,16,14,2152.86,5,5,4,14,Champions
11187,299,16,2657.76,2,5,5,12,At Risk
11188,402,11,768.15,2,3,1,6,Regulars
11189,247,14,1763.49,3,5,4,12,Big Spenders
11190,485,14,3148.86,1,5,5,11,At Risk
11191,248,9,917.1800000000001,2,2,2,6,Hibernating
11192,557,11,1508.8,1,3,3,7,Regulars
11193,65,14,1036.25,5,5,2,12,Loyal
11194,142,5,349.27,4,1,1,6,Regulars
11195,143,9,2674.91,4,2,5,11,Big Spenders
11196,35,13,2640.54,5,4,5,14,Champions
11197,639,14,1787.4299999999998,1,5,4,10,At Risk
11198,773,3,496.44000000000005,1,1,1,3,Hibernating
11199,455,12,2217.65,2,4,4,10,At Risk
11200,492,10,1265.92,1,3,3,7,Regulars
11201,231,5,1011.33,3,1,2,6,Regulars
11202,2,14,4368.17,5,5,5,15,Champions
11203,103,11,1299.03,4,3,3,10,Loyal
11204,138,7,1031.79,4,1,2,7,Regulars
11205,421,8,1173.11,2,2,2,6,Hibernating
11206,349,6,326.19,2,1,1,4,Hibernating
11207,264,18,2269.06,2,5,4,11,At Risk
11208,11,9,1268.32,5,2,3,10,Regulars
11209,172,15,3314.0,3,5,5,13,Big Spenders
11210,1212,6,620.98,1,1,1,3,Hibernating
11211,263,7,4198.2,2,1,5,8,Regulars
11212,330,11,2386.05,2,3,4,9,Regulars
11213,245,8,2048.2,3,2,4,9,Big Spenders
11214,126,15,1321.15,4,5,3,12,Loyal
11215,21,9,3677.63,5,2,5,12,Big Spenders
11216,495,7,1151.1200000000001,1,1,2,4,Hibernating
11217,161,9,2290.71,3,2,4,9,Big Spenders
11218,950,6,601.73,1,1,1,3,Hibernating
11219,6,15,3262.9900000000002,5,5,5,15,Champions
11220,236,8,444.88,3,2,1,6,Regulars
11221,335,13,3357.81,2,4,5,11,At Risk
11222,243,12,2195.06,3,4,4,11,Big Spenders
11223,308,9,1109.79,2,2,2,6,Hibernating
11224,85,15,1775.8400000000001,4,5,4,13,Champions
11225,391,12,1036.11,2,4,2,8,At Risk
11226,215,6,848.26,3,1,2,6,Regulars
11227,284,15,4794.9800000000005,2,5,5,12,At Risk
11228,259,12,1654.55,2,4,3,9,At Risk
11229,10,10,3535.4,5,3,5,13,Loyal
11230,56,11,2591.85,5,3,5,13,Loyal
11231,120,8,1005.35,4,2,2,8,Regulars
11232,583,12,2977.41,1,4,5,10,At Risk
11233,1,8,1876.79,5,2,4,11,Big Spenders
11234,26,13,1724.5,5,4,3,12,Loyal
11235,22,21,5712.28,5,5,5,15,Champions
11236,70,13,1636.28,4,4,3,11,Loyal
11237,38,8,1423.37,5,2,3,10,Regulars
11238,61,7,1044.96,5,1,2,8,Regulars
11239,550,9,835.14,1,2,1,4,Hibernating
11240,239,12,2397.21,3,4,4,11,Big Spenders
11241,681,7,553.11,1,1,1,3,Hibernating
11242,1870,4,272.37,1,1,1,3,Hibernating
11243,505,7,693.14,1,1,1,3,Hibernating
11244,322,13,3367.3199999999997,2,4,5,11,At Risk
11245,909,10,732.21,1,3,1,5,Regulars
11246,667,8,4611.39,1,2,5,8,Regulars
11247,186,10,3182.7,3,3,5,11,Big Spenders
11248,78,9,1008.31,4,2,2,8,Regulars
11249,249,7,1079.8200000000002,2,1,2,5,Hibernating
11250,211,10,3402.37,3,3,5,11,Big Spenders
11251,75,10,1308.3799999999999,4,3,3,10,Loyal
11252,184,9,781.96,3,2,1,6,Regulars
11253,175,9,1578.73,3,2,3,8,Regulars
11254,642,5,333.27,1,1,1,3,Hibernating
11255,561,11,2800.8,1,3,5,9,Regulars
11256,66,9,1528.05,4,2,3,9,Regulars
11257,587,5,724.6800000000001,1,1,1,3,Hibernating
11258,701,12,5053.8,1,4,5,10,At Risk
11259,477,15,2707.09,1,5,5,11,At Risk
11260,105,13,1247.1299999999999,4,4,3,11,Loyal
11261,60,9,3468.71,5,2,5,12,Big Spenders
11262,195,16,7223.41,3,5,5,13,Big Spenders
11263,100,12,2177.67,4,4,4,12,Champions
11264,236,7,1798.79,3,1,4,8,Big Spenders
11265,610,8,874.12,1,2,2,5,Hibernating
11266,512,8,1421.13,1,2,3,6,Regulars
11267,236,10,3138.54,3,3,5,11,Big Spenders
11268,210,7,1301.89,3,1,3,7,Regulars
11269,8,6,1034.17,5,1,2,8,Regulars
11270,60,10,1405.51,5,3,3,11,Loyal
11271,15,10,1358.78,5,3,3,11,Loyal
11272,155,5,1356.1,3,1,3,7,Regulars
11273,4,16,3111.81,5,5,5,15,Champions
11274,77,9,822.65,4,2,1,7,Regulars
11275,72,8,675.29,4,2,1,7,Regulars
11276,218,7,849.76,3,1,2,6,Regulars
11277,538,11,1046.8600000000001,1,3,2,6,Regulars
11278,327,11,2404.66,2,3,4,9,Regulars
11279,90,8,1542.29,4,2,3,9,Regulars
11280,532,9,1640.16,1,2,3,6,Regulars
11281,848,10,3411.5000000000005,1,3,5,9,Regulars
11282,204,14,1299.17,3,5,3,11,Regulars
11283,151,10,2273.8,3,3,4,10,Big Spenders
11284,187,10,2258.67,3,3,4,10,Big Spenders
11285,911,4,924.5200000000001,1,1,2,4,Hibernating
11286,757,12,1439.75,1,4,3,8,At Risk
11287,338,13,1229.31,2,4,2,8,At Risk
11288,122,12,1165.31,4,4,2,10,Loyal
11289,343,14,1392.59,2,5,3,10,At Risk
11290,31,13,4256.93,5,4,5,14,Champions
11291,255,11,2687.82,2,3,5,10,Regulars
11292,7,11,1241.03,5,3,2,10,Loyal
11293,476,6,4439.25,1,1,5,7,Regulars
11294,50,14,2889.99,5,5,5,15,Champions
11295,3,10,1870.23,5,3,4,12,Loyal
11296,6,4,682.1700000000001,5,1,1,7,Regulars
11297,203,7,892.6500000000001,3,1,2,6,Regulars
11298,547,7,458.85,1,1,1,3,Hibernating
11299,90,11,1184.31,4,3,2,9,Loyal
11300,126,15,4765.67,4,5,5,14,Champions
11301,449,14,2531.33,2,5,4,11,At Risk
11302,25,7,637.39,5,1,1,7,Regulars
11303,251,7,933.3,2,1,2,5,Hibernating
11304,118,9,943.09,4,2,2,8,Regulars
11305,92,17,1451.06,4,5,3,12,Loyal
11306,564,6,529.59,1,1,1,3,Hibernating
11307,118,9,1941.42,4,2,4,10,Big Spenders
11308,71,17,1801.68,4,5,4,13,Champions
11309,96,9,1084.04,4,2,2,8,Regulars
11310,221,7,2577.36,3,1,5,9,Big Spenders
11311,304,9,1327.92,2,2,3,7,Regulars
11312,984,7,845.56,1,1,2,4,Hibernating
11313,170,6,527.82,3,1,1,5,Regulars
11314,91,13,2719.1299999999997,4,4,5,13,Champions
11315,49,10,1625.43,5,3,3,11,Loyal
11316,2,13,1493.72,5,4,3,12,Loyal
11317,105,11,801.28,4,3,1,8,Loyal
11318,42,11,875.74,5,3,2,10,Loyal
11319,187,11,717.94,3,3,1,7,Regulars
11320,75,10,1941.03,4,3,4,11,Loyal
11321,24,5,457.8,5,1,1,7,Regulars
11322,145,11,612.26,4,3,1,8,Loyal
11323,229,15,1462.22,3,5,3,11,Regulars
11324,272,10,1772.78,2,3,4,9,Regulars
11325,675,5,388.03999999999996,1,1,1,3,Hibernating
11326,681,9,2551.75,1,2,4,7,Regulars
11327,777,10,695.24,1,3,1,5,Regulars
11328,91,13,1155.54,4,4,2,10,Loyal
11329,5,8,3493.8099999999995,5,2,5,12,Big Spenders
11330,172,15,4620.78,3,5,5,13,Big Spenders
11331,81,15,3051.31,4,5,5,14,Champions
11332,232,13,1146.22,3,4,2,9,Regulars
11333,119,8,848.67,4,2,2,8,Regulars
11334,121,15,2340.91,4,5,4,13,Champions
11335,226,9,504.53999999999996,3,2,1,6,Regulars
11336,667,11,1647.7,1,3,3,7,Regulars
11337,315,15,1655.79,2,5,3,10,At Risk
11338,1744,4,330.83,1,1,1,3,Hibernating
11339,427,14,2211.92,2,5,4,11,At Risk
11340,89,10,989.61,4,3,2,9,Loyal
11341,0,11,793.87,5,3,1,9,Loyal
11342,260,15,1227.11,2,5,2,9,At Risk
11343,242,11,2762.85,3,3,5,11,Big Spenders
11344,421,9,825.09,2,2,1,5,Hibernating
11345,628,9,3074.9700000000003,1,2,5,8,Regulars
11346,1641,6,2672.43,1,1,5,7,Regulars
11347,89,10,2957.8599999999997,4,3,5,12,Loyal
11348,82,5,640.75,4,1,1,6,Regulars
11349,788,7,1194.0600000000002,1,1,2,4,Hibernating
11350,34,8,2575.95,5,2,5,12,Big Spenders
11351,519,6,275.70000000000005,1,1,1,3,Hibernating
11352,2,10,1082.17,5,3,2,10,Loyal
11353,191,11,2110.25,3,3,4,10,Big Spenders
11354,240,10,973.93,3,3,2,8,Regulars
11355,44,12,1021.0899999999999,5,4,2,11,Loyal
11356,580,10,2635.5499999999997,1,3,5,9,Regulars
11357,324,12,1383.3600000000001,2,4,3,9,At Risk
11358,51,12,2691.62,5,4,5,14,Champions
11359,12,8,3778.8599999999997,5,2,5,12,Big Spenders
11360,135,12,2038.41,4,4,4,12,Champions
11361,446,9,1195.38,2,2,2,6,Hibernating
11362,96,12,891.34,4,4,2,10,Loyal
11363,675,9,2162.19,1,2,4,7,Regulars
11364,110,12,2625.51,4,4,5,13,Champions
11365,143,19,5630.47,4,5,5,14,Champions
11366,3,13,947.28,5,4,2,11,Loyal
11367,90,11,3487.8199999999997,4,3,5,12,Loyal
11368,1159,4,1279.61,1,1,3,5,Regulars
11369,323,12,1650.1100000000001,2,4,3,9,At Risk
11370,252,4,347.57,2,1,1,4,Hibernating
11371,460,9,642.25,1,2,1,4,Hibernating
11372,156,14,1504.3899999999999,3,5,3,11,Regulars
11373,148,6,706.28,3,1,1,5,Regulars
11374,262,9,1091.52,2,2,2,6,Hibernating
11375,362,11,934.9499999999999,2,3,2,7,Regulars
11376,124,15,4772.29,4,5,5,14,Champions
11377,595,9,1890.4,1,2,4,7,Regulars
11378,323,10,1886.77,2,3,4,9,Regulars
11379,710,7,1389.47,1,1,3,5,Regulars
11380,175,14,1552.59,3,5,3,11,Regulars
11381,499,9,984.3299999999999,1,2,2,5,Hibernating
11382,580,9,1056.92,1,2,2,5,Hibernating
11383,72,19,3800.16,4,5,5,14,Champions
11384,214,9,1565.22,3,2,3,8,Regulars
11385,336,12,2454.46,2,4,4,10,At Risk
11386,410,10,2253.86,2,3,4,9,Regulars
11387,66,13,4854.4400000000005,4,4,5,13,Champions
11388,114,9,797.21,4,2,1,7,Regulars
11389,67,4,878.1800000000001,4,1,2,7,Regulars
11390,468,14,2407.88,1,5,4,10,At Risk
11391,83,13,935.3000000000001,4,4,2,10,Loyal
11392,505,7,944.52,1,1,2,4,Hibernating
11393,74,13,1189.25,4,4,2,10,Loyal
11394,75,9,1146.12,4,2,2,8,Regulars
11395,401,3,123.56,2,1,1,4,Hibernating
11396,954,9,1224.5700000000002,1,2,2,5,Hibernating
11397,224,6,834.1899999999999,3,1,1,5,Regulars
11398,514,10,1160.15,1,3,2,6,Regulars
11399,449,7,1069.3899999999999,2,1,2,5,Hibernating
11400,797,10,779.2800000000001,1,3,1,5,Regulars
11401,1324,5,490.1,1,1,1,3,Hibernating
11402,118,8,3353.22,4,2,5,11,Big Spenders
11403,765,7,3176.2799999999997,1,1,5,7,Regulars
11404,41,17,2550.4300000000003,5,5,4,14,Champions
11405,14,11,2303.5,5,3,4,12,Loyal
11406,2373,2,43.57,1,1,1,3,Hibernating
11407,231,8,755.09,3,2,1,6,Regulars
11408,0,9,876.89,5,2,2,9,Regulars
11409,220,13,1292.33,3,4,3,10,Regulars
11410,72,9,599.53,4,2,1,7,Regulars
11411,7,18,1920.59,5,5,4,14,Champions
11412,250,7,303.37,2,1,1,4,Hibernating
11413,438,9,750.37,2,2,1,5,Hibernating
11414,24,13,5875.37,5,4,5,14,Champions
11415,173,11,1801.01,3,3,4,10,Big Spenders
11416,782,13,1623.64,1,4,3,8,At Risk
11417,866,12,1809.57,1,4,4,9,At Risk
11418,771,9,1787.81,1,2,4,7,Regulars
11419,126,8,1707.81,4,2,3,9,Regulars
11420,283,10,1791.6299999999999,2,3,4,9,Regulars
11421,635,6,625.89,1,1,1,3,Hibernating
11422,279,9,1419.23,2,2,3,7,Regulars
11423,101,14,1305.6599999999999,4,5,3,12,Loyal
11424,1334,4,648.35,1,1,1,3,Hibernating
11425,186,5,443.69,3,1,1,5,Regulars
11426,372,7,2957.18,2,1,5,8,Regulars
11427,305,8,1246.69,2,2,3,7,Regulars
11428,297,8,1577.1599999999999,2,2,3,7,Regulars
11429,220,14,874.43,3,5,2,10,Regulars
11430,195,11,1860.2,3,3,4,10,Big Spenders
11431,933,10,3580.66,1,3,5,9,Regulars
11432,143,17,4449.03,4,5,5,14,Champions
11433,162,9,751.33,3,2,1,6,Regulars
11434,410,15,4547.26,2,5,5,12,At Risk
11435,97,9,651.34,4,2,1,7,Regulars
11436,105,8,2021.1100000000001,4,2,4,10,Big Spenders
11437,279,12,2601.5299999999997,2,4,5,11,At Risk
11438,186,14,1366.33,3,5,3,11,Regulars
11439,649,8,1416.86,1,2,3,6,Regulars
11440,312,10,1293.33,2,3,3,8,Regulars
11441,135,12,1660.0900000000001,4,4,3,11,Loyal
11442,711,8,922.27,1,2,2,5,Hibernating
11443,45,15,1692.3400000000001,5,5,3,13,Loyal
11444,425,13,871.41,2,4,2,8,At Risk
11445,7,12,1125.71,5,4,2,11,Loyal
11446,896,11,1653.45,1,3,3,7,Regulars
11447,176,11,5403.2,3,3,5,11,Big Spenders
11448,422,10,1125.55,2,3,2,7,Regulars
11449,194,9,1760.3600000000001,3,2,4,9,Big Spenders
11450,55,8,1097.32,5,2,2,9,Regulars
11451,196,13,3695.3599999999997,3,4,5,12,Big Spenders
11452,162,12,1501.47,3,4,3,10,Regulars
11453,36,18,5802.99,5,5,5,15,Champions
11454,373,14,2563.74,2,5,4,11,At Risk
11455,623,13,1896.12,1,4,4,9,At Risk
11456,228,12,1714.86,3,4,3,10,Regulars
11457,398,7,1251.19,2,1,3,6,Regulars
11458,226,12,3195.76,3,4,5,12,Big Spenders
11459,233,10,634.9,3,3,1,7,Regulars
11460,146,10,1987.81,4,3,4,11,Loyal
11461,481,10,1450.54,1,3,3,7,Regulars
11462,130,7,1184.68,4,1,2,7,Regulars
11463,425,7,674.03,2,1,1,4,Hibernating
11464,354,10,3906.0400000000004,2,3,5,10,Regulars
11465,250,18,1582.52,2,5,3,10,At Risk
11466,447,10,1136.69,2,3,2,7,Regulars
11467,182,14,1548.4,3,5,3,11,Regulars
11468,822,7,327.49,1,1,1,3,Hibernating
11469,834,8,425.63,1,2,1,4,Hibernating
11470,393,12,1318.3300000000002,2,4,3,9,At Risk
11471,33,12,1147.01,5,4,2,11,Loyal
11472,42,17,2294.78,5,5,4,14,Champions
11473,880,5,973.97,1,1,2,4,Hibernating
11474,133,19,2047.0200000000002,4,5,4,13,Champions
11475,26,13,1315.3600000000001,5,4,3,12,Loyal
11476,268,11,1021.97,2,3,2,7,Regulars
11477,188,15,1839.24,3,5,4,12,Big Spenders
11478,467,11,1405.43,1,3,3,7,Regulars
11479,235,7,1048.44,3,1,2,6,Regulars
11480,25,11,1264.56,5,3,3,11,Loyal
11481,88,12,2205.48,4,4,4,12,Champions
11482,289,8,2049.35,2,2,4,8,Regulars
11483,348,9,1722.78,2,2,3,7,Regulars
11484,331,11,3073.64,2,3,5,10,Regulars
11485,243,8,808.49,3,2,1,6,Regulars
11486,34,11,1406.75,5,3,3,11,Loyal
11487,34,13,3223.52,5,4,5,14,Champions
11488,313,7,622.5899999999999,2,1,1,4,Hibernating
11489,288,9,1358.31,2,2,3,7,Regulars
11490,128,11,855.99,4,3,2,9,Loyal
11491,228,9,1273.0900000000001,3,2,3,8,Regulars
11492,108,11,699.84,4,3,1,8,Loyal
11493,912,8,1060.23,1,2,2,5,Hibernating
11494,129,15,2102.55,4,5,4,13,Champions
11495,62,9,762.15,5,2,1,8,Regulars
11496,825,10,1867.58,1,3,4,8,Regulars
11497,104,9,1003.79,4,2,2,8,Regulars
11498,737,9,1613.99,1,2,3,6,Regulars
11499,625,8,470.09999999999997,1,2,1,4,Hibernating
11500,90,7,917.5799999999999,4,1,2,7,Regulars
11501,278,12,1366.1100000000001,2,4,3,9,At Risk
11502,1273,6,844.83,1,1,2,4,Hibernating
11503,482,8,1667.03,1,2,3,6,Regulars
11504,152,7,2947.3999999999996,3,1,5,9,Big Spenders
11505,14,16,1540.95,5,5,3,13,Loyal
11506,460,13,1613.52,1,4,3,8,At Risk
11507,123,5,496.0,4,1,1,6,Regulars
11508,204,5,111.02000000000001,3,1,1,5,Regulars
11509,100,12,3643.92,4,4,5,13,Champions
11510,91,13,1774.54,4,4,4,12,Champions
11511,602,9,635.9599999999999,1,2,1,4,Hibernating
11512,134,9,1476.8300000000002,4,2,3,9,Regulars
11513,88,13,1554.3,4,4,3,11,Loyal
11514,85,11,2053.37,4,3,4,11,Loyal
11515,391,9,449.61,2,2,1,5,Hibernating
11516,387,4,207.95,2,1,1,4,Hibernating
11517,35,16,4094.7,5,5,5,15,Champions
11518,464,12,1771.83,1,4,4,9,At Risk
11519,276,12,924.9499999999999,2,4,2,8,At Risk
11520,977,9,1904.17,1,2,4,7,Regulars
11521,294,7,1449.8999999999999,2,1,3,6,Regulars
11522,812,9,1162.23,1,2,2,5,Hibernating
11523,935,10,751.8499999999999,1,3,1,5,Regulars
11524,156,13,1340.96,3,4,3,10,Regulars
11525,94,12,3482.0099999999998,4,4,5,13,Champions
11526,49,11,1476.23,5,3,3,11,Loyal
11527,877,11,548.16,1,3,1,5,Regulars
11528,154,5,473.15,3,1,1,5,Regulars
11529,409,9,993.6300000000001,2,2,2,6,Hibernating
11530,45,11,3977.89,5,3,5,13,Loyal
11531,229,11,4049.8,3,3,5,11,Big Spenders
11532,8,9,3706.9300000000003,5,2,5,12,Big Spenders
11533,63,6,791.77,5,1,1,7,Regulars
11534,70,10,1050.7,4,3,2,9,Loyal
11535,98,7,575.33,4,1,1,6,Regulars
11536,198,11,2142.2799999999997,3,3,4,10,Big Spenders
11537,308,7,731.67,2,1,1,4,Hibernating
11538,127,12,1664.42,4,4,3,11,Loyal
11539,245,10,1031.1100000000001,3,3,2,8,Regulars
11540,695,3,410.7,1,1,1,3,Hibernating
11541,50,5,610.02,5,1,1,7,Regulars
11542,70,10,1299.58,4,3,3,10,Loyal
11543,718,7,359.65,1,1,1,3,Hibernating
11544,195,10,534.82,3,3,1,7,Regulars
11545,213,10,648.9,3,3,1,7,Regulars
11546,80,9,1142.22,4,2,2,8,Regulars
11547,254,7,1278.9,2,1,3,6,Regulars
11548,3,6,721.0600000000001,5,1,1,7,Regulars
11549,135,9,1828.4,4,2,4,10,Big Spenders
11550,138,16,1391.81,4,5,3,12,Loyal
11551,0,12,1290.43,5,4,3,12,Loyal
11552,56,8,2282.83,5,2,4,11,Big Spenders
11553,15,11,3023.56,5,3,5,13,Loyal
11554,161,14,2861.56,3,5,5,13,Big Spenders
11555,100,7,520.27,4,1,1,6,Regulars
11556,473,8,789.41,1,2,1,4,Hibernating
11557,2041,4,328.59000000000003,1,1,1,3,Hibernating
11558,667,8,1039.33,1,2,2,5,Hibernating
11559,216,12,2506.48,3,4,4,11,Big Spenders
11560,315,9,863.02,2,2,2,6,Hibernating
11561,453,6,3121.9900000000002,2,1,5,8,Regulars
11562,215,11,958.39,3,3,2,8,Regulars
11563,534,9,3151.1,1,2,5,8,Regulars
11564,526,11,5948.46,1,3,5,9,Regulars
11565,31,10,1928.21,5,3,4,12,Loyal
11566,164,15,3339.23,3,5,5,13,Big Spenders
11567,379,9,1072.65,2,2,2,6,Hibernating
11568,197,13,1656.8400000000001,3,4,3,10,Regulars
11569,95,11,1001.09,4,3,2,9,Loyal
11570,652,9,1201.23,1,2,2,5,Hibernating
11571,198,8,1825.56,3,2,4,9,Big Spenders
11572,87,13,1408.96,4,4,3,11,Loyal
11573,35,8,3039.63,5,2,5,12,Big Spenders
11574,476,6,1062.32,1,1,2,4,Hibernating
11575,35,18,2382.21,5,5,4,14,Champions
11576,195,9,2276.7,3,2,4,9,Big Spenders
11577,83,10,2364.5,4,3,4,11,Loyal
11578,852,7,1379.5,1,1,3,5,Regulars
11579,171,16,2707.93,3,5,5,13,Big Spenders
11580,138,8,540.89,4,2,1,7,Regulars
11581,9,16,2215.08,5,5,4,14,Champions
11582,203,7,1346.86,3,1,3,7,Regulars
11583,199,10,2929.98,3,3,5,11,Big Spenders
11584,524,7,2463.47,1,1,4,6,Regulars
11585,23,12,1332.09,5,4,3,12,Loyal
11586,153,16,1597.25,3,5,3,11,Regulars
11587,17,9,1575.2399999999998,5,2,3,10,Regulars
11588,556,13,1734.24,1,4,4,9,At Risk
11589,313,13,2067.4900000000002,2,4,4,10,At Risk
11590,159,9,784.47,3,2,1,6,Regulars
11591,218,10,521.21,3,3,1,7,Regulars
11592,58,15,2209.87,5,5,4,14,Champions
11593,121,12,2184.16,4,4,4,12,Champions
11594,716,6,251.16,1,1,1,3,Hibernating
11595,70,7,859.23,4,1,2,7,Regulars
11596,191,8,545.79,3,2,1,6,Regulars
11597,186,10,877.33,3,3,2,8,Regulars
11598,82,16,2166.64,4,5,4,13,Champions
11599,232,11,1810.0700000000002,3,3,4,10,Big Spenders
11600,110,7,920.83,4,1,2,7,Regulars
11601,385,15,2992.5000000000005,2,5,5,12,At Risk
11602,167,10,2014.7300000000002,3,3,4,10,Big Spenders
11603,455,8,568.47,2,2,1,5,Hibernating
11604,286,10,998.0500000000001,2,3,2,7,Regulars
11605,38,12,1043.02,5,4,2,11,Loyal
11606,606,10,2430.34,1,3,4,8,Regulars
11607,50,9,2568.01,5,2,4,11,Big Spenders
11608,136,13,2984.18,4,4,5,13,Champions
11609,707,7,1412.86,1,1,3,5,Regulars
11610,55,18,3204.05,5,5,5,15,Champions
11611,82,12,3741.8599999999997,4,4,5,13,Champions
11612,460,14,1154.11,1,5,2,8,At Risk
11613,314,13,3029.8399999999997,2,4,5,11,At Risk
11614,97,11,1282.43,4,3,3,10,Loyal
11615,1,9,1060.66,5,2,2,9,Regulars
11616,322,10,705.71,2,3,1,6,Regulars
11617,162,14,4674.22,3,5,5,13,Big Spenders
11618,101,12,1562.1999999999998,4,4,3,11,Loyal
11619,887,5,1150.79,1,1,2,4,Hibernating
11620,165,11,1050.11,3,3,2,8,Regulars
11621,22,16,2891.66,5,5,5,15,Champions
11622,180,12,4610.66,3,4,5,12,Big Spenders
11623,227,8,1271.54,3,2,3,8,Regulars
11624,595,11,2634.56,1,3,5,9,Regulars
11625,104,11,2803.8099999999995,4,3,5,12,Loyal
11626,236,9,1098.19,3,2,2,7,Regulars
11627,161,7,967.8199999999999,3,1,2,6,Regulars
11628,532,8,2113.32,1,2,4,7,Regulars
11629,5,9,1206.16,5,2,2,9,Regulars
11630,295,11,2867.4,2,3,5,10,Regulars
11631,171,10,3318.2599999999998,3,3,5,11,Big Spenders
11632,253,8,1391.59,2,2,3,7,Regulars
11633,664,6,423.14000000000004,1,1,1,3,Hibernating
11634,90,9,933.9200000000001,4,2,2,8,Regulars
11635,152,11,3378.5499999999997,3,3,5,11,Big Spenders
11636,273,8,1140.66,2,2,2,6,Hibernating
11637,239,8,2416.6000000000004,3,2,4,9,Big Spenders
11638,361,9,757.54,2,2,1,5,Hibernating
11639,104,12,2779.59,4,4,5,13,Champions
11640,794,11,1274.76,1,3,3,7,Regulars
11641,173,8,2776.39,3,2,5,10,Big Spenders
11642,111,14,2929.2799999999997,4,5,5,14,Champions
11643,65,10,1155.05,5,3,2,10,Loyal
11644,179,10,1671.24,3,3,3,9,Regulars
11645,371,12,1457.17,2,4,3,9,At Risk
11646,160,7,1238.92,3,1,2,6,Regulars
11647,250,10,3454.1500000000005,2,3,5,10,Regulars
11648,114,7,2364.13,4,1,4,9,Big Spenders
11649,588,13,1018.1999999999999,1,4,2,7,At Risk
11650,881,10,953.9300000000001,1,3,2,6,Regulars
11651,205,11,1843.51,3,3,4,10,Big Spenders
11652,435,10,2301.06,2,3,4,9,Regulars
11653,138,15,1387.67,4,5,3,12,Loyal
11654,551,12,1734.92,1,4,4,9,At Risk
11655,155,9,1149.1000000000001,3,2,2,7,Regulars
11656,1203,5,818.75,1,1,1,3,Hibernating
11657,418,12,1115.65,2,4,2,8,At Risk
11658,306,8,1076.19,2,2,2,6,Hibernating
11659,282,7,745.0600000000001,2,1,1,4,Hibernating
11660,0,9,2656.42,5,2,5,12,Big Spenders
11661,485,7,1184.42,1,1,2,4,Hibernating
11662,456,5,548.51,2,1,1,4,Hibernating
11663,190,14,1509.72,3,5,3,11,Regulars
11664,88,13,2774.2799999999997,4,4,5,13,Champions
11665,476,9,660.92,1,2,1,4,Hibernating
11666,28,11,770.51,5,3,1,9,Loyal
11667,131,10,1670.77,4,3,3,10,Loyal
11668,519,9,1259.6799999999998,1,2,3,6,Regulars
11669,602,17,1734.24,1,5,4,10,At Risk
11670,535,2,231.73,1,1,1,3,Hibernating
11671,132,7,798.69,4,1,1,6,Regulars
11672,175,8,1601.45,3,2,3,8,Regulars
11673,145,10,1795.15,4,3,4,11,Loyal
11674,155,8,765.1700000000001,3,2,1,6,Regulars
11675,272,16,1845.47,2,5,4,11,At Risk
11676,73,17,2129.38,4,5,4,13,Champions
11677,281,9,4174.58,2,2,5,9,Regulars
11678,202,11,5205.81,3,3,5,11,Big Spenders
11679,540,7,772.46,1,1,1,3,Hibernating
11680,60,17,2684.67,5,5,5,15,Champions
11681,284,10,3148.88,2,3,5,10,Regulars
11682,609,9,2778.8300000000004,1,2,5,8,Regulars
11683,299,11,998.3,2,3,2,7,Regulars
11684,15,10,2985.5099999999998,5,3,5,13,Loyal
11685,78,10,2928.62,4,3,5,12,Loyal
11686,33,12,3487.59,5,4,5,14,Champions
11687,118,11,2105.8700000000003,4,3,4,11,Loyal
11688,305,9,1231.81,2,2,2,6,Hibernating
11689,54,7,692.0600000000001,5,1,1,7,Regulars
11690,512,6,1275.3,1,1,3,5,Regulars
11691,165,15,1771.21,3,5,4,12,Big Spenders
11692,165,6,958.01,3,1,2,6,Regulars
11693,142,16,2996.11,4,5,5,14,Champions
11694,361,11,764.15,2,3,1,6,Regulars
11695,97,11,1730.4099999999999,4,3,4,11,Loyal
11696,214,10,1106.21,3,3,2,8,Regulars
11697,108,7,914.94,4,1,2,7,Regulars
11698,547,8,2821.4500000000003,1,2,5,8,Regulars
11699,68,8,968.38,4,2,2,8,Regulars
11700,24,6,371.47,5,1,1,7,Regulars
11701,187,17,3117.54,3,5,5,13,Big Spenders
11702,298,11,1704.09,2,3,3,8,Regulars
11703,24,6,554.08,5,1,1,7,Regulars
11704,270,7,2231.59,2,1,4,7,Regulars
11705,1026,6,746.45,1,1,1,3,Hibernating
11706,17,17,3543.67,5,5,5,15,Champions
11707,208,9,1434.55,3,2,3,8,Regulars
11708,1272,2,219.04,1,1,1,3,Hibernating
11709,29,9,1717.57,5,2,3,10,Regulars
11710,245,9,2111.23,3,2,4,9,Big Spenders
11711,121,16,1946.8600000000001,4,5,4,13,Champions
11712,263,10,534.62,2,3,1,6,Regulars
11713,927,14,1427.8700000000001,1,5,3,9,At Risk
11714,35,9,2769.0,5,2,5,12,Big Spenders
11715,398,8,860.98,2,2,2,6,Hibernating
11716,513,10,2538.73,1,3,4,8,Regulars
11717,159,10,2147.59,3,3,4,10,Big Spenders
11718,104,12,3007.43,4,4,5,13,Champions
11719,446,9,952.75,2,2,2,6,Hibernating
11720,42,9,994.28,5,2,2,9,Regulars
11721,223,11,4143.1900000000005,3,3,5,11,Big Spenders
11722,101,17,1770.3799999999999,4,5,4,13,Champions
11723,80,16,2098.44,4,5,4,13,Champions
11724,644,7,554.43,1,1,1,3,Hibernating
11725,119,17,3592.82,4,5,5,14,Champions
11726,314,9,1337.44,2,2,3,7,Regulars
11727,46,7,479.41999999999996,5,1,1,7,Regulars
11728,64,13,3628.88,5,4,5,14,Champions
11729,627,9,2954.33,1,2,5,8,Regulars
11730,90,11,2157.61,4,3,4,11,Loyal
11731,104,7,790.1800000000001,4,1,1,6,Regulars
11732,172,13,3147.54,3,4,5,12,Big Spenders
11733,366,12,1359.86,2,4,3,9,At Risk
11734,72,12,1280.18,4,4,3,11,Loyal
11735,124,10,1055.98,4,3,2,9,Loyal
11736,125,15,1735.33,4,5,4,13,Champions
11737,95,13,1841.0300000000002,4,4,4,12,Champions
11738,141,13,876.4300000000001,4,4,2,10,Loyal
11739,14,10,1974.4499999999998,5,3,4,12,Loyal
11740,112,10,1471.09,4,3,3,10,Loyal
11741,177,14,1521.93,3,5,3,11,Regulars
11742,82,12,1937.97,4,4,4,12,Champions
11743,490,8,801.8499999999999,1,2,1,4,Hibernating
11744,1125,10,834.8000000000001,1,3,1,5,Regulars
11745,266,7,767.3800000000001,2,1,1,4,Hibernating
11746,128,9,1144.1100000000001,4,2,2,8,Regulars
11747,237,11,1412.45,3,3,3,9,Regulars
11748,292,9,1319.07,2,2,3,7,Regulars
11749,648,8,2685.74,1,2,5,8,Regulars
11750,46,11,3526.73,5,3,5,13,Loyal
11751,40,8,2461.6,5,2,4,11,Big Spenders
11752,161,13,1484.3600000000001,3,4,3,10,Regulars
11753,166,12,1189.6399999999999,3,4,2,9,Regulars
11754,288,12,663.72,2,4,1,7,At Risk
11755,40,14,1645.22,5,5,3,13,Loyal
11756,243,6,885.71,3,1,2,6,Regulars
11757,75,11,2612.84,4,3,5,12,Loyal
11758,69,10,3072.13,4,3,5,12,Loyal
11759,27,14,1649.03,5,5,3,13,Loyal
11760,507,8,3388.11,1,2,5,8,Regulars
11761,25,11,1364.8400000000001,5,3,3,11,Loyal
11762,178,11,1287.04,3,3,3,9,Regulars
11763,12,8,1372.51,5,2,3,10,Regulars
11764,385,7,638.27,2,1,1,4,Hibernating
11765,249,7,452.01,2,1,1,4,Hibernating
11766,5,11,1319.83,5,3,3,11,Loyal
11767,845,9,847.94,1,2,2,5,Hibernating
11768,422,10,1011.53,2,3,2,7,Regulars
11769,429,6,2041.0300000000002,2,1,4,7,Regulars
11770,172,9,1411.5,3,2,3,8,Regulars
11771,220,15,1692.51,3,5,3,11,Regulars
11772,229,11,722.12,3,3,1,7,Regulars
11773,348,7,1873.2,2,1,4,7,Regulars
11774,298,9,959.38,2,2,2,6,Hibernating
11775,18,15,5662.54,5,5,5,15,Champions
11776,61,10,2912.6200000000003,5,3,5,13,Loyal
11777,545,7,2121.52,1,1,4,6,Regulars
11778,59,7,802.91,5,1,1,7,Regulars
11779,90,14,1669.04,4,5,3,12,Loyal
11780,209,7,948.8199999999999,3,1,2,6,Regulars
11781,31,16,3803.28,5,5,5,15,Champions
11782,224,13,4303.6,3,4,5,12,Big Spenders
11783,2,12,2835.35,5,4,5,14,Champions
11784,361,6,1106.12,2,1,2,5,Hibernating
11785,694,8,1380.8300000000002,1,2,3,6,Regulars
11786,155,12,4006.95,3,4,5,12,Big Spenders
11787,203,13,3855.5299999999997,3,4,5,12,Big Spenders
11788,7,10,1514.38,5,3,3,11,Loyal
11789,623,9,902.49,1,2,2,5,Hibernating
11790,295,10,1360.83,2,3,3,8,Regulars
11791,152,12,1313.03,3,4,3,10,Regulars
11792,220,8,3237.3900000000003,3,2,5,10,Big Spenders
11793,190,8,1116.3999999999999,3,2,2,7,Regulars
11794,580,7,1088.93,1,1,2,4,Hibernating
11795,146,7,1249.9,4,1,3,8,Regulars
11796,361,6,2163.99,2,1,4,7,Regulars
11797,105,14,3511.21,4,5,5,14,Champions
11798,90,4,236.17999999999998,4,1,1,6,Regulars
11799,52,16,2088.93,5,5,4,14,Champions
11800,204,11,2207.74,3,3,4,10,Big Spenders
11801,245,11,1931.77,3,3,4,10,Big Spenders
11802,93,13,3646.36,4,4,5,13,Champions
11803,98,9,1555.9499999999998,4,2,3,9,Regulars
11804,671,4,167.19,1,1,1,3,Hibernating
11805,1716,7,1154.26,1,1,2,4,Hibernating
11806,14,10,1208.52,5,3,2,10,Loyal
11807,734,10,1747.0199999999998,1,3,4,8,Regulars
11808,322,13,1076.4099999999999,2,4,2,8,At Risk
11809,249,16,1827.16,2,5,4,11,At Risk
11810,1248,8,1865.59,1,2,4,7,Regulars
11811,28,4,512.0899999999999,5,1,1,7,Regulars
11812,63,7,957.0799999999999,5,1,2,8,Regulars
11813,21,9,998.33,5,2,2,9,Regulars
11814,161,11,1393.98,3,3,3,9,Regulars
11815,1052,8,925.0,1,2,2,5,Hibernating
11816,116,9,1882.71,4,2,4,10,Big Spenders
11817,134,10,1290.62,4,3,3,10,Loyal
11818,40,11,1490.32,5,3,3,11,Loyal
11819,151,12,1327.8700000000001,3,4,3,10,Regulars
11820,205,15,1820.97,3,5,4,12,Big Spenders
11821,156,14,1014.61,3,5,2,10,Regulars
11822,269,11,2581.16,2,3,5,10,Regulars
11823,315,7,1733.59,2,1,4,7,Regulars
11824,1312,4,532.73,1,1,1,3,Hibernating
11825,254,16,3155.99,2,5,5,12,At Risk
11826,586,14,2704.88,1,5,5,11,At Risk
11827,303,8,6436.47,2,2,5,9,Regulars
11828,173,12,1687.0500000000002,3,4,3,10,Regulars
11829,31,13,2397.01,5,4,4,13,Champions
11830,357,9,658.6800000000001,2,2,1,5,Hibernating
11831,649,8,1042.48,1,2,2,5,Hibernating
11832,374,6,2370.7,2,1,4,7,Regulars
11833,148,11,1712.3100000000002,3,3,3,9,Regulars
11834,31,10,944.61,5,3,2,10,Loyal
11835,271,9,886.3,2,2,2,6,Hibernating
11836,295,16,6161.81,2,5,5,12,At Risk
11837,509,7,1328.58,1,1,3,5,Regulars
11838,27,10,1207.26,5,3,2,10,Loyal
11839,80,16,2547.91,4,5,4,13,Champions
11840,135,6,902.98,4,1,2,7,Regulars
11841,517,9,1986.3400000000001,1,2,4,7,Regulars
11842,54,13,2994.43,5,4,5,14,Champions
11843,270,9,559.86,2,2,1,5,Hibernating
11844,454,9,576.35,2,2,1,5,Hibernating
11845,78,14,1074.68,4,5,2,11,Loyal
11846,83,8,807.5,4,2,1,7,Regulars
11847,502,9,1569.64,1,2,3,6,Regulars
11848,292,6,2573.78,2,1,5,8,Regulars
11849,548,7,824.91,1,1,1,3,Hibernating
11850,315,7,754.3000000000001,2,1,1,4,Hibernating
11851,193,9,935.99,3,2,2,7,Regulars
11852,134,9,1267.1100000000001,4,2,3,9,Regulars
11853,371,10,4288.95,2,3,5,10,Regulars
11854,225,13,3141.39,3,4,5,12,Big Spenders
11855,874,8,2271.96,1,2,4,7,Regulars
11856,662,5,562.4300000000001,1,1,1,3,Hibernating
11857,5,13,2502.47,5,4,4,13,Champions
11858,82,15,1555.1799999999998,4,5,3,12,Loyal
11859,337,11,2037.67,2,3,4,9,Regulars
11860,254,10,852.74,2,3,2,7,Regulars
11861,161,14,1120.05,3,5,2,10,Regulars
11862,191,13,1044.3200000000002,3,4,2,9,Regulars
11863,378,6,885.8399999999999,2,1,2,5,Hibernating
11864,208,11,3861.7299999999996,3,3,5,11,Big Spenders
11865,668,9,843.0,1,2,1,4,Hibernating
11866,51,9,1080.04,5,2,2,9,Regulars
11867,171,9,1995.8600000000001,3,2,4,9,Big Spenders
11868,202,7,617.42,3,1,1,5,Regulars
11869,176,11,1606.1,3,3,3,9,Regulars
11870,160,13,4616.51,3,4,5,12,Big Spenders
11871,299,14,3561.8500000000004,2,5,5,12,At Risk
11872,53,9,2296.21,5,2,4,11,Big Spenders
11873,16,13,2206.34,5,4,4,13,Champions
11874,11,10,2429.2500000000005,5,3,4,12,Loyal
11875,213,9,1453.74,3,2,3,8,Regulars
11876,126,11,2832.82,4,3,5,12,Loyal
11877,122,10,599.7800000000001,4,3,1,8,Loyal
11878,385,7,661.19,2,1,1,4,Hibernating
11879,133,6,474.17,4,1,1,6,Regulars
11880,10,7,1208.42,5,1,2,8,Regulars
11881,125,11,1093.88,4,3,2,9,Loyal
11882,165,7,1121.12,3,1,2,6,Regulars
11883,173,9,2059.7599999999998,3,2,4,9,Big Spenders
11884,118,13,1869.29,4,4,4,12,Champions
11885,35,16,2282.74,5,5,4,14,Champions
11886,288,18,3066.43,2,5,5,12,At Risk
11887,712,6,685.44,1,1,1,3,Hibernating
11888,12,9,546.04,5,2,1,8,Regulars
11889,240,13,1950.9299999999998,3,4,4,11,Big Spenders
11890,356,7,1783.4,2,1,4,7,Regulars
11891,38,13,6333.2,5,4,5,14,Champions
11892,365,8,1057.34,2,2,2,6,Hibernating
11893,50,12,748.97,5,4,1,10,Loyal
11894,135,7,820.54,4,1,1,6,Regulars
11895,52,8,1209.65,5,2,2,9,Regulars
11896,35,14,2884.2400000000002,5,5,5,15,Champions
11897,275,14,1613.14,2,5,3,10,At Risk
11898,711,18,2052.13,1,5,4,10,At Risk
11899,272,12,3936.5699999999997,2,4,5,11,At Risk
11900,148,13,846.5899999999999,3,4,2,9,Regulars
11901,5,18,2024.82,5,5,4,14,Champions
11902,182,8,2601.57,3,2,5,10,Big Spenders
11903,110,11,2770.39,4,3,5,12,Loyal
11904,59,11,2019.3000000000002,5,3,4,12,Loyal
11905,110,5,2425.01,4,1,4,9,Big Spenders
11906,292,10,978.41,2,3,2,7,Regulars
11907,188,14,1989.77,3,5,4,12,Big Spenders
11908,239,5,1542.45,3,1,3,7,Regulars
11909,19,6,412.5,5,1,1,7,Regulars
11910,42,11,1147.71,5,3,2,10,Loyal
11911,8,11,2227.02,5,3,4,12,Loyal
11912,151,9,984.7399999999999,3,2,2,7,Regulars
11913,419,12,2867.88,2,4,5,11,At Risk
11914,6,8,2169.19,5,2,4,11,Big Spenders
11915,199,8,1125.72,3,2,2,7,Regulars
11916,33,11,2223.3500000000004,5,3,4,12,Loyal
11917,669,6,1035.23,1,1,2,4,Hibernating
11918,149,16,3996.82,3,5,5,13,Big Spenders
11919,75,12,1356.81,4,4,3,11,Loyal
11920,215,15,7766.51,3,5,5,13,Big Spenders
11921,35,10,1381.2,5,3,3,11,Loyal
11922,575,5,4054.1,1,1,5,7,Regulars
11923,411,10,1632.8799999999999,2,3,3,8,Regulars
11924,172,8,2690.21,3,2,5,10,Big Spenders
11925,130,7,1605.6399999999999,4,1,3,8,Regulars
11926,102,12,1659.4299999999998,4,4,3,11,Loyal
11927,523,7,601.94,1,1,1,3,Hibernating
11928,66,17,5922.88,4,5,5,14,Champions
11929,910,10,1312.1599999999999,1,3,3,7,Regulars
11930,114,8,2030.3500000000001,4,2,4,10,Big Spenders
11931,182,11,1552.43,3,3,3,9,Regulars
11932,545,11,1494.44,1,3,3,7,Regulars
11933,171,11,2276.79,3,3,4,10,Big Spenders
11934,70,9,2692.25,4,2,5,11,Big Spenders
11935,404,16,2041.47,2,5,4,11,At Risk
11936,160,12,1411.51,3,4,3,10,Regulars
11937,508,9,3685.2000000000003,1,2,5,8,Regulars
11938,59,21,4574.48,5,5,5,15,Champions
11939,26,13,2082.1,5,4,4,13,Champions
11940,85,14,1269.6899999999998,4,5,3,12,Loyal
11941,133,9,1350.79,4,2,3,9,Regulars
11942,621,5,311.6,1,1,1,3,Hibernating
11943,508,9,793.27,1,2,1,4,Hibernating
11944,539,8,1227.1200000000001,1,2,2,5,Hibernating
11945,95,6,725.79,4,1,1,6,Regulars
11946,156,10,1072.69,3,3,2,8,Regulars
11947,18,14,1025.17,5,5,2,12,Loyal
11948,8,9,520.4,5,2,1,8,Regulars
11949,172,11,1298.21,3,3,3,9,Regulars
11950,229,13,2025.6499999999999,3,4,4,11,Big Spenders
11951,117,15,1923.5900000000001,4,5,4,13,Champions
11952,26,17,1909.47,5,5,4,14,Champions
11953,309,13,1607.07,2,4,3,9,At Risk
11954,91,12,5116.56,4,4,5,13,Champions
11955,357,14,1853.8700000000001,2,5,4,11,At Risk
11956,175,13,2939.15,3,4,5,12,Big Spenders
11957,269,11,3198.8500000000004,2,3,5,10,Regulars
11958,373,11,1584.25,2,3,3,8,Regulars
11959,141,11,1870.55,4,3,4,11,Loyal
11960,125,11,1532.22,4,3,3,10,Loyal
11961,883,13,2747.3700000000003,1,4,5,10,At Risk
11962,529,10,1661.01,1,3,3,7,Regulars
11963,143,8,1068.5700000000002,4,2,2,8,Regulars
11964,565,10,1877.66,1,3,4,8,Regulars
11965,239,10,1894.6500000000003,3,3,4,10,Big Spenders
11966,333,13,1375.36,2,4,3,9,At Risk
11967,432,5,436.99,2,1,1,4,Hibernating
11968,527,19,5207.36,1,5,5,11,At Risk
11969,425,11,1802.64,2,3,4,9,Regulars
11970,284,5,652.36,2,1,1,4,Hibernating
11971,292,8,665.46,2,2,1,5,Hibernating
11972,124,7,536.4100000000001,4,1,1,6,Regulars
11973,1202,9,641.69,1,2,1,4,Hibernating
11974,167,8,2576.1,3,2,5,10,Big Spenders
11975,39,7,1128.55,5,1,2,8,Regulars
11976,224,8,1011.93,3,2,2,7,Regulars
11977,49,12,1227.93,5,4,2,11,Loyal
11978,33,12,1971.6000000000001,5,4,4,13,Champions
11979,277,6,1180.0,2,1,2,5,Hibernating
11980,163,9,1703.5,3,2,3,8,Regulars
11981,3,16,5469.25,5,5,5,15,Champions
11982,62,10,1048.63,5,3,2,10,Loyal
11983,16,10,1612.17,5,3,3,11,Loyal
11984,149,7,489.19,3,1,1,5,Regulars
11985,16,8,1970.2,5,2,4,11,Big Spenders
11986,77,7,1214.1100000000001,4,1,2,7,Regulars
11987,110,9,1269.6,4,2,3,9,Regulars
11988,413,13,1383.2,2,4,3,9,At Risk
11989,504,14,1346.31,1,5,3,9,At Risk
11990,195,15,1077.19,3,5,2,10,Regulars
11991,374,11,1857.02,2,3,4,9,Regulars
11992,119,8,1175.96,4,2,2,8,Regulars
11993,35,10,2763.56,5,3,5,13,Loyal
11994,71,12,3846.4300000000003,4,4,5,13,Champions
11995,22,6,249.82999999999998,5,1,1,7,Regulars
11996,74,11,3170.29,4,3,5,12,Loyal
11997,15,8,809.08,5,2,1,8,Regulars
11998,28,14,4120.17,5,5,5,15,Champions
11999,491,12,725.11,1,4,1,6,At Risk
12000,199,9,1858.12,3,2,4,9,Big Spenders
12001,305,11,3353.75,2,3,5,10,Regulars
12002,50,20,4546.01,5,5,5,15,Champions
12003,89,11,2029.98,4,3,4,11,Loyal
12004,179,8,597.63,3,2,1,6,Regulars
12005,349,7,1538.13,2,1,3,6,Regulars
12006,309,6,739.75,2,1,1,4,Hibernating
12007,74,13,1899.86,4,4,4,12,Champions
12008,818,10,1569.8899999999999,1,3,3,7,Regulars
12009,179,12,3897.75,3,4,5,12,Big Spenders
12010,400,12,3192.2200000000003,2,4,5,11,At Risk
12011,33,12,1346.3200000000002,5,4,3,12,Loyal
12012,6,12,2806.0,5,4,5,14,Champions
12013,221,11,1006.77,3,3,2,8,Regulars
12014,1241,3,186.64,1,1,1,3,Hibernating
12015,161,9,1729.5,3,2,4,9,Big Spenders
12016,40,12,1420.5500000000002,5,4,3,12,Loyal
12017,94,8,2131.6299999999997,4,2,4,10,Big Spenders
12018,1073,12,4948.33,1,4,5,10,At Risk
12019,107,12,1430.09,4,4,3,11,Loyal
12020,155,6,454.74,3,1,1,5,Regulars
12021,1202,5,1663.46,1,1,3,5,Regulars
12022,79,13,2162.62,4,4,4,12,Champions
12023,591,11,1759.9199999999998,1,3,4,8,Regulars
12024,97,12,1811.46,4,4,4,12,Champions
12025,145,13,3833.56,4,4,5,13,Champions
12026,368,6,554.96,2,1,1,4,Hibernating
12027,502,15,2832.11,1,5,5,11,At Risk
12028,215,7,867.2,3,1,2,6,Regulars
12029,173,6,413.58,3,1,1,5,Regulars
12030,85,19,2494.6,4,5,4,13,Champions
12031,738,9,1099.41,1,2,2,5,Hibernating
12032,19,4,291.44,5,1,1,7,Regulars
12033,114,10,2719.03,4,3,5,12,Loyal
12034,40,20,6696.33,5,5,5,15,Champions
12035,320,7,1499.67,2,1,3,6,Regulars
12036,84,13,936.24,4,4,2,10,Loyal
12037,358,18,2256.53,2,5,4,11,At Risk
12038,625,10,2801.5,1,3,5,9,Regulars
12039,23,8,2987.32,5,2,5,12,Big Spenders
12040,151,10,1867.1000000000001,3,3,4,10,Big Spenders
12041,156,18,2237.81,3,5,4,12,Big Spenders
12042,388,10,1099.02,2,3,2,7,Regulars
12043,270,9,1017.46,2,2,2,6,Hibernating
12044,189,8,2065.5699999999997,3,2,4,9,Big Spenders
12045,565,11,2711.6099999999997,1,3,5,9,Regulars
12046,10,15,4537.93,5,5,5,15,Champions
12047,151,12,1153.17,3,4,2,9,Regulars
12048,2,14,4546.889999999999,5,5,5,15,Champions
12049,172,12,1970.18,3,4,4,11,Big Spenders
12050,249,14,1894.92,2,5,4,11,At Risk
12051,297,9,2302.38,2,2,4,8,Regulars
12052,136,12,2797.0299999999997,4,4,5,13,Champions
12053,13,9,1379.6499999999999,5,2,3,10,Regulars
12054,172,10,746.94,3,3,1,7,Regulars
12055,665,8,1212.19,1,2,2,5,Hibernating
12056,55,13,2269.38,5,4,4,13,Champions
12057,57,8,745.13,5,2,1,8,Regulars
12058,180,8,879.69,3,2,2,7,Regulars
12059,534,11,2177.78,1,3,4,8,Regulars
12060,9,12,1108.88,5,4,2,11,Loyal
12061,723,7,851.3199999999999,1,1,2,4,Hibernating
12062,146,10,1035.91,4,3,2,9,Loyal
12063,8,9,1049.68,5,2,2,9,Regulars
12064,878,9,2103.33,1,2,4,7,Regulars
12065,99,8,599.41,4,2,1,7,Regulars
12066,74,11,1692.02,4,3,3,10,Loyal
12067,189,12,2930.46,3,4,5,12,Big Spenders
12068,166,12,1452.59,3,4,3,10,Regulars
12069,61,6,774.97,5,1,1,7,Regulars
12070,705,6,1630.55,1,1,3,5,Regulars
12071,88,10,1511.25,4,3,3,10,Loyal
12072,296,8,2329.7400000000002,2,2,4,8,Regulars
12073,156,8,1033.72,3,2,2,7,Regulars
12074,48,16,2606.31,5,5,5,15,Champions
12075,138,18,1772.74,4,5,4,13,Champions
12076,367,10,1882.15,2,3,4,9,Regulars
12077,70,13,1339.55,4,4,3,11,Loyal
12078,254,7,729.19,2,1,1,4,Hibernating
12079,41,12,1081.73,5,4,2,11,Loyal
12080,111,7,658.6,4,1,1,6,Regulars
12081,715,9,851.82,1,2,2,5,Hibernating
12082,309,9,2486.4700000000003,2,2,4,8,Regulars
12083,478,8,978.76,1,2,2,5,Hibernating
12084,128,11,1435.95,4,3,3,10,Loyal
12085,87,8,1111.13,4,2,2,8,Regulars
12086,186,13,1165.72,3,4,2,9,Regulars
12087,262,14,1115.44,2,5,2,9,At Risk
12088,552,9,1415.43,1,2,3,6,Regulars
12089,848,9,1371.9,1,2,3,6,Regulars
12090,90,7,836.04,4,1,1,6,Regulars
12091,429,14,1990.74,2,5,4,11,At Risk
12092,344,12,491.35,2,4,1,7,At Risk
12093,187,10,1587.29,3,3,3,9,Regulars
12094,111,8,977.96,4,2,2,8,Regulars
12095,74,14,1068.42,4,5,2,11,Loyal
12096,1094,10,1358.5200000000002,1,3,3,7,Regulars
12097,1238,9,587.2,1,2,1,4,Hibernating
12098,75,10,2876.7799999999997,4,3,5,12,Loyal
12099,157,4,430.85,3,1,1,5,Regulars
12100,458,9,609.63,2,2,1,5,Hibernating
12101,86,12,1394.6299999999999,4,4,3,11,Loyal
12102,216,16,4793.33,3,5,5,13,Big Spenders
12103,412,9,1391.52,2,2,3,7,Regulars
12104,228,15,1793.47,3,5,4,12,Big Spenders
12105,893,12,3900.66,1,4,5,10,At Risk
12106,546,9,911.51,1,2,2,5,Hibernating
12107,971,9,1192.97,1,2,2,5,Hibernating
12108,523,10,2277.31,1,3,4,8,Regulars
12109,99,9,1411.8300000000002,4,2,3,9,Regulars
12110,94,12,1076.3899999999999,4,4,2,10,Loyal
12111,702,5,762.99,1,1,1,3,Hibernating
12112,96,14,1767.37,4,5,4,13,Champions
12113,478,10,2425.55,1,3,4,8,Regulars
12114,1046,4,1837.8000000000002,1,1,4,6,Regulars
12115,181,9,2782.16,3,2,5,10,Big Spenders
12116,767,4,1476.6799999999998,1,1,3,5,Regulars
12117,44,9,781.77,5,2,1,8,Regulars
12118,8,7,680.26,5,1,1,7,Regulars
12119,197,12,3576.8900000000003,3,4,5,12,Big Spenders
12120,453,5,279.71,2,1,1,4,Hibernating
12121,335,14,1860.85,2,5,4,11,At Risk
12122,50,15,1118.0900000000001,5,5,2,12,Loyal
12123,83,12,1525.6499999999999,4,4,3,11,Loyal
12124,1307,5,2024.4500000000003,1,1,4,6,Regulars
12125,148,10,5243.96,3,3,5,11,Big Spenders
12126,104,13,1110.26,4,4,2,10,Loyal
12127,329,13,1962.1200000000001,2,4,4,10,At Risk
12128,125,15,2616.73,4,5,5,14,Champions
12129,206,14,2812.67,3,5,5,13,Big Spenders
12130,474,10,1820.29,1,3,4,8,Regulars
12131,65,10,1679.56,5,3,3,11,Loyal
12132,54,7,573.6700000000001,5,1,1,7,Regulars
12133,101,14,3608.47,4,5,5,14,Champions
12134,59,17,2666.7799999999997,5,5,5,15,Champions
12135,338,7,464.73,2,1,1,4,Hibernating
12136,572,6,1005.01,1,1,2,4,Hibernating
12137,145,15,2545.7400000000002,4,5,4,13,Champions
12138,65,10,1551.06,5,3,3,11,Loyal
12139,454,10,1892.41,2,3,4,9,Regulars
12140,108,10,893.3199999999999,4,3,2,9,Loyal
12141,871,6,1142.6399999999999,1,1,2,4,Hibernating
12142,71,5,716.01,4,1,1,6,Regulars
12143,505,9,827.37,1,2,1,4,Hibernating
12144,16,11,1355.8700000000001,5,3,3,11,Loyal
12145,97,7,650.13,4,1,1,6,Regulars
12146,100,7,541.8199999999999,4,1,1,6,Regulars
12147,28,14,2571.2700000000004,5,5,4,14,Champions
12148,462,11,1862.1900000000003,1,3,4,8,Regulars
12149,145,8,699.88,4,2,1,7,Regulars
12150,337,12,905.05,2,4,2,8,At Risk
12151,348,9,1054.27,2,2,2,6,Hibernating
12152,460,10,1786.83,1,3,4,8,Regulars
12153,65,4,665.5699999999999,5,1,1,7,Regulars
12154,268,9,587.48,2,2,1,5,Hibernating
12155,235,17,2419.03,3,5,4,12,Big Spenders
12156,437,10,1835.6100000000001,2,3,4,9,Regulars
12157,385,6,1478.88,2,1,3,6,Regulars
12158,15,13,2718.2799999999997,5,4,5,14,Champions
12159,75,10,1888.88,4,3,4,11,Loyal
12160,131,9,740.69,4,2,1,7,Regulars
12161,228,14,5911.7699999999995,3,5,5,13,Big Spenders
12162,110,12,1701.3300000000002,4,4,3,11,Loyal
12163,500,6,538.52,1,1,1,3,Hibernating
12164,6,14,1842.05,5,5,4,14,Champions
12165,600,11,1317.9,1,3,3,7,Regulars
12166,321,7,830.5799999999999,2,1,1,4,Hibernating
12167,279,12,1553.95,2,4,3,9,At Risk
12168,329,12,1354.28,2,4,3,9,At Risk
12169,440,9,4817.4400000000005,2,2,5,9,Regulars
12170,99,11,1498.38,4,3,3,10,Loyal
12171,211,7,1702.03,3,1,3,7,Regulars
12172,101,12,1060.37,4,4,2,10,Loyal
12173,517,6,2118.91,1,1,4,6,Regulars
12174,248,7,1302.9,2,1,3,6,Regulars
12175,2,12,3211.15,5,4,5,14,Champions
12176,519,8,531.47,1,2,1,4,Hibernating
12177,243,10,3249.75,3,3,5,11,Big Spenders
12178,172,10,1437.69,3,3,3,9,Regulars
12179,112,10,2197.4700000000003,4,3,4,11,Loyal
12180,117,12,2935.7000000000003,4,4,5,13,Champions
12181,233,10,824.85,3,3,1,7,Regulars
12182,101,12,1510.31,4,4,3,11,Loyal
12183,302,6,550.09,2,1,1,4,Hibernating
12184,39,8,2434.53,5,2,4,11,Big Spenders
12185,54,5,1209.43,5,1,2,8,Regulars
12186,274,5,251.67000000000002,2,1,1,4,Hibernating
12187,443,12,2893.09,2,4,5,11,At Risk
12188,758,10,1378.8400000000001,1,3,3,7,Regulars
12189,380,11,1828.94,2,3,4,9,Regulars
12190,363,9,2031.42,2,2,4,8,Regulars
12191,967,4,160.01,1,1,1,3,Hibernating
12192,205,14,1451.46,3,5,3,11,Regulars
12193,247,14,3221.39,3,5,5,13,Big Spenders
12194,154,6,876.55,3,1,2,6,Regulars
12195,310,9,1978.81,2,2,4,8,Regulars
12196,43,15,6222.66,5,5,5,15,Champions
12197,601,13,1804.92,1,4,4,9,At Risk
12198,237,9,904.31,3,2,2,7,Regulars
12199,58,7,548.03,5,1,1,7,Regulars
12200,35,6,733.26,5,1,1,7,Regulars
12201,97,9,747.72,4,2,1,7,Regulars
12202,644,7,668.2,1,1,1,3,Hibernating
12203,639,10,1300.3,1,3,3,7,Regulars
12204,5,13,4391.799999999999,5,4,5,14,Champions
12205,38,7,703.1,5,1,1,7,Regulars
12206,262,13,1398.03,2,4,3,9,At Risk
12207,31,14,3322.2400000000002,5,5,5,15,Champions
12208,114,10,720.67,4,3,1,8,Loyal
12209,190,14,2310.76,3,5,4,12,Big Spenders
12210,759,9,1657.3600000000001,1,2,3,6,Regulars
12211,14,12,1571.49,5,4,3,12,Loyal
12212,253,12,3447.0099999999998,2,4,5,11,At Risk
12213,549,7,1178.69,1,1,2,4,Hibernating
12214,8,15,1565.14,5,5,3,13,Loyal
12215,107,9,1319.22,4,2,3,9,Regulars
12216,177,12,778.82,3,4,1,8,Regulars
12217,1,8,2264.02,5,2,4,11,Big Spenders
12218,602,7,597.63,1,1,1,3,Hibernating
12219,888,10,1329.1,1,3,3,7,Regulars
12220,526,11,1387.44,1,3,3,7,Regulars
12221,222,10,1741.18,3,3,4,10,Big Spenders
12222,91,16,4230.87,4,5,5,14,Champions
12223,139,6,1321.0,4,1,3,8,Regulars
12224,10,11,3311.9900000000002,5,3,5,13,Loyal
12225,122,18,2870.24,4,5,5,14,Champions
12226,523,6,636.5799999999999,1,1,1,3,Hibernating
12227,103,10,985.91,4,3,2,9,Loyal
12228,425,4,348.11,2,1,1,4,Hibernating
12229,335,10,581.8499999999999,2,3,1,6,Regulars
12230,73,15,1662.09,4,5,3,12,Loyal
12231,630,10,1192.6499999999999,1,3,2,6,Regulars
12232,60,7,1882.1399999999999,5,1,4,10,Big Spenders
12233,37,12,1897.17,5,4,4,13,Champions
12234,1077,3,636.39,1,1,1,3,Hibernating
12235,616,13,3742.09,1,4,5,10,At Risk
12236,954,11,912.9300000000001,1,3,2,6,Regulars
12237,77,18,2876.9599999999996,4,5,5,14,Champions
12238,275,7,646.37,2,1,1,4,Hibernating
12239,836,8,322.61,1,2,1,4,Hibernating
12240,858,4,312.85,1,1,1,3,Hibernating
12241,139,11,2554.12,4,3,4,11,Loyal
12242,40,7,704.45,5,1,1,7,Regulars
12243,76,11,1745.54,4,3,4,11,Loyal
12244,305,8,621.76,2,2,1,5,Hibernating
12245,251,8,1022.1199999999999,2,2,2,6,Hibernating
12246,30,8,874.95,5,2,2,9,Regulars
12247,359,12,1458.8899999999999,2,4,3,9,At Risk
12248,156,12,1400.49,3,4,3,10,Regulars
12249,272,9,2210.82,2,2,4,8,Regulars
12250,48,13,1381.45,5,4,3,12,Loyal
12251,317,8,2788.9900000000002,2,2,5,9,Regulars
12252,186,14,2550.54,3,5,4,12,Big Spenders
12253,241,12,1718.59,3,4,3,10,Regulars
12254,113,7,426.71000000000004,4,1,1,6,Regulars
12255,395,15,1242.58,2,5,3,10,At Risk
12256,602,10,1087.89,1,3,2,6,Regulars
12257,269,13,2816.04,2,4,5,11,At Risk
12258,180,12,1332.91,3,4,3,10,Regulars
12259,42,11,1321.0700000000002,5,3,3,11,Loyal
12260,585,10,1115.39,1,3,2,6,Regulars
12261,535,8,1988.46,1,2,4,7,Regulars
12262,624,7,1094.14,1,1,2,4,Hibernating
12263,114,15,2460.7799999999997,4,5,4,13,Champions
12264,5,12,2908.41,5,4,5,14,Champions
12265,99,12,1661.8799999999999,4,4,3,11,Loyal
12266,158,15,1274.94,3,5,3,11,Regulars
12267,153,8,1511.19,3,2,3,8,Regulars
12268,24,16,3510.4300000000003,5,5,5,15,Champions
12269,347,4,287.54,2,1,1,4,Hibernating
12270,251,6,548.9699999999999,2,1,1,4,Hibernating
12271,301,11,1089.16,2,3,2,7,Regulars
12272,362,7,2003.7099999999998,2,1,4,7,Regulars
12273,491,6,2791.45,1,1,5,7,Regulars
12274,28,9,1265.8,5,2,3,10,Regulars
12275,193,9,1688.73,3,2,3,8,Regulars
12276,20,13,1415.01,5,4,3,12,Loyal
12277,382,7,2207.4199999999996,2,1,4,7,Regulars
12278,823,5,966.09,1,1,2,4,Hibernating
12279,483,6,1765.97,1,1,4,6,Regulars
12280,33,9,612.87,5,2,1,8,Regulars
12281,537,9,3176.55,1,2,5,8,Regulars
12282,68,11,2158.61,4,3,4,11,Loyal
12283,361,13,2669.9900000000002,2,4,5,11,At Risk
12284,170,15,1093.3400000000001,3,5,2,10,Regulars
12285,622,8,2226.71,1,2,4,7,Regulars
12286,34,13,3676.42,5,4,5,14,Champions
12287,53,8,1146.29,5,2,2,9,Regulars
12288,316,15,1545.21,2,5,3,10,At Risk
12289,497,16,2937.9300000000003,1,5,5,11,At Risk
12290,308,14,1506.5,2,5,3,10,At Risk
12291,316,8,1803.9099999999999,2,2,4,8,Regulars
12292,371,7,776.6299999999999,2,1,1,4,Hibernating
12293,148,9,475.42,3,2,1,6,Regulars
12294,430,7,881.31,2,1,2,5,Hibernating
12295,264,8,720.16,2,2,1,5,Hibernating
12296,128,12,1501.2,4,4,3,11,Loyal
12297,92,9,890.45,4,2,2,8,Regulars
12298,123,11,2811.11,4,3,5,12,Loyal
12299,401,10,2226.33,2,3,4,9,Regulars
12300,595,10,1357.8,1,3,3,7,Regulars
12301,327,15,3960.24,2,5,5,12,At Risk
12302,192,15,1805.95,3,5,4,12,Big Spenders
12303,555,12,2232.06,1,4,4,9,At Risk
12304,538,14,1468.56,1,5,3,9,At Risk
12305,169,5,742.25,3,1,1,5,Regulars
12306,162,18,2378.92,3,5,4,12,Big Spenders
12307,391,6,503.90999999999997,2,1,1,4,Hibernating
12308,319,8,1455.84,2,2,3,7,Regulars
12309,714,10,3549.01,1,3,5,9,Regulars
12310,124,14,2714.04,4,5,5,14,Champions
12311,580,9,1033.01,1,2,2,5,Hibernating
12312,174,9,672.3199999999999,3,2,1,6,Regulars
12313,100,8,2485.07,4,2,4,10,Big Spenders
12314,772,10,1719.41,1,3,3,7,Regulars
12315,182,10,1312.41,3,3,3,9,Regulars
12316,262,10,3637.56,2,3,5,10,Regulars
12317,7,15,4313.91,5,5,5,15,Champions
12318,52,11,2916.97,5,3,5,13,Loyal
12319,226,8,490.59999999999997,3,2,1,6,Regulars
12320,124,13,1717.21,4,4,3,11,Loyal
12321,152,11,1243.65,3,3,3,9,Regulars
12322,14,13,806.45,5,4,1,10,Loyal
12323,249,13,2912.94,2,4,5,11,At Risk
12324,25,11,1089.87,5,3,2,10,Loyal
12325,177,9,1895.7700000000002,3,2,4,9,Big Spenders
12326,592,11,982.41,1,3,2,6,Regulars
12327,26,10,1294.62,5,3,3,11,Loyal
12328,531,9,2790.91,1,2,5,8,Regulars
12329,188,15,4386.900000000001,3,5,5,13,Big Spenders
12330,111,16,2459.8599999999997,4,5,4,13,Champions
12331,623,12,1927.61,1,4,4,9,At Risk
12332,53,16,2309.9900000000002,5,5,4,14,Champions
12333,16,8,629.0,5,2,1,8,Regulars
12334,84,12,741.55,4,4,1,9,Loyal
12335,18,19,2051.71,5,5,4,14,Champions
12336,76,13,1020.44,4,4,2,10,Loyal
12337,164,13,1631.82,3,4,3,10,Regulars
12338,638,8,3457.67,1,2,5,8,Regulars
12339,319,7,809.75,2,1,1,4,Hibernating
12340,23,14,2419.71,5,5,4,14,Champions
12341,59,11,1015.5600000000001,5,3,2,10,Loyal
12342,318,11,1881.53,2,3,4,9,Regulars
12343,24,16,3685.78,5,5,5,15,Champions
12344,103,8,2329.6,4,2,4,10,Big Spenders
12345,267,7,697.78,2,1,1,4,Hibernating
12346,17,8,336.12,5,2,1,8,Regulars
12347,53,9,1195.42,5,2,2,9,Regulars
12348,28,7,862.31,5,1,2,8,Regulars
12349,10,14,5453.02,5,5,5,15,Champions
12350,476,11,1360.76,1,3,3,7,Regulars
12351,243,13,1147.1,3,4,2,9,Regulars
12352,271,6,1557.87,2,1,3,6,Regulars
12353,514,9,1013.4,1,2,2,5,Hibernating
12354,377,7,2409.11,2,1,4,7,Regulars
12355,65,15,1585.78,5,5,3,13,Loyal
12356,307,13,1226.01,2,4,2,8,At Risk
12357,841,4,428.9,1,1,1,3,Hibernating
12358,39,9,896.3899999999999,5,2,2,9,Regulars
12359,394,8,484.26,2,2,1,5,Hibernating
12360,949,7,1314.74,1,1,3,5,Regulars
12361,342,10,3266.87,2,3,5,10,Regulars
12362,465,6,585.11,1,1,1,3,Hibernating
12363,80,5,1574.72,4,1,3,8,Regulars
12364,226,15,1994.6399999999999,3,5,4,12,Big Spenders
12365,34,10,2010.51,5,3,4,12,Loyal
12366,570,12,2565.72,1,4,4,9,At Risk
12367,149,8,2904.3900000000003,3,2,5,10,Big Spenders
12368,77,10,2852.7,4,3,5,12,Loyal
12369,288,4,593.77,2,1,1,4,Hibernating
12370,1222,7,783.64,1,1,1,3,Hibernating
12371,60,9,2505.88,5,2,4,11,Big Spenders
12372,98,11,1910.7599999999998,4,3,4,11,Loyal
12373,79,11,835.17,4,3,1,8,Loyal
12374,14,13,1638.2800000000002,5,4,3,12,Loyal
12375,526,10,639.59,1,3,1,5,Regulars
12376,197,9,1304.19,3,2,3,8,Regulars
12377,496,14,1963.8,1,5,4,10,At Risk
12378,123,10,980.8,4,3,2,9,Loyal
12379,139,12,1908.1399999999999,4,4,4,12,Champions
12380,120,13,1373.1299999999999,4,4,3,11,Loyal
12381,1266,7,1041.65,1,1,2,4,Hibernating
12382,554,6,1535.47,1,1,3,5,Regulars
12383,182,12,1156.92,3,4,2,9,Regulars
12384,360,3,385.22,2,1,1,4,Hibernating
12385,14,21,4632.7300000000005,5,5,5,15,Champions
12386,70,6,569.5500000000001,4,1,1,6,Regulars
12387,110,10,1924.01,4,3,4,11,Loyal
12388,291,13,2725.0,2,4,5,11,At Risk
12389,55,11,2011.13,5,3,4,12,Loyal
12390,18,10,1495.62,5,3,3,11,Loyal
12391,742,10,2024.81,1,3,4,8,Regulars
12392,103,12,1022.0800000000002,4,4,2,10,Loyal
12393,116,10,1904.32,4,3,4,11,Loyal
12394,479,10,883.66,1,3,2,6,Regulars
12395,97,9,999.69,4,2,2,8,Regulars
12396,348,8,2783.87,2,2,5,9,Regulars
12397,16,8,2947.82,5,2,5,12,Big Spenders
12398,96,10,549.47,4,3,1,8,Loyal
12399,75,15,1936.3400000000001,4,5,4,13,Champions
12400,214,6,1558.76,3,1,3,7,Regulars
12401,818,9,1880.34,1,2,4,7,Regulars
12402,756,4,294.06,1,1,1,3,Hibernating
12403,70,9,1053.89,4,2,2,8,Regulars
12404,51,7,649.66,5,1,1,7,Regulars
12405,133,12,1959.26,4,4,4,12,Champions
12406,129,14,2262.39,4,5,4,13,Champions
12407,33,17,4637.839999999999,5,5,5,15,Champions
12408,71,4,396.86,4,1,1,6,Regulars
12409,564,3,410.16,1,1,1,3,Hibernating
12410,46,8,946.8,5,2,2,9,Regulars
12411,66,10,1987.8500000000001,4,3,4,11,Loyal
12412,203,6,489.3,3,1,1,5,Regulars
12413,3,10,3078.89,5,3,5,13,Loyal
12414,144,9,1060.17,4,2,2,8,Regulars
12415,242,10,1258.13,3,3,3,9,Regulars
12416,238,10,1359.04,3,3,3,9,Regulars
12417,45,8,1211.1299999999999,5,2,2,9,Regulars
12418,330,10,1116.83,2,3,2,7,Regulars
12419,109,10,2807.5,4,3,5,12,Loyal
12420,99,10,1075.21,4,3,2,9,Loyal
12421,253,6,859.3399999999999,2,1,2,5,Hibernating
12422,578,8,969.4200000000001,1,2,2,5,Hibernating
12423,16,7,499.76,5,1,1,7,Regulars
12424,397,5,449.5,2,1,1,4,Hibernating
12425,493,9,1653.99,1,2,3,6,Regulars
12426,109,8,2286.94,4,2,4,10,Big Spenders
12427,602,3,232.6,1,1,1,3,Hibernating
12428,7,9,618.7,5,2,1,8,Regulars
12429,290,16,1438.6399999999999,2,5,3,10,At Risk
12430,47,9,1139.64,5,2,2,9,Regulars
12431,312,9,1273.21,2,2,3,7,Regulars
12432,132,15,1685.33,4,5,3,12,Loyal
12433,174,12,1933.78,3,4,4,11,Big Spenders
12434,419,9,1204.39,2,2,2,6,Hibernating
12435,82,9,999.54,4,2,2,8,Regulars
12436,832,12,819.08,1,4,1,6,At Risk
12437,78,6,560.6600000000001,4,1,1,6,Regulars
12438,82,10,2749.57,4,3,5,12,Loyal
12439,409,10,498.2,2,3,1,6,Regulars
12440,331,9,2354.1099999999997,2,2,4,8,Regulars
12441,88,11,2666.18,4,3,5,12,Loyal
12442,157,5,1070.49,3,1,2,6,Regulars
12443,701,5,472.44,1,1,1,3,Hibernating
12444,168,10,1825.9599999999998,3,3,4,10,Big Spenders
12445,200,7,1014.23,3,1,2,6,Regulars
12446,199,6,1746.1899999999998,3,1,4,8,Big Spenders
12447,121,9,732.71,4,2,1,7,Regulars
12448,126,13,3106.5,4,4,5,13,Champions
12449,14,13,1390.52,5,4,3,12,Loyal
12450,505,12,7593.639999999999,1,4,5,10,At Risk
12451,119,12,3629.34,4,4,5,13,Champions
12452,47,14,1427.56,5,5,3,13,Loyal
12453,267,10,933.54,2,3,2,7,Regulars
12454,33,16,2206.68,5,5,4,14,Champions
12455,542,18,3035.26,1,5,5,11,At Risk
12456,104,13,2254.03,4,4,4,12,Champions
12457,689,4,2101.96,1,1,4,6,Regulars
12458,261,10,2681.01,2,3,5,10,Regulars
12459,53,8,1015.39,5,2,2,9,Regulars
12460,522,7,2653.63,1,1,5,7,Regulars
12461,123,20,4240.67,4,5,5,14,Champions
12462,85,16,1746.47,4,5,4,13,Champions
12463,179,17,1323.8799999999999,3,5,3,11,Regulars
12464,217,4,284.4,3,1,1,5,Regulars
12465,658,8,1127.01,1,2,2,5,Hibernating
12466,210,9,646.58,3,2,1,6,Regulars
12467,29,12,972.71,5,4,2,11,Loyal
12468,64,11,2178.0,5,3,4,12,Loyal
12469,50,11,1077.39,5,3,2,10,Loyal
12470,30,6,386.75,5,1,1,7,Regulars
12471,358,6,498.47999999999996,2,1,1,4,Hibernating
12472,13,14,2708.5,5,5,5,15,Champions
12473,494,12,1906.09,1,4,4,9,At Risk
12474,872,4,460.47,1,1,1,3,Hibernating
12475,266,7,1045.98,2,1,2,5,Hibernating
12476,441,15,2073.92,2,5,4,11,At Risk
12477,202,8,755.99,3,2,1,6,Regulars
12478,14,9,823.76,5,2,1,8,Regulars
12479,877,11,1313.22,1,3,3,7,Regulars
12480,26,9,903.98,5,2,2,9,Regulars
12481,282,10,3044.02,2,3,5,10,Regulars
12482,315,10,1064.52,2,3,2,7,Regulars
12483,145,13,1438.69,4,4,3,11,Loyal
12484,506,9,2894.89,1,2,5,8,Regulars
12485,414,8,943.03,2,2,2,6,Hibernating
12486,379,12,1422.0700000000002,2,4,3,9,At Risk
12487,83,9,2087.8500000000004,4,2,4,10,Big Spenders
12488,563,12,2185.93,1,4,4,9,At Risk
12489,10,7,1112.83,5,1,2,8,Regulars
12490,143,10,1867.81,4,3,4,11,Loyal
12491,22,10,1425.23,5,3,3,11,Loyal
12492,214,14,3542.66,3,5,5,13,Big Spenders
12493,206,15,2254.8,3,5,4,12,Big Spenders
12494,1255,10,1860.64,1,3,4,8,Regulars
12495,560,10,3418.85,1,3,5,9,Regulars
12496,65,10,1931.6,5,3,4,12,Loyal
12497,210,8,929.15,3,2,2,7,Regulars
12498,337,9,1689.1499999999999,2,2,3,7,Regulars
12499,44,8,1758.38,5,2,4,11,Big Spenders
12500,35,9,659.42,5,2,1,8,Regulars
12501,82,9,3001.7300000000005,4,2,5,11,Big Spenders
12502,775,4,319.0,1,1,1,3,Hibernating
12503,234,12,2180.5499999999997,3,4,4,11,Big Spenders
12504,479,5,521.88,1,1,1,3,Hibernating
12505,822,11,2387.87,1,3,4,8,Regulars
12506,35,8,1439.32,5,2,3,10,Regulars
12507,209,6,618.14,3,1,1,5,Regulars
12508,118,8,776.6099999999999,4,2,1,7,Regulars
12509,447,12,3235.3999999999996,2,4,5,11,At Risk
12510,123,10,1936.89,4,3,4,11,Loyal
12511,3,11,1261.38,5,3,3,11,Loyal
12512,90,14,963.47,4,5,2,11,Loyal
12513,68,8,1366.72,4,2,3,9,Regulars
12514,731,13,2745.83,1,4,5,10,At Risk
12515,1336,9,954.7600000000001,1,2,2,5,Hibernating
12516,279,11,957.5799999999999,2,3,2,7,Regulars
12517,65,8,2655.31,5,2,5,12,Big Spenders
12518,284,8,673.04,2,2,1,5,Hibernating
12519,127,6,471.70000000000005,4,1,1,6,Regulars
12520,322,6,1012.65,2,1,2,5,Hibernating
12521,134,10,727.98,4,3,1,8,Loyal
12522,181,15,2147.5,3,5,4,12,Big Spenders
12523,100,8,2755.16,4,2,5,11,Big Spenders
12524,75,13,1818.31,4,4,4,12,Champions
12525,331,7,1199.74,2,1,2,5,Hibernating
12526,485,8,740.45,1,2,1,4,Hibernating
12527,41,7,2773.3199999999997,5,1,5,11,Big Spenders
12528,151,9,549.5600000000001,3,2,1,6,Regulars
12529,459,7,4468.28,2,1,5,8,Regulars
12530,385,14,2637.75,2,5,5,12,At Risk
12531,407,13,1887.55,2,4,4,10,At Risk
12532,28,15,2182.39,5,5,4,14,Champions
12533,194,8,1112.94,3,2,2,7,Regulars
12534,168,10,3969.84,3,3,5,11,Big Spenders
12535,390,14,1693.04,2,5,3,10,At Risk
12536,29,15,2440.81,5,5,4,14,Champions
12537,88,9,695.34,4,2,1,7,Regulars
12538,263,18,1738.58,2,5,4,11,At Risk
12539,321,12,2403.1,2,4,4,10,At Risk
12540,196,9,2648.44,3,2,5,10,Big Spenders
12541,188,8,492.46,3,2,1,6,Regulars
12542,119,6,462.09999999999997,4,1,1,6,Regulars
12543,207,11,1995.4199999999998,3,3,4,10,Big Spenders
12544,170,9,1633.5900000000001,3,2,3,8,Regulars
12545,1012,7,963.8499999999999,1,1,2,4,Hibernating
12546,32,7,1195.29,5,1,2,8,Regulars
12547,348,9,4909.57,2,2,5,9,Regulars
12548,4,11,1712.28,5,3,3,11,Loyal
12549,213,11,1171.92,3,3,2,8,Regulars
12550,508,3,432.57,1,1,1,3,Hibernating
12551,9,13,1531.98,5,4,3,12,Loyal
12552,224,17,2819.13,3,5,5,13,Big Spenders
12553,1043,4,618.93,1,1,1,3,Hibernating
12554,144,10,1348.77,4,3,3,10,Loyal
12555,1408,7,2326.44,1,1,4,6,Regulars
12556,43,11,1728.13,5,3,4,12,Loyal
12557,905,10,2230.73,1,3,4,8,Regulars
12558,0,11,1133.06,5,3,2,10,Loyal
12559,202,9,1640.62,3,2,3,8,Regulars
12560,648,11,3819.61,1,3,5,9,Regulars
12561,299,11,2699.0299999999997,2,3,5,10,Regulars
12562,221,10,2238.15,3,3,4,10,Big Spenders
12563,328,8,2924.7999999999997,2,2,5,9,Regulars
12564,188,7,1020.23,3,1,2,6,Regulars
12565,120,8,514.09,4,2,1,7,Regulars
12566,234,11,1798.37,3,3,4,10,Big Spenders
12567,17,6,1420.06,5,1,3,9,Regulars
12568,71,8,636.41,4,2,1,7,Regulars
12569,53,10,2629.19,5,3,5,13,Loyal
12570,641,13,3724.76,1,4,5,10,At Risk
12571,259,14,1524.3700000000001,2,5,3,10,At Risk
12572,142,16,2101.27,4,5,4,13,Champions
12573,297,12,1352.67,2,4,3,9,At Risk
12574,343,11,1094.58,2,3,2,7,Regulars
12575,97,16,2472.0,4,5,4,13,Champions
12576,958,6,1108.32,1,1,2,4,Hibernating
12577,385,11,1715.65,2,3,3,8,Regulars
12578,77,12,1527.23,4,4,3,11,Loyal
12579,613,8,1218.15,1,2,2,5,Hibernating
12580,236,8,1176.99,3,2,2,7,Regulars
12581,35,13,1559.58,5,4,3,12,Loyal
12582,264,11,2146.98,2,3,4,9,Regulars
12583,700,9,949.1100000000001,1,2,2,5,Hibernating
12584,73,6,1157.18,4,1,2,7,Regulars
12585,46,7,963.02,5,1,2,8,Regulars
12586,99,14,1287.2,4,5,3,12,Loyal
12587,13,12,2040.9499999999998,5,4,4,13,Champions
12588,523,15,1725.89,1,5,4,10,At Risk
12589,227,11,683.51,3,3,1,7,Regulars
12590,294,14,1841.77,2,5,4,11,At Risk
12591,229,6,393.37,3,1,1,5,Regulars
12592,119,10,1003.54,4,3,2,9,Loyal
12593,412,10,1225.49,2,3,2,7,Regulars
12594,108,11,3715.96,4,3,5,12,Loyal
12595,366,16,2495.35,2,5,4,11,At Risk
12596,498,9,1897.8,1,2,4,7,Regulars
12597,7,16,3377.3,5,5,5,15,Champions
12598,176,17,3882.3999999999996,3,5,5,13,Big Spenders
12599,383,11,1527.26,2,3,3,8,Regulars
12600,266,14,2302.89,2,5,4,11,At Risk
12601,756,7,2396.09,1,1,4,6,Regulars
12602,357,14,2135.2200000000003,2,5,4,11,At Risk
12603,102,8,873.34,4,2,2,8,Regulars
12604,71,12,1371.12,4,4,3,11,Loyal
12605,509,10,3582.09,1,3,5,9,Regulars
12606,712,7,2641.33,1,1,5,7,Regulars
12607,265,13,2401.48,2,4,4,10,At Risk
12608,33,13,1720.7,5,4,3,12,Loyal
12609,710,10,1898.6100000000001,1,3,4,8,Regulars
12610,1200,7,1702.65,1,1,3,5,Regulars
12611,54,4,468.39,5,1,1,7,Regulars
12612,175,13,2933.94,3,4,5,12,Big Spenders
12613,53,13,3739.58,5,4,5,14,Champions
12614,206,4,213.52,3,1,1,5,Regulars
12615,526,14,1525.4099999999999,1,5,3,9,At Risk
12616,154,10,1694.9,3,3,3,9,Regulars
12617,80,13,1754.92,4,4,4,12,Champions
12618,434,7,1268.72,2,1,3,6,Regulars
12619,85,13,2001.92,4,4,4,12,Champions
12620,280,3,387.82000000000005,2,1,1,4,Hibernating
12621,127,9,1839.13,4,2,4,10,Big Spenders
12622,11,17,2746.63,5,5,5,15,Champions
12623,739,7,1023.6200000000001,1,1,2,4,Hibernating
12624,247,9,2447.37,3,2,4,9,Big Spenders
12625,31,6,937.4499999999999,5,1,2,8,Regulars
12626,305,13,838.69,2,4,1,7,At Risk
12627,479,13,1118.76,1,4,2,7,At Risk
12628,911,7,475.78,1,1,1,3,Hibernating
12629,394,12,1204.36,2,4,2,8,At Risk
12630,0,7,1264.14,5,1,3,9,Regulars
12631,448,8,791.39,2,2,1,5,Hibernating
12632,45,12,2685.53,5,4,5,14,Champions
12633,166,8,3337.35,3,2,5,10,Big Spenders
12634,65,13,3366.52,5,4,5,14,Champions
12635,172,10,1193.8799999999999,3,3,2,8,Regulars
12636,9,13,3199.9500000000003,5,4,5,14,Champions
12637,168,6,3109.0,3,1,5,9,Big Spenders
12638,502,13,1340.6100000000001,1,4,3,8,At Risk
12639,521,8,1682.9,1,2,3,6,Regulars
12640,139,14,1056.07,4,5,2,11,Loyal
12641,10,7,1050.33,5,1,2,8,Regulars
12642,49,7,537.08,5,1,1,7,Regulars
12643,11,8,628.5699999999999,5,2,1,8,Regulars
12644,246,11,1008.66,3,3,2,8,Regulars
12645,42,7,384.37,5,1,1,7,Regulars
12646,1026,9,3359.65,1,2,5,8,Regulars
12647,173,10,931.2700000000001,3,3,2,8,Regulars
12648,82,14,2312.93,4,5,4,13,Champions
12649,57,9,2213.78,5,2,4,11,Big Spenders
12650,224,6,633.19,3,1,1,5,Regulars
12651,1529,3,281.82,1,1,1,3,Hibernating
12652,220,10,1123.0,3,3,2,8,Regulars
12653,149,15,1461.44,3,5,3,11,Regulars
12654,1616,7,807.13,1,1,1,3,Hibernating
12655,158,15,2681.54,3,5,5,13,Big Spenders
12656,108,10,1298.14,4,3,3,10,Loyal
12657,53,9,576.7,5,2,1,8,Regulars
12658,35,9,513.52,5,2,1,8,Regulars
12659,741,8,2119.11,1,2,4,7,Regulars
12660,11,9,681.03,5,2,1,8,Regulars
12661,438,10,884.55,2,3,2,7,Regulars
12662,38,8,740.65,5,2,1,8,Regulars
12663,80,11,3195.71,4,3,5,12,Loyal
12664,79,6,1089.96,4,1,2,7,Regulars
12665,388,11,1097.2,2,3,2,7,Regulars
12666,194,8,1665.87,3,2,3,8,Regulars
12667,171,16,2174.8,3,5,4,12,Big Spenders
12668,892,13,1500.77,1,4,3,8,At Risk
12669,101,13,833.61,4,4,1,9,Loyal
12670,2,8,592.0600000000001,5,2,1,8,Regulars
12671,171,12,4198.1,3,4,5,12,Big Spenders
12672,106,8,2568.79,4,2,4,10,Big Spenders
12673,223,9,1142.42,3,2,2,7,Regulars
12674,168,11,1260.92,3,3,3,9,Regulars
12675,195,10,1495.2,3,3,3,9,Regulars
12676,29,8,591.6700000000001,5,2,1,8,Regulars
12677,153,13,1508.46,3,4,3,10,Regulars
12678,166,12,1049.07,3,4,2,9,Regulars
12679,23,15,3310.4500000000003,5,5,5,15,Champions
12680,481,13,2257.73,1,4,4,9,At Risk
12681,26,10,1445.49,5,3,3,11,Loyal
12682,155,9,1673.56,3,2,3,8,Regulars
12683,465,7,962.4300000000001,1,1,2,4,Hibernating
12684,456,9,600.12,2,2,1,5,Hibernating
12685,455,8,1407.02,2,2,3,7,Regulars
12686,172,14,3771.1,3,5,5,13,Big Spenders
12687,134,12,1243.13,4,4,3,11,Loyal
12688,278,11,846.37,2,3,2,7,Regulars
12689,20,16,1663.8,5,5,3,13,Loyal
12690,61,8,1206.98,5,2,2,9,Regulars
12691,530,13,2237.75,1,4,4,9,At Risk
12692,164,10,1028.29,3,3,2,8,Regulars
12693,32,9,596.97,5,2,1,8,Regulars
12694,39,13,3282.6000000000004,5,4,5,14,Champions
12695,152,11,2193.99,3,3,4,10,Big Spenders
12696,51,15,1932.24,5,5,4,14,Champions
12697,239,10,1392.27,3,3,3,9,Regulars
12698,154,9,1167.36,3,2,2,7,Regulars
12699,786,9,946.0600000000001,1,2,2,5,Hibernating
12700,490,9,1917.74,1,2,4,7,Regulars
12701,495,12,1576.2800000000002,1,4,3,8,At Risk
12702,614,8,2483.9100000000003,1,2,4,7,Regulars
12703,212,6,1104.28,3,1,2,6,Regulars
12704,186,16,2451.72,3,5,4,12,Big Spenders
12705,972,2,143.08,1,1,1,3,Hibernating
12706,123,8,522.69,4,2,1,7,Regulars
12707,664,13,1569.24,1,4,3,8,At Risk
12708,142,11,1295.97,4,3,3,10,Loyal
12709,240,9,4886.08,3,2,5,10,Big Spenders
12710,492,5,2338.73,1,1,4,6,Regulars
12711,1,9,701.11,5,2,1,8,Regulars
12712,40,9,2709.34,5,2,5,12,Big Spenders
12713,132,9,3831.05,4,2,5,11,Big Spenders
12714,194,8,1154.28,3,2,2,7,Regulars
12715,60,10,1092.8,5,3,2,10,Loyal
12716,431,7,721.78,2,1,1,4,Hibernating
12717,102,8,935.49,4,2,2,8,Regulars
12718,31,18,1607.45,5,5,3,13,Loyal
12719,10,13,3334.9900000000002,5,4,5,14,Champions
12720,103,7,1755.86,4,1,4,9,Big Spenders
12721,713,11,4525.580000000001,1,3,5,9,Regulars
12722,254,14,3178.37,2,5,5,12,At Risk
12723,30,10,1676.2,5,3,3,11,Loyal
12724,272,17,1267.8899999999999,2,5,3,10,At Risk
12725,461,6,1134.74,1,1,2,4,Hibernating
12726,116,17,4366.48,4,5,5,14,Champions
12727,342,14,3004.97,2,5,5,12,At Risk
12728,348,10,3012.4,2,3,5,10,Regulars
12729,38,11,1336.1,5,3,3,11,Loyal
12730,546,10,1868.0,1,3,4,8,Regulars
12731,156,15,2861.15,3,5,5,13,Big Spenders
12732,93,11,2991.6800000000003,4,3,5,12,Loyal
12733,917,6,924.63,1,1,2,4,Hibernating
12734,302,11,1403.69,2,3,3,8,Regulars
12735,667,7,1011.46,1,1,2,4,Hibernating
12736,521,8,1109.32,1,2,2,5,Hibernating
12737,1382,7,909.3900000000001,1,1,2,4,Hibernating
12738,545,11,2948.8,1,3,5,9,Regulars
12739,178,10,2886.43,3,3,5,11,Big Spenders
12740,103,13,1524.55,4,4,3,11,Loyal
12741,78,13,2323.7000000000003,4,4,4,12,Champions
12742,81,9,1140.75,4,2,2,8,Regulars
12743,456,7,1281.79,2,1,3,6,Regulars
12744,544,9,668.88,1,2,1,4,Hibernating
12745,278,8,1039.2099999999998,2,2,2,6,Hibernating
12746,203,9,1344.7,3,2,3,8,Regulars
12747,33,15,2635.77,5,5,5,15,Champions
12748,22,13,2237.51,5,4,4,13,Champions
12749,236,11,683.21,3,3,1,7,Regulars
12750,241,9,1319.46,3,2,3,8,Regulars
12751,63,14,1898.84,5,5,4,14,Champions
12752,111,16,1836.25,4,5,4,13,Champions
12753,711,10,1795.95,1,3,4,8,Regulars
12754,105,14,3281.73,4,5,5,14,Champions
12755,1007,12,1981.25,1,4,4,9,At Risk
12756,197,10,2676.36,3,3,5,11,Big Spenders
12757,1175,3,1804.9099999999999,1,1,4,6,Regulars
12758,140,10,663.89,4,3,1,8,Loyal
12759,405,13,1152.8400000000001,2,4,2,8,At Risk
12760,445,12,1387.85,2,4,3,9,At Risk
12761,295,8,896.39,2,2,2,6,Hibernating
12762,293,13,3334.27,2,4,5,11,At Risk
12763,358,14,4887.85,2,5,5,12,At Risk
12764,888,11,2410.24,1,3,4,8,Regulars
12765,1639,3,1026.28,1,1,2,4,Hibernating
12766,149,8,1198.8,3,2,2,7,Regulars
12767,128,12,1279.49,4,4,3,11,Loyal
12768,4,12,1659.13,5,4,3,12,Loyal
12769,55,15,1908.47,5,5,4,14,Champions
12770,6,10,1960.6699999999998,5,3,4,12,Loyal
12771,181,7,1304.93,3,1,3,7,Regulars
12772,39,10,1584.16,5,3,3,11,Loyal
12773,227,9,750.72,3,2,1,6,Regulars
12774,356,4,835.85,2,1,1,4,Hibernating
12775,240,11,4037.75,3,3,5,11,Big Spenders
12776,119,11,1609.06,4,3,3,10,Loyal
12777,8,11,969.5799999999999,5,3,2,10,Loyal
12778,395,6,550.49,2,1,1,4,Hibernating
12779,220,11,952.84,3,3,2,8,Regulars
12780,31,12,4129.2300000000005,5,4,5,14,Champions
12781,75,9,1337.27,4,2,3,9,Regulars
12782,649,12,1650.8400000000001,1,4,3,8,At Risk
12783,535,8,3504.98,1,2,5,8,Regulars
12784,151,14,1074.33,3,5,2,10,Regulars
12785,591,13,2396.6,1,4,4,9,At Risk
12786,312,13,1869.68,2,4,4,10,At Risk
12787,42,11,1512.45,5,3,3,11,Loyal
12788,145,7,651.09,4,1,1,6,Regulars
12789,610,9,1265.64,1,2,3,6,Regulars
12790,556,10,1922.9599999999998,1,3,4,8,Regulars
12791,395,15,2183.28,2,5,4,11,At Risk
12792,505,8,857.35,1,2,2,5,Hibernating
12793,215,4,279.63,3,1,1,5,Regulars
12794,155,12,1400.05,3,4,3,10,Regulars
12795,99,12,1297.9,4,4,3,11,Loyal
12796,472,7,3053.77,1,1,5,7,Regulars
12797,99,11,1792.1599999999999,4,3,4,11,Loyal
12798,193,11,1182.8899999999999,3,3,2,8,Regulars
12799,8,13,1723.34,5,4,3,12,Loyal
12800,30,13,3191.29,5,4,5,14,Champions
12801,40,3,301.64,5,1,1,7,Regulars
12802,199,8,944.54,3,2,2,7,Regulars
12803,108,18,1363.33,4,5,3,12,Loyal
12804,455,10,866.36,2,3,2,7,Regulars
12805,162,8,522.2,3,2,1,6,Regulars
12806,128,11,1842.4,4,3,4,11,Loyal
12807,172,11,2237.77,3,3,4,10,Big Spenders
12808,491,10,569.31,1,3,1,5,Regulars
12809,108,11,1200.1799999999998,4,3,2,9,Loyal
12810,146,14,1972.57,4,5,4,13,Champions
12811,162,7,3183.03,3,1,5,9,Big Spenders
12812,177,16,937.3,3,5,2,10,Regulars
12813,427,8,1535.27,2,2,3,7,Regulars
12814,34,12,1289.73,5,4,3,12,Loyal
12815,287,9,798.01,2,2,1,5,Hibernating
12816,132,10,1582.06,4,3,3,10,Loyal
12817,212,8,3569.96,3,2,5,10,Big Spenders
12818,631,11,1479.85,1,3,3,7,Regulars
12819,575,10,1246.54,1,3,3,7,Regulars
12820,353,14,4170.39,2,5,5,12,At Risk
12821,206,13,1560.31,3,4,3,10,Regulars
12822,5,16,3607.65,5,5,5,15,Champions
12823,61,13,3658.5,5,4,5,14,Champions
12824,9,10,1400.73,5,3,3,11,Loyal
12825,568,7,953.38,1,1,2,4,Hibernating
12826,19,8,548.64,5,2,1,8,Regulars
12827,353,14,2194.4700000000003,2,5,4,11,At Risk
12828,139,10,1200.21,4,3,2,9,Loyal
12829,12,12,1518.61,5,4,3,12,Loyal
12830,690,7,742.37,1,1,1,3,Hibernating
12831,235,11,1041.87,3,3,2,8,Regulars
12832,158,7,1193.4,3,1,2,6,Regulars
12833,731,13,1564.03,1,4,3,8,At Risk
12834,38,4,422.85,5,1,1,7,Regulars
12835,233,12,1704.94,3,4,3,10,Regulars
12836,64,10,1339.29,5,3,3,11,Loyal
12837,171,13,1083.23,3,4,2,9,Regulars
12838,1,13,2395.75,5,4,4,13,Champions
12839,69,10,2791.01,4,3,5,12,Loyal
12840,477,11,1291.82,1,3,3,7,Regulars
12841,34,13,1353.75,5,4,3,12,Loyal
12842,768,3,147.97000000000003,1,1,1,3,Hibernating
12843,580,4,2059.98,1,1,4,6,Regulars
12844,266,13,1704.48,2,4,3,9,At Risk
12845,105,12,3253.67,4,4,5,13,Champions
12846,161,10,1200.8600000000001,3,3,2,8,Regulars
12847,12,11,1460.67,5,3,3,11,Loyal
12848,87,7,513.79,4,1,1,6,Regulars
12849,101,13,1120.97,4,4,2,10,Loyal
12850,59,7,591.26,5,1,1,7,Regulars
12851,660,10,1749.0800000000002,1,3,4,8,Regulars
12852,750,10,1770.85,1,3,4,8,Regulars
12853,890,6,767.9300000000001,1,1,1,3,Hibernating
12854,487,8,643.43,1,2,1,4,Hibernating
12855,51,11,1593.86,5,3,3,11,Loyal
12856,123,9,4345.36,4,2,5,11,Big Spenders
12857,357,11,1954.78,2,3,4,9,Regulars
12858,747,6,1972.4299999999998,1,1,4,6,Regulars
12859,216,14,1227.29,3,5,2,10,Regulars
12860,218,6,1403.04,3,1,3,7,Regulars
12861,99,12,3924.59,4,4,5,13,Champions
12862,113,9,1870.5300000000002,4,2,4,10,Big Spenders
12863,165,8,496.3,3,2,1,6,Regulars
12864,40,10,3372.0600000000004,5,3,5,13,Loyal
12865,527,8,683.86,1,2,1,4,Hibernating
12866,263,8,2093.16,2,2,4,8,Regulars
12867,656,7,2098.65,1,1,4,6,Regulars
12868,435,11,1017.83,2,3,2,7,Regulars
12869,32,11,1810.75,5,3,4,12,Loyal
12870,206,9,1890.06,3,2,4,9,Big Spenders
12871,163,16,3727.93,3,5,5,13,Big Spenders
12872,123,6,732.52,4,1,1,6,Regulars
12873,106,9,2610.2000000000003,4,2,5,11,Big Spenders
12874,96,14,2990.17,4,5,5,14,Champions
12875,158,11,1623.21,3,3,3,9,Regulars
12876,2093,5,237.06,1,1,1,3,Hibernating
12877,132,6,740.8199999999999,4,1,1,6,Regulars
12878,566,4,764.08,1,1,1,3,Hibernating
12879,219,11,986.26,3,3,2,8,Regulars
12880,24,6,381.27,5,1,1,7,Regulars
12881,15,14,1917.6200000000001,5,5,4,14,Champions
12882,256,19,4758.5599999999995,2,5,5,12,At Risk
12883,478,10,1989.28,1,3,4,8,Regulars
12884,598,10,983.53,1,3,2,6,Regulars
12885,65,17,2874.53,5,5,5,15,Champions
12886,26,11,2044.2199999999998,5,3,4,12,Loyal
12887,219,14,1952.05,3,5,4,12,Big Spenders
12888,271,6,697.1700000000001,2,1,1,4,Hibernating
12889,394,6,2198.85,2,1,4,7,Regulars
12890,70,12,2220.77,4,4,4,12,Champions
12891,104,14,1515.13,4,5,3,12,Loyal
12892,57,10,1548.4299999999998,5,3,3,11,Loyal
12893,24,9,1204.62,5,2,2,9,Regulars
12894,162,11,1201.53,3,3,2,8,Regulars
12895,345,7,507.06,2,1,1,4,Hibernating
12896,758,3,176.03,1,1,1,3,Hibernating
12897,630,9,861.64,1,2,2,5,Hibernating
12898,581,6,1608.2000000000003,1,1,3,5,Regulars
12899,473,9,1467.35,1,2,3,6,Regulars
12900,44,14,1988.8899999999999,5,5,4,14,Champions
12901,51,9,980.23,5,2,2,9,Regulars
12902,274,11,1852.5900000000001,2,3,4,9,Regulars
12903,9,7,1999.52,5,1,4,10,Big Spenders
12904,27,12,1728.7199999999998,5,4,4,13,Champions
12905,172,9,1098.36,3,2,2,7,Regulars
12906,878,6,538.0600000000001,1,1,1,3,Hibernating
12907,622,5,233.48,1,1,1,3,Hibernating
12908,927,13,1182.51,1,4,2,7,At Risk
12909,74,9,1413.1200000000001,4,2,3,9,Regulars
12910,129,5,404.46999999999997,4,1,1,6,Regulars
12911,129,10,1311.73,4,3,3,10,Loyal
12912,32,18,2786.19,5,5,5,15,Champions
12913,139,13,1572.27,4,4,3,11,Loyal
12914,226,12,1343.27,3,4,3,10,Regulars
12915,980,6,756.91,1,1,1,3,Hibernating
12916,6,13,1344.79,5,4,3,12,Loyal
12917,204,11,904.52,3,3,2,8,Regulars
12918,258,7,1465.43,2,1,3,6,Regulars
12919,342,10,1266.96,2,3,3,8,Regulars
12920,231,7,519.02,3,1,1,5,Regulars
12921,547,8,1228.05,1,2,2,5,Hibernating
12922,865,5,345.15999999999997,1,1,1,3,Hibernating
12923,297,10,1352.15,2,3,3,8,Regulars
12924,490,6,891.6800000000001,1,1,2,4,Hibernating
12925,124,6,432.36,4,1,1,6,Regulars
12926,212,10,1281.79,3,3,3,9,Regulars
12927,178,12,531.5,3,4,1,8,Regulars
12928,109,15,1017.65,4,5,2,11,Loyal
12929,195,11,621.01,3,3,1,7,Regulars
12930,556,8,1003.3900000000001,1,2,2,5,Hibernating
12931,321,10,880.0699999999999,2,3,2,7,Regulars
12932,122,15,2324.43,4,5,4,13,Champions
12933,20,13,2874.09,5,4,5,14,Champions
12934,139,11,1296.83,4,3,3,10,Loyal
12935,286,9,880.1500000000001,2,2,2,6,Hibernating
12936,179,11,1173.63,3,3,2,8,Regulars
12937,1058,2,119.95000000000002,1,1,1,3,Hibernating
12938,287,9,1009.65,2,2,2,6,Hibernating
12939,23,13,2877.19,5,4,5,14,Champions
12940,85,9,1002.9300000000001,4,2,2,8,Regulars
12941,32,11,662.65,5,3,1,9,Loyal
12942,58,11,2560.59,5,3,4,12,Loyal
12943,439,6,970.31,2,1,2,5,Hibernating
12944,510,9,962.85,1,2,2,5,Hibernating
12945,250,10,2027.84,2,3,4,9,Regulars
12946,699,8,565.92,1,2,1,4,Hibernating
12947,123,11,1470.52,4,3,3,10,Loyal
12948,564,13,2750.54,1,4,5,10,At Risk
12949,343,11,962.43,2,3,2,7,Regulars
12950,38,18,2968.62,5,5,5,15,Champions
12951,7,6,458.79,5,1,1,7,Regulars
12952,205,10,1389.35,3,3,3,9,Regulars
12953,31,9,1354.76,5,2,3,10,Regulars
12954,168,7,416.84,3,1,1,5,Regulars
12955,68,11,1445.92,4,3,3,10,Loyal
12956,248,11,3441.7,2,3,5,10,Regulars
12957,665,7,372.19,1,1,1,3,Hibernating
12958,207,12,3762.67,3,4,5,12,Big Spenders
12959,57,8,1206.28,5,2,2,9,Regulars
12960,604,8,1583.8,1,2,3,6,Regulars
12961,315,6,848.62,2,1,2,5,Hibernating
12962,131,8,847.21,4,2,2,8,Regulars
12963,129,12,1316.58,4,4,3,11,Loyal
12964,2,16,1443.46,5,5,3,13,Loyal
12965,410,10,592.6,2,3,1,6,Regulars
12966,90,9,1100.65,4,2,2,8,Regulars
12967,298,13,1379.54,2,4,3,9,At Risk
12968,627,1,71.07,1,1,1,3,Hibernating
12969,710,8,737.0799999999999,1,2,1,4,Hibernating
12970,100,8,851.27,4,2,2,8,Regulars
12971,223,9,1490.18,3,2,3,8,Regulars
12972,52,15,1368.21,5,5,3,13,Loyal
12973,521,4,468.45,1,1,1,3,Hibernating
12974,89,9,990.21,4,2,2,8,Regulars
12975,184,10,1877.88,3,3,4,10,Big Spenders
12976,322,7,298.18,2,1,1,4,Hibernating
12977,172,12,2432.46,3,4,4,11,Big Spenders
12978,224,14,1589.84,3,5,3,11,Regulars
12979,113,11,1106.8,4,3,2,9,Loyal
12980,107,12,2231.04,4,4,4,12,Champions
12981,126,17,2754.54,4,5,5,14,Champions
12982,6,11,1903.43,5,3,4,12,Loyal
12983,116,12,2353.3,4,4,4,12,Champions
12984,333,7,847.83,2,1,2,5,Hibernating
12985,75,18,2853.33,4,5,5,14,Champions
12986,305,10,663.58,2,3,1,6,Regulars
12987,69,7,1973.6799999999998,4,1,4,9,Big Spenders
12988,125,10,1628.58,4,3,3,10,Loyal
12989,291,8,929.88,2,2,2,6,Hibernating
12990,196,13,4987.6900000000005,3,4,5,12,Big Spenders
12991,18,12,763.82,5,4,1,10,Loyal
12992,272,15,4197.72,2,5,5,12,At Risk
12993,99,10,2672.75,4,3,5,12,Loyal
12994,12,10,1010.77,5,3,2,10,Loyal
12995,120,17,1335.2,4,5,3,12,Loyal
12996,1007,9,1399.1100000000001,1,2,3,6,Regulars
12997,598,10,2339.22,1,3,4,8,Regulars
12998,41,17,5326.32,5,5,5,15,Champions
12999,35,16,2684.16,5,5,5,15,Champions
13000,79,7,676.84,4,1,1,6,Regulars
13001,103,9,983.49,4,2,2,8,Regulars
13002,26,11,6219.68,5,3,5,13,Loyal
13003,35,15,5739.86,5,5,5,15,Champions
13004,110,13,2079.9700000000003,4,4,4,12,Champions
13005,721,6,1112.8999999999999,1,1,2,4,Hibernating
13006,8,4,957.7099999999999,5,1,2,8,Regulars
13007,83,9,1055.05,4,2,2,8,Regulars
13008,1,12,3042.16,5,4,5,14,Champions
13009,29,13,1348.18,5,4,3,12,Loyal
13010,256,10,744.1700000000001,2,3,1,6,Regulars
13011,118,14,1567.3,4,5,3,12,Loyal
13012,403,6,602.42,2,1,1,4,Hibernating
13013,1015,8,2249.55,1,2,4,7,Regulars
13014,236,11,2172.23,3,3,4,10,Big Spenders
13015,17,9,3954.41,5,2,5,12,Big Spenders
13016,124,6,1105.88,4,1,2,7,Regulars
13017,19,12,3552.66,5,4,5,14,Champions
13018,612,9,1038.3,1,2,2,5,Hibernating
13019,304,8,2720.9599999999996,2,2,5,9,Regulars
13020,145,15,1675.58,4,5,3,12,Loyal
13021,1152,8,828.4,1,2,1,4,Hibernating
13022,82,8,366.99,4,2,1,7,Regulars
13023,225,11,1306.97,3,3,3,9,Regulars
13024,63,13,1555.65,5,4,3,12,Loyal
13025,194,9,3988.96,3,2,5,10,Big Spenders
13026,669,5,243.16,1,1,1,3,Hibernating
13027,398,7,2535.4,2,1,4,7,Regulars
13028,136,9,652.13,4,2,1,7,Regulars
13029,374,11,1931.0700000000002,2,3,4,9,Regulars
13030,85,7,748.65,4,1,1,6,Regulars
13031,60,14,1389.0,5,5,3,13,Loyal
13032,21,13,1269.33,5,4,3,12,Loyal
13033,113,7,568.96,4,1,1,6,Regulars
13034,64,6,876.15,5,1,2,8,Regulars
13035,133,9,1709.08,4,2,3,9,Regulars
13036,93,11,3143.45,4,3,5,12,Loyal
13037,476,6,1630.96,1,1,3,5,Regulars
13038,93,14,2359.39,4,5,4,13,Champions
13039,21,13,1879.1599999999999,5,4,4,13,Champions
13040,106,11,1811.5900000000001,4,3,4,11,Loyal
13041,606,5,415.93,1,1,1,3,Hibernating
13042,60,11,2452.26,5,3,4,12,Loyal
13043,195,6,514.7,3,1,1,5,Regulars
13044,361,10,878.3599999999999,2,3,2,7,Regulars
13045,102,9,956.53,4,2,2,8,Regulars
13046,110,10,4431.28,4,3,5,12,Loyal
13047,125,9,859.13,4,2,2,8,Regulars
13048,245,12,2099.25,3,4,4,11,Big Spenders
13049,107,10,1435.7,4,3,3,10,Loyal
13050,214,14,1486.89,3,5,3,11,Regulars
13051,55,13,2734.43,5,4,5,14,Champions
13052,232,8,893.3499999999999,3,2,2,7,Regulars
13053,897,15,2327.9700000000003,1,5,4,10,At Risk
13054,873,8,1378.5500000000002,1,2,3,6,Regulars
13055,278,10,1443.64,2,3,3,8,Regulars
13056,439,10,671.52,2,3,1,6,Regulars
13057,157,11,2528.56,3,3,4,10,Big Spenders
13058,293,13,2118.05,2,4,4,10,At Risk
13059,144,12,1528.3200000000002,4,4,3,11,Loyal
13060,565,7,1143.36,1,1,2,4,Hibernating
13061,800,6,432.87,1,1,1,3,Hibernating
13062,40,7,1114.47,5,1,2,8,Regulars
13063,201,11,6710.74,3,3,5,11,Big Spenders
13064,434,11,1605.65,2,3,3,8,Regulars
13065,56,15,1755.53,5,5,4,14,Champions
13066,67,11,1963.09,4,3,4,11,Loyal
13067,73,10,1110.07,4,3,2,9,Loyal
13068,56,12,1572.88,5,4,3,12,Loyal
13069,547,8,660.53,1,2,1,4,Hibernating
13070,128,9,3494.62,4,2,5,11,Big Spenders
13071,40,13,2608.17,5,4,5,14,Champions
13072,790,4,477.12,1,1,1,3,Hibernating
13073,124,13,4613.43,4,4,5,13,Champions
13074,207,9,1268.96,3,2,3,8,Regulars
13075,259,6,232.09,2,1,1,4,Hibernating
13076,523,11,1295.32,1,3,3,7,Regulars
13077,165,11,2063.15,3,3,4,10,Big Spenders
13078,450,7,1518.96,2,1,3,6,Regulars
13079,183,10,1429.94,3,3,3,9,Regulars
13080,245,9,1268.31,3,2,3,8,Regulars
13081,15,8,1689.65,5,2,3,10,Regulars
13082,29,12,1540.56,5,4,3,12,Loyal
13083,368,11,1378.8899999999999,2,3,3,8,Regulars
13084,74,15,1761.47,4,5,4,13,Champions
13085,234,13,920.5600000000001,3,4,2,9,Regulars
13086,149,11,614.81,3,3,1,7,Regulars
13087,515,5,708.92,1,1,1,3,Hibernating
13088,499,6,1637.8,1,1,3,5,Regulars
13089,192,6,640.72,3,1,1,5,Regulars
13090,314,12,1884.88,2,4,4,10,At Risk
13091,609,11,4462.160000000001,1,3,5,9,Regulars
13092,611,13,2894.5,1,4,5,10,At Risk
13093,135,7,613.33,4,1,1,6,Regulars
13094,132,13,2828.81,4,4,5,13,Champions
13095,705,12,1028.27,1,4,2,7,At Risk
13096,169,17,3706.76,3,5,5,13,Big Spenders
13097,120,9,929.04,4,2,2,8,Regulars
13098,64,10,3669.11,5,3,5,13,Loyal
13099,754,10,1304.31,1,3,3,7,Regulars
13100,603,7,566.25,1,1,1,3,Hibernating
13101,844,6,327.5,1,1,1,3,Hibernating
13102,214,3,147.06,3,1,1,5,Regulars
13103,18,9,818.6899999999999,5,2,1,8,Regulars
13104,280,15,3980.63,2,5,5,12,At Risk
13105,346,10,1212.54,2,3,2,7,Regulars
13106,201,10,1132.58,3,3,2,8,Regulars
13107,462,8,561.72,1,2,1,4,Hibernating
13108,6,11,1968.32,5,3,4,12,Loyal
13109,329,9,2209.77,2,2,4,8,Regulars
13110,64,10,1117.12,5,3,2,10,Loyal
13111,21,11,3337.24,5,3,5,13,Loyal
13112,356,9,699.97,2,2,1,5,Hibernating
13113,508,7,4073.96,1,1,5,7,Regulars
13114,44,19,3886.98,5,5,5,15,Champions
13115,192,11,1538.48,3,3,3,9,Regulars
13116,167,10,1068.13,3,3,2,8,Regulars
13117,265,13,1161.09,2,4,2,8,At Risk
13118,4,12,1742.54,5,4,4,13,Champions
13119,305,7,1358.1100000000001,2,1,3,6,Regulars
13120,213,10,1385.8,3,3,3,9,Regulars
13121,265,10,3290.5599999999995,2,3,5,10,Regulars
13122,206,12,1423.27,3,4,3,10,Regulars
13123,63,9,1925.94,5,2,4,11,Big Spenders
13124,165,9,533.6,3,2,1,6,Regulars
13125,128,11,1324.35,4,3,3,10,Loyal
13126,107,13,3249.0299999999997,4,4,5,13,Champions
13127,544,12,1351.78,1,4,3,8,At Risk
13128,122,10,1398.36,4,3,3,10,Loyal
13129,479,13,1078.03,1,4,2,7,At Risk
13130,29,5,609.85,5,1,1,7,Regulars
13131,149,14,1164.59,3,5,2,10,Regulars
13132,113,5,441.15999999999997,4,1,1,6,Regulars
13133,231,9,1298.63,3,2,3,8,Regulars
13134,253,12,1261.77,2,4,3,9,At Risk
13135,267,6,469.7,2,1,1,4,Hibernating
13136,229,10,2691.2,3,3,5,11,Big Spenders
13137,689,15,1801.64,1,5,4,10,At Risk
13138,6,17,1934.27,5,5,4,14,Champions
13139,159,7,1072.33,3,1,2,6,Regulars
13140,124,8,1891.25,4,2,4,10,Big Spenders
13141,578,10,1109.61,1,3,2,6,Regulars
13142,779,10,1472.43,1,3,3,7,Regulars
13143,173,8,599.38,3,2,1,6,Regulars
13144,101,10,839.54,4,3,1,8,Loyal
13145,85,13,4142.4,4,4,5,13,Champions
13146,65,10,1757.96,5,3,4,12,Loyal
13147,150,11,1164.8600000000001,3,3,2,8,Regulars
13148,261,11,2467.17,2,3,4,9,Regulars
13149,382,8,1020.95,2,2,2,6,Hibernating
13150,383,10,1134.73,2,3,2,7,Regulars
13151,34,9,1411.81,5,2,3,10,Regulars
13152,152,14,1827.06,3,5,4,12,Big Spenders
13153,145,10,1227.8999999999999,4,3,2,9,Loyal
13154,59,9,809.7,5,2,1,8,Regulars
13155,176,13,1469.72,3,4,3,10,Regulars
13156,337,15,1961.0,2,5,4,11,At Risk
13157,207,8,889.49,3,2,2,7,Regulars
13158,501,11,1852.28,1,3,4,8,Regulars
13159,784,8,703.31,1,2,1,4,Hibernating
13160,88,15,1390.8,4,5,3,12,Loyal
13161,457,10,3064.91,2,3,5,10,Regulars
13162,110,21,3650.09,4,5,5,14,Champions
13163,510,8,1213.74,1,2,2,5,Hibernating
13164,85,12,4165.070000000001,4,4,5,13,Champions
13165,284,7,2664.86,2,1,5,8,Regulars
13166,57,7,834.6700000000001,5,1,1,7,Regulars
13167,588,12,1538.82,1,4,3,8,At Risk
13168,30,7,421.92999999999995,5,1,1,7,Regulars
13169,209,8,1287.9099999999999,3,2,3,8,Regulars
13170,208,6,1350.3300000000002,3,1,3,7,Regulars
13171,1511,6,965.21,1,1,2,4,Hibernating
13172,530,12,919.6,1,4,2,7,At Risk
13173,937,4,352.79,1,1,1,3,Hibernating
13174,15,15,2304.09,5,5,4,14,Champions
13175,551,7,1512.9499999999998,1,1,3,5,Regulars
13176,767,9,963.8499999999999,1,2,2,5,Hibernating
13177,183,10,1091.9,3,3,2,8,Regulars
13178,6,14,4257.81,5,5,5,15,Champions
13179,426,19,2805.63,2,5,5,12,At Risk
13180,108,5,821.36,4,1,1,6,Regulars
13181,237,7,907.9099999999999,3,1,2,6,Regulars
13182,403,13,1503.63,2,4,3,9,At Risk
13183,101,11,3945.0800000000004,4,3,5,12,Loyal
13184,91,7,718.16,4,1,1,6,Regulars
13185,466,10,650.11,1,3,1,5,Regulars
13186,47,15,2247.08,5,5,4,14,Champions
13187,486,4,151.08,1,1,1,3,Hibernating
13188,75,6,344.64,4,1,1,6,Regulars
13189,99,13,3644.3700000000003,4,4,5,13,Champions
13190,418,9,1242.67,2,2,3,7,Regulars
13191,476,7,1514.44,1,1,3,5,Regulars
13192,803,5,364.6,1,1,1,3,Hibernating
13193,349,16,2412.7,2,5,4,11,At Risk
13194,149,5,873.42,3,1,2,6,Regulars
13195,277,8,699.23,2,2,1,5,Hibernating
13196,334,10,1417.0900000000001,2,3,3,8,Regulars
13197,127,6,764.32,4,1,1,6,Regulars
13198,884,6,786.51,1,1,1,3,Hibernating
13199,460,14,2129.69,1,5,4,10,At Risk
13200,684,14,2243.45,1,5,4,10,At Risk
13201,10,9,1015.9,5,2,2,9,Regulars
13202,924,6,523.19,1,1,1,3,Hibernating
13203,589,12,1386.04,1,4,3,8,At Risk
13204,47,6,2289.79,5,1,4,10,Big Spenders
13205,318,7,1115.6599999999999,2,1,2,5,Hibernating
13206,2,12,2476.87,5,4,4,13,Champions
13207,610,2,217.8,1,1,1,3,Hibernating
13208,420,11,1671.79,2,3,3,8,Regulars
13209,71,12,1587.35,4,4,3,11,Loyal
13210,180,14,1539.92,3,5,3,11,Regulars
13211,121,8,1268.79,4,2,3,9,Regulars
13212,885,8,852.01,1,2,2,5,Hibernating
13213,67,14,1073.68,4,5,2,11,Loyal
13214,367,12,2379.74,2,4,4,10,At Risk
13215,40,9,2979.9,5,2,5,12,Big Spenders
13216,46,10,493.06,5,3,1,9,Loyal
13217,242,12,900.94,3,4,2,9,Regulars
13218,19,8,997.73,5,2,2,9,Regulars
13219,259,6,1008.24,2,1,2,5,Hibernating
13220,73,8,1139.6,4,2,2,8,Regulars
13221,221,7,1104.14,3,1,2,6,Regulars
13222,38,6,513.5600000000001,5,1,1,7,Regulars
13223,491,5,634.33,1,1,1,3,Hibernating
13224,427,10,1538.28,2,3,3,8,Regulars
13225,510,11,1192.39,1,3,2,6,Regulars
13226,94,9,1828.7999999999997,4,2,4,10,Big Spenders
13227,58,14,1545.6100000000001,5,5,3,13,Loyal
13228,109,13,4036.21,4,4,5,13,Champions
13229,356,6,2256.78,2,1,4,7,Regulars
13230,250,11,1370.92,2,3,3,8,Regulars
13231,22,12,1784.9,5,4,4,13,Champions
13232,523,17,4651.83,1,5,5,11,At Risk
13233,56,16,1783.45,5,5,4,14,Champions
13234,182,10,1241.9,3,3,3,9,Regulars
13235,9,9,1097.74,5,2,2,9,Regulars
13236,94,13,1281.1100000000001,4,4,3,11,Loyal
13237,185,9,784.46,3,2,1,6,Regulars
13238,160,16,2871.94,3,5,5,13,Big Spenders
13239,488,7,601.71,1,1,1,3,Hibernating
13240,99,10,1137.6499999999999,4,3,2,9,Loyal
13241,474,9,924.02,1,2,2,5,Hibernating
13242,130,15,2055.92,4,5,4,13,Champions
13243,34,11,1807.2,5,3,4,12,Loyal
13244,37,12,1671.43,5,4,3,12,Loyal
13245,107,8,1249.18,4,2,3,9,Regulars
13246,95,15,2347.09,4,5,4,13,Champions
13247,67,13,2154.66,4,4,4,12,Champions
13248,157,5,981.26,3,1,2,6,Regulars
13249,689,13,1362.79,1,4,3,8,At Risk
13250,187,11,2513.06,3,3,4,10,Big Spenders
13251,45,10,1467.69,5,3,3,11,Loyal
13252,78,8,569.13,4,2,1,7,Regulars
13253,210,10,839.1199999999999,3,3,1,7,Regulars
13254,78,16,3051.6099999999997,4,5,5,14,Champions
13255,227,6,3873.8999999999996,3,1,5,9,Big Spenders
13256,110,8,1859.17,4,2,4,10,Big Spenders
13257,268,10,734.8,2,3,1,6,Regulars
13258,97,11,1179.3300000000002,4,3,2,9,Loyal
13259,159,12,1028.89,3,4,2,9,Regulars
13260,107,9,941.52,4,2,2,8,Regulars
13261,317,13,2271.36,2,4,4,10,At Risk
13262,739,10,1338.72,1,3,3,7,Regulars
13263,62,6,1860.92,5,1,4,10,Big Spenders
13264,564,16,1432.98,1,5,3,9,At Risk
13265,60,12,1119.26,5,4,2,11,Loyal
13266,473,9,1896.9299999999998,1,2,4,7,Regulars
13267,345,14,911.2,2,5,2,9,At Risk
13268,91,11,1136.58,4,3,2,9,Loyal
13269,931,6,583.21,1,1,1,3,Hibernating
13270,118,7,1083.8200000000002,4,1,2,7,Regulars
13271,9,12,3829.3799999999997,5,4,5,14,Champions
13272,248,15,1496.89,2,5,3,10,At Risk
13273,245,11,2065.45,3,3,4,10,Big Spenders
13274,57,15,2178.17,5,5,4,14,Champions
13275,0,19,2985.5299999999997,5,5,5,15,Champions
13276,113,12,2195.44,4,4,4,12,Champions
13277,625,9,1920.54,1,2,4,7,Regulars
13278,263,9,1450.74,2,2,3,7,Regulars
13279,272,7,420.4,2,1,1,4,Hibernating
13280,222,11,3078.42,3,3,5,11,Big Spenders
13281,52,9,1480.8500000000001,5,2,3,10,Regulars
13282,256,12,840.4100000000001,2,4,1,7,At Risk
13283,669,8,3910.729999999999,1,2,5,8,Regulars
13284,122,9,826.72,4,2,1,7,Regulars
13285,357,14,1375.56,2,5,3,10,At Risk
13286,138,9,2613.22,4,2,5,11,Big Spenders
13287,1202,9,1213.66,1,2,2,5,Hibernating
13288,571,9,2230.08,1,2,4,7,Regulars
13289,218,9,1505.25,3,2,3,8,Regulars
13290,98,7,425.3,4,1,1,6,Regulars
13291,90,17,2381.69,4,5,4,13,Champions
13292,216,9,1243.85,3,2,3,8,Regulars
13293,184,11,1521.15,3,3,3,9,Regulars
13294,693,7,1419.91,1,1,3,5,Regulars
13295,139,12,1821.67,4,4,4,12,Champions
13296,192,7,506.35,3,1,1,5,Regulars
13297,139,10,1204.46,4,3,2,9,Loyal
13298,14,14,2956.26,5,5,5,15,Champions
13299,180,12,1375.37,3,4,3,10,Regulars
13300,219,11,1094.41,3,3,2,8,Regulars
13301,363,10,1823.1799999999998,2,3,4,9,Regulars
13302,76,17,2664.92,4,5,5,14,Champions
13303,362,6,831.99,2,1,1,4,Hibernating
13304,178,12,4688.26,3,4,5,12,Big Spenders
13305,177,9,1884.27,3,2,4,9,Big Spenders
13306,425,11,2556.63,2,3,4,9,Regulars
13307,206,10,2219.03,3,3,4,10,Big Spenders
13308,249,8,724.26,2,2,1,5,Hibernating
13309,149,8,763.67,3,2,1,6,Regulars
13310,54,6,690.86,5,1,1,7,Regulars
13311,485,10,2974.13,1,3,5,9,Regulars
13312,31,14,2299.08,5,5,4,14,Champions
13313,288,6,360.35,2,1,1,4,Hibernating
13314,68,15,1608.6399999999999,4,5,3,12,Loyal
13315,125,11,1367.2,4,3,3,10,Loyal
13316,146,13,3130.95,4,4,5,13,Champions
13317,243,12,1026.15,3,4,2,9,Regulars
13318,3,15,1765.62,5,5,4,14,Champions
13319,35,11,990.01,5,3,2,10,Loyal
13320,212,10,1039.54,3,3,2,8,Regulars
13321,203,4,1842.75,3,1,4,8,Big Spenders
13322,463,10,958.3699999999999,1,3,2,6,Regulars
13323,115,8,466.90999999999997,4,2,1,7,Regulars
13324,154,10,1392.83,3,3,3,9,Regulars
13325,313,11,3076.9,2,3,5,10,Regulars
13326,247,10,657.6800000000001,3,3,1,7,Regulars
13327,251,13,1428.5,2,4,3,9,At Risk
13328,191,12,3859.37,3,4,5,12,Big Spenders
13329,233,6,247.01,3,1,1,5,Regulars
13330,230,13,3277.6,3,4,5,12,Big Spenders
13331,235,10,1296.85,3,3,3,9,Regulars
13332,242,10,1388.8600000000001,3,3,3,9,Regulars
13333,147,7,800.36,4,1,1,6,Regulars
13334,159,12,2028.5900000000001,3,4,4,11,Big Spenders
13335,503,11,731.41,1,3,1,5,Regulars
13336,188,9,892.75,3,2,2,7,Regulars
13337,11,14,1799.1399999999999,5,5,4,14,Champions
13338,196,11,1175.8,3,3,2,8,Regulars
13339,77,15,4970.58,4,5,5,14,Champions
13340,361,9,1543.27,2,2,3,7,Regulars
13341,162,6,919.6700000000001,3,1,2,6,Regulars
13342,520,11,609.95,1,3,1,5,Regulars
13343,498,13,4373.0,1,4,5,10,At Risk
13344,84,11,2282.25,4,3,4,11,Loyal
13345,139,12,961.5500000000001,4,4,2,10,Loyal
13346,195,16,2921.6699999999996,3,5,5,13,Big Spenders
13347,14,10,966.8399999999999,5,3,2,10,Loyal
13348,307,9,1894.0700000000002,2,2,4,8,Regulars
13349,226,10,1140.54,3,3,2,8,Regulars
13350,58,11,2079.4700000000003,5,3,4,12,Loyal
13351,99,11,899.47,4,3,2,9,Loyal
13352,722,8,1265.69,1,2,3,6,Regulars
13353,387,11,2342.17,2,3,4,9,Regulars
13354,19,7,962.78,5,1,2,8,Regulars
13355,680,8,3254.02,1,2,5,8,Regulars
13356,68,11,2298.06,4,3,4,11,Loyal
13357,197,9,2106.19,3,2,4,9,Big Spenders
13358,177,11,872.98,3,3,2,8,Regulars
13359,208,17,2419.2400000000002,3,5,4,12,Big Spenders
13360,180,10,619.59,3,3,1,7,Regulars
13361,51,9,1184.26,5,2,2,9,Regulars
13362,998,5,1322.57,1,1,3,5,Regulars
13363,208,8,1252.97,3,2,3,8,Regulars
13364,1267,7,761.75,1,1,1,3,Hibernating
13365,186,7,540.84,3,1,1,5,Regulars
13366,67,7,791.3,4,1,1,6,Regulars
13367,5,20,5281.43,5,5,5,15,Champions
13368,159,10,677.13,3,3,1,7,Regulars
13369,203,19,3588.69,3,5,5,13,Big Spenders
13370,65,10,946.96,5,3,2,10,Loyal
13371,244,8,1359.69,3,2,3,8,Regulars
13372,46,13,3205.0299999999997,5,4,5,14,Champions
13373,236,13,5009.3099999999995,3,4,5,12,Big Spenders
13374,129,11,1816.33,4,3,4,11,Loyal
13375,377,10,2904.2,2,3,5,10,Regulars
13376,1624,6,547.72,1,1,1,3,Hibernating
13377,85,12,1205.87,4,4,2,10,Loyal
13378,247,12,2458.48,3,4,4,11,Big Spenders
13379,311,6,890.66,2,1,2,5,Hibernating
13380,103,7,652.89,4,1,1,6,Regulars
13381,251,14,1707.08,2,5,3,10,At Risk
13382,61,11,1364.8,5,3,3,11,Loyal
13383,653,14,1548.11,1,5,3,9,At Risk
13384,19,9,2135.83,5,2,4,11,Big Spenders
13385,19,16,6955.900000000001,5,5,5,15,Champions
13386,305,9,2615.75,2,2,5,9,Regulars
13387,49,12,1000.87,5,4,2,11,Loyal
13388,243,11,1226.38,3,3,2,8,Regulars
13389,16,15,1395.53,5,5,3,13,Loyal
13390,467,5,2074.65,1,1,4,6,Regulars
13391,507,13,1882.1499999999999,1,4,4,9,At Risk
13392,128,8,1271.72,4,2,3,9,Regulars
13393,132,17,3544.45,4,5,5,14,Champions
13394,22,8,2972.6400000000003,5,2,5,12,Big Spenders
13395,116,10,1027.26,4,3,2,9,Loyal
13396,656,11,6278.16,1,3,5,9,Regulars
13397,57,8,1625.16,5,2,3,10,Regulars
13398,302,12,1323.77,2,4,3,9,At Risk
13399,116,14,1650.7,4,5,3,12,Loyal
13400,48,6,794.25,5,1,1,7,Regulars
13401,281,10,3651.34,2,3,5,10,Regulars
13402,21,13,4634.3099999999995,5,4,5,14,Champions
13403,93,4,1435.25,4,1,3,8,Regulars
13404,888,13,3930.0199999999995,1,4,5,10,At Risk
13405,341,13,1669.49,2,4,3,9,At Risk
13406,649,16,3073.29,1,5,5,11,At Risk
13407,352,11,2348.6200000000003,2,3,4,9,Regulars
13408,104,14,2953.59,4,5,5,14,Champions
13409,22,10,952.04,5,3,2,10,Loyal
13410,860,3,312.83,1,1,1,3,Hibernating
13411,41,13,2974.41,5,4,5,14,Champions
13412,196,11,941.9,3,3,2,8,Regulars
13413,20,15,1170.38,5,5,2,12,Loyal
13414,9,11,2222.6699999999996,5,3,4,12,Loyal
13415,109,10,2587.78,4,3,5,12,Loyal
13416,638,7,2764.67,1,1,5,7,Regulars
13417,302,11,1787.46,2,3,4,9,Regulars
13418,420,11,970.48,2,3,2,7,Regulars
13419,310,11,1848.8700000000001,2,3,4,9,Regulars
13420,390,7,542.8599999999999,2,1,1,4,Hibernating
13421,397,11,877.9000000000001,2,3,2,7,Regulars
13422,194,13,1184.22,3,4,2,9,Regulars
13423,488,14,4958.87,1,5,5,11,At Risk
13424,206,11,2697.0499999999997,3,3,5,11,Big Spenders
13425,313,12,1823.8999999999999,2,4,4,10,At Risk
13426,620,11,1911.58,1,3,4,8,Regulars
13427,571,5,1036.62,1,1,2,4,Hibernating
13428,2,11,2413.2000000000003,5,3,4,12,Loyal
13429,315,10,2383.13,2,3,4,9,Regulars
13430,552,7,1223.1399999999999,1,1,2,4,Hibernating
13431,480,15,1811.49,1,5,4,10,At Risk
13432,150,14,2649.86,3,5,5,13,Big Spenders
13433,139,8,985.06,4,2,2,8,Regulars
13434,118,18,2050.41,4,5,4,13,Champions
13435,749,9,1183.79,1,2,2,5,Hibernating
13436,234,10,2310.1600000000003,3,3,4,10,Big Spenders
13437,504,8,1398.03,1,2,3,6,Regulars
13438,25,7,1624.73,5,1,3,9,Regulars
13439,182,11,1812.1200000000001,3,3,4,10,Big Spenders
13440,191,6,778.09,3,1,1,5,Regulars
13441,375,12,1502.8899999999999,2,4,3,9,At Risk
13442,211,7,690.7,3,1,1,5,Regulars
13443,267,13,2517.8,2,4,4,10,At Risk
13444,608,7,2480.04,1,1,4,6,Regulars
13445,124,8,3162.4999999999995,4,2,5,11,Big Spenders
13446,128,13,1377.49,4,4,3,11,Loyal
13447,560,13,1932.39,1,4,4,9,At Risk
13448,656,8,665.21,1,2,1,4,Hibernating
13449,342,10,2029.8600000000001,2,3,4,9,Regulars
13450,159,20,2160.8,3,5,4,12,Big Spenders
13451,79,11,2595.21,4,3,5,12,Loyal
13452,473,10,2012.43,1,3,4,8,Regulars
13453,61,8,982.28,5,2,2,9,Regulars
13454,349,7,1266.1000000000001,2,1,3,6,Regulars
13455,330,6,674.9200000000001,2,1,1,4,Hibernating
13456,780,10,715.49,1,3,1,5,Regulars
13457,241,16,2978.3100000000004,3,5,5,13,Big Spenders
13458,21,11,2910.48,5,3,5,13,Loyal
13459,278,10,1081.44,2,3,2,7,Regulars
13460,18,7,586.26,5,1,1,7,Regulars
13461,272,14,2595.41,2,5,5,12,At Risk
13462,133,8,628.05,4,2,1,7,Regulars
13463,451,5,667.35,2,1,1,4,Hibernating
13464,22,11,2700.02,5,3,5,13,Loyal
13465,208,9,1392.95,3,2,3,8,Regulars
13466,65,7,539.8199999999999,5,1,1,7,Regulars
13467,658,9,755.29,1,2,1,4,Hibernating
13468,450,9,1451.29,2,2,3,7,Regulars
13469,249,11,3715.58,2,3,5,10,Regulars
13470,58,13,3612.86,5,4,5,14,Champions
13471,319,15,2437.41,2,5,4,11,At Risk
13472,150,10,855.6700000000001,3,3,2,8,Regulars
13473,198,11,4342.49,3,3,5,11,Big Spenders
13474,60,8,2905.3599999999997,5,2,5,12,Big Spenders
13475,1314,5,877.7900000000001,1,1,2,4,Hibernating
13476,62,9,2956.38,5,2,5,12,Big Spenders
13477,19,12,1868.03,5,4,4,13,Champions
13478,577,10,1237.3700000000001,1,3,2,6,Regulars
13479,157,13,2735.7699999999995,3,4,5,12,Big Spenders
13480,880,6,361.82000000000005,1,1,1,3,Hibernating
13481,103,12,1750.26,4,4,4,12,Champions
13482,18,9,892.9300000000001,5,2,2,9,Regulars
13483,156,13,1386.81,3,4,3,10,Regulars
13484,178,15,1720.28,3,5,3,11,Regulars
13485,374,4,1250.6100000000001,2,1,3,6,Regulars
13486,221,7,2331.8900000000003,3,1,4,8,Big Spenders
13487,65,10,1753.46,5,3,4,12,Loyal
13488,382,12,1432.2,2,4,3,9,At Risk
13489,23,13,2605.7,5,4,5,14,Champions
13490,1091,5,881.37,1,1,2,4,Hibernating
13491,313,11,1450.56,2,3,3,8,Regulars
13492,248,18,2646.16,2,5,5,12,At Risk
13493,552,7,511.61,1,1,1,3,Hibernating
13494,241,14,2440.62,3,5,4,12,Big Spenders
13495,220,8,1064.12,3,2,2,7,Regulars
13496,202,7,583.65,3,1,1,5,Regulars
13497,71,8,1006.8,4,2,2,8,Regulars
13498,12,11,1804.21,5,3,4,12,Loyal
13499,116,9,679.39,4,2,1,7,Regulars
13500,84,21,5092.79,4,5,5,14,Champions
13501,34,7,894.79,5,1,2,8,Regulars
13502,554,7,822.08,1,1,1,3,Hibernating
13503,71,10,4362.86,4,3,5,12,Loyal
13504,49,11,1658.72,5,3,3,11,Loyal
13505,161,12,2771.74,3,4,5,12,Big Spenders
13506,74,13,2235.26,4,4,4,12,Champions
13507,46,10,1884.39,5,3,4,12,Loyal
13508,38,6,833.5500000000001,5,1,1,7,Regulars
13509,311,8,933.64,2,2,2,6,Hibernating
13510,65,10,533.26,5,3,1,9,Loyal
13511,462,9,1894.37,1,2,4,7,Regulars
13512,534,8,1744.41,1,2,4,7,Regulars
13513,77,10,1294.15,4,3,3,10,Loyal
13514,330,5,246.17,2,1,1,4,Hibernating
13515,246,9,3488.79,3,2,5,10,Big Spenders
13516,3,9,901.78,5,2,2,9,Regulars
13517,261,10,1402.44,2,3,3,8,Regulars
13518,613,10,1136.1000000000001,1,3,2,6,Regulars
13519,136,13,1008.27,4,4,2,10,Loyal
13520,821,10,1408.0900000000001,1,3,3,7,Regulars
13521,182,10,697.98,3,3,1,7,Regulars
13522,148,15,1927.7,3,5,4,12,Big Spenders
13523,390,18,2587.85,2,5,5,12,At Risk
13524,283,9,1522.1100000000001,2,2,3,7,Regulars
13525,124,16,2083.11,4,5,4,13,Champions
13526,55,9,1534.31,5,2,3,10,Regulars
13527,123,7,2526.0,4,1,4,9,Big Spenders
13528,319,12,1269.3899999999999,2,4,3,9,At Risk
13529,118,9,604.89,4,2,1,7,Regulars
13530,297,10,797.62,2,3,1,6,Regulars
13531,87,7,4150.360000000001,4,1,5,10,Big Spenders
13532,59,6,671.39,5,1,1,7,Regulars
13533,684,11,2550.4900000000002,1,3,4,8,Regulars
13534,592,6,2415.35,1,1,4,6,Regulars
13535,15,7,2148.78,5,1,4,10,Big Spenders
13536,47,15,3254.71,5,5,5,15,Champions
13537,130,21,6281.370000000001,4,5,5,14,Champions
13538,108,8,656.9300000000001,4,2,1,7,Regulars
13539,1273,11,2583.05,1,3,5,9,Regulars
13540,123,15,3033.36,4,5,5,14,Champions
13541,187,16,3411.5899999999997,3,5,5,13,Big Spenders
13542,158,11,964.83,3,3,2,8,Regulars
13543,300,12,3371.5099999999998,2,4,5,11,At Risk
13544,448,8,1463.6100000000001,2,2,3,7,Regulars
13545,41,9,1360.24,5,2,3,10,Regulars
13546,54,12,1099.17,5,4,2,11,Loyal
13547,251,7,1058.04,2,1,2,5,Hibernating
13548,139,15,3155.27,4,5,5,14,Champions
13549,486,11,4077.9899999999993,1,3,5,9,Regulars
13550,390,8,952.1700000000001,2,2,2,6,Hibernating
13551,279,14,3153.17,2,5,5,12,At Risk
13552,667,7,2357.26,1,1,4,6,Regulars
13553,5,13,2181.89,5,4,4,13,Champions
13554,145,14,1211.58,4,5,2,11,Loyal
13555,629,8,866.42,1,2,2,5,Hibernating
13556,609,13,1945.37,1,4,4,9,At Risk
13557,18,5,1021.2100000000002,5,1,2,8,Regulars
13558,237,13,2944.4700000000003,3,4,5,12,Big Spenders
13559,96,12,742.15,4,4,1,9,Loyal
13560,196,12,943.01,3,4,2,9,Regulars
13561,45,9,983.8,5,2,2,9,Regulars
13562,232,10,1292.9,3,3,3,9,Regulars
13563,365,5,1238.1599999999999,2,1,2,5,Hibernating
13564,292,13,1560.74,2,4,3,9,At Risk
13565,567,8,978.0699999999999,1,2,2,5,Hibernating
13566,561,11,711.29,1,3,1,5,Regulars
13567,85,7,550.02,4,1,1,6,Regulars
13568,268,9,2100.96,2,2,4,8,Regulars
13569,156,8,624.8,3,2,1,6,Regulars
13570,591,8,2273.9700000000003,1,2,4,7,Regulars
13571,96,12,3392.32,4,4,5,13,Champions
13572,298,10,2747.9500000000003,2,3,5,10,Regulars
13573,388,3,1747.68,2,1,4,7,Regulars
13574,239,10,1406.1599999999999,3,3,3,9,Regulars
13575,255,7,676.66,2,1,1,4,Hibernating
13576,92,10,829.9200000000001,4,3,1,8,Loyal
13577,201,7,993.1700000000001,3,1,2,6,Regulars
13578,31,11,1237.14,5,3,2,10,Loyal
13579,119,10,1268.77,4,3,3,10,Loyal
13580,124,4,298.16,4,1,1,6,Regulars
13581,588,7,724.89,1,1,1,3,Hibernating
13582,253,13,4276.5,2,4,5,11,At Risk
13583,504,8,546.44,1,2,1,4,Hibernating
13584,112,9,996.0,4,2,2,8,Regulars
13585,188,8,1589.9,3,2,3,8,Regulars
13586,125,10,913.4,4,3,2,9,Loyal
13587,261,10,2071.57,2,3,4,9,Regulars
13588,208,10,1130.54,3,3,2,8,Regulars
13589,155,6,495.53,3,1,1,5,Regulars
13590,289,7,290.64,2,1,1,4,Hibernating
13591,49,12,1924.63,5,4,4,13,Champions
13592,581,5,1249.2800000000002,1,1,3,5,Regulars
13593,318,7,919.91,2,1,2,5,Hibernating
13594,1229,6,501.43,1,1,1,3,Hibernating
13595,45,19,1959.1599999999999,5,5,4,14,Champions
13596,420,9,834.19,2,2,1,5,Hibernating
13597,341,10,911.8499999999999,2,3,2,7,Regulars
13598,99,8,515.42,4,2,1,7,Regulars
13599,295,7,1227.9099999999999,2,1,2,5,Hibernating
13600,923,13,2613.71,1,4,5,10,At Risk
13601,237,7,851.5699999999999,3,1,2,6,Regulars
13602,546,17,1922.44,1,5,4,10,At Risk
13603,95,7,504.74,4,1,1,6,Regulars
13604,211,5,680.15,3,1,1,5,Regulars
13605,40,17,2207.78,5,5,4,14,Champions
13606,137,8,933.47,4,2,2,8,Regulars
13607,453,8,1029.49,2,2,2,6,Hibernating
13608,432,9,3355.92,2,2,5,9,Regulars
13609,43,11,1724.19,5,3,3,11,Loyal
13610,66,13,2805.3099999999995,4,4,5,13,Champions
13611,340,6,2799.3199999999997,2,1,5,8,Regulars
13612,729,4,1861.35,1,1,4,6,Regulars
13613,167,9,1041.8899999999999,3,2,2,7,Regulars
13614,132,15,3282.88,4,5,5,14,Champions
13615,378,11,634.82,2,3,1,6,Regulars
13616,220,15,2354.63,3,5,4,12,Big Spenders
13617,475,9,1020.08,1,2,2,5,Hibernating
13618,385,17,3545.12,2,5,5,12,At Risk
13619,536,12,2803.9,1,4,5,10,At Risk
13620,1060,10,965.99,1,3,2,6,Regulars
13621,216,10,664.05,3,3,1,7,Regulars
13622,385,7,898.3199999999999,2,1,2,5,Hibernating
13623,340,14,2843.37,2,5,5,12,At Risk
13624,273,8,639.64,2,2,1,5,Hibernating
13625,85,10,3397.77,4,3,5,12,Loyal
13626,4,10,1633.63,5,3,3,11,Loyal
13627,361,9,1741.33,2,2,4,8,Regulars
13628,98,13,1162.52,4,4,2,10,Loyal
13629,678,7,1922.24,1,1,4,6,Regulars
13630,185,14,1204.72,3,5,2,10,Regulars
13631,253,10,2212.89,2,3,4,9,Regulars
13632,488,10,1125.7,1,3,2,6,Regulars
13633,93,8,3538.96,4,2,5,11,Big Spenders
13634,126,12,3227.8199999999997,4,4,5,13,Champions
13635,971,11,1164.05,1,3,2,6,Regulars
13636,188,6,504.24,3,1,1,5,Regulars
13637,492,6,777.57,1,1,1,3,Hibernating
13638,51,6,452.31,5,1,1,7,Regulars
13639,48,16,2375.93,5,5,4,14,Champions
13640,189,11,1393.21,3,3,3,9,Regulars
13641,549,10,910.8,1,3,2,6,Regulars
13642,61,17,3804.62,5,5,5,15,Champions
13643,69,13,936.3299999999999,4,4,2,10,Loyal
13644,127,10,921.0699999999999,4,3,2,9,Loyal
13645,44,13,2198.69,5,4,4,13,Champions
13646,125,9,4402.18,4,2,5,11,Big Spenders
13647,166,12,2127.63,3,4,4,11,Big Spenders
13648,175,14,1834.06,3,5,4,12,Big Spenders
13649,326,7,907.91,2,1,2,5,Hibernating
13650,536,10,2137.56,1,3,4,8,Regulars
13651,33,13,1755.17,5,4,4,13,Champions
13652,383,13,2526.33,2,4,4,10,At Risk
13653,1078,7,848.9,1,1,2,4,Hibernating
13654,61,14,2282.85,5,5,4,14,Champions
13655,54,10,1483.84,5,3,3,11,Loyal
13656,46,12,1572.8899999999999,5,4,3,12,Loyal
13657,574,12,3646.81,1,4,5,10,At Risk
13658,210,9,1018.66,3,2,2,7,Regulars
13659,0,11,883.52,5,3,2,10,Loyal
13660,54,12,4161.64,5,4,5,14,Champions
13661,134,10,3291.2699999999995,4,3,5,12,Loyal
13662,30,8,643.58,5,2,1,8,Regulars
13663,36,13,2307.72,5,4,4,13,Champions
13664,271,22,4735.38,2,5,5,12,At Risk
13665,1477,6,1203.51,1,1,2,4,Hibernating
13666,324,9,1197.04,2,2,2,6,Hibernating
13667,277,5,474.09000000000003,2,1,1,4,Hibernating
13668,401,12,2030.53,2,4,4,10,At Risk
13669,270,13,1342.28,2,4,3,9,At Risk
13670,396,10,1093.61,2,3,2,7,Regulars
13671,621,8,1444.56,1,2,3,6,Regulars
13672,286,3,245.33,2,1,1,4,Hibernating
13673,747,7,2393.95,1,1,4,6,Regulars
13674,391,9,1858.0300000000002,2,2,4,8,Regulars
13675,303,14,2237.54,2,5,4,11,At Risk
13676,602,7,1187.67,1,1,2,4,Hibernating
13677,46,11,2466.81,5,3,4,12,Loyal
13678,169,14,4498.71,3,5,5,13,Big Spenders
13679,19,9,792.32,5,2,1,8,Regulars
13680,236,6,432.03,3,1,1,5,Regulars
13681,264,9,2948.3,2,2,5,9,Regulars
13682,181,12,1670.94,3,4,3,10,Regulars
13683,383,9,670.55,2,2,1,5,Hibernating
13684,430,11,1090.26,2,3,2,7,Regulars
13685,183,14,2043.74,3,5,4,12,Big Spenders
13686,591,11,718.54,1,3,1,5,Regulars
13687,91,15,1328.9,4,5,3,12,Loyal
13688,252,9,1251.55,2,2,3,7,Regulars
13689,293,6,1299.55,2,1,3,6,Regulars
13690,134,12,1642.62,4,4,3,11,Loyal
13691,25,7,1303.88,5,1,3,9,Regulars
13692,620,8,995.68,1,2,2,5,Hibernating
13693,129,13,1362.3400000000001,4,4,3,11,Loyal
13694,299,5,382.93,2,1,1,4,Hibernating
13695,125,11,2795.91,4,3,5,12,Loyal
13696,338,10,1233.4,2,3,2,7,Regulars
13697,101,14,1668.13,4,5,3,12,Loyal
13698,112,7,2032.4900000000002,4,1,4,9,Big Spenders
13699,57,9,2832.4100000000003,5,2,5,12,Big Spenders
13700,208,10,706.03,3,3,1,7,Regulars
13701,569,10,1790.8300000000002,1,3,4,8,Regulars
13702,1177,6,859.3900000000001,1,1,2,4,Hibernating
13703,463,11,3348.45,1,3,5,9,Regulars
13704,169,8,1087.54,3,2,2,7,Regulars
13705,53,16,1857.67,5,5,4,14,Champions
13706,538,4,387.79,1,1,1,3,Hibernating
13707,121,10,1211.72,4,3,2,9,Loyal
13708,314,10,2496.62,2,3,4,9,Regulars
13709,1015,7,684.1600000000001,1,1,1,3,Hibernating
13710,79,9,911.1100000000001,4,2,2,8,Regulars
13711,38,14,2766.67,5,5,5,15,Champions
13712,537,6,2030.8000000000002,1,1,4,6,Regulars
13713,257,4,798.23,2,1,1,4,Hibernating
13714,203,13,1994.6699999999998,3,4,4,11,Big Spenders
13715,169,10,2058.1,3,3,4,10,Big Spenders
13716,204,21,4109.33,3,5,5,13,Big Spenders
13717,215,9,916.31,3,2,2,7,Regulars
13718,13,12,2046.96,5,4,4,13,Champions
13719,107,11,1213.16,4,3,2,9,Loyal
13720,135,8,972.07,4,2,2,8,Regulars
13721,281,10,2958.95,2,3,5,10,Regulars
13722,562,11,2835.12,1,3,5,9,Regulars
13723,437,11,2454.76,2,3,4,9,Regulars
13724,231,16,1928.08,3,5,4,12,Big Spenders
13725,13,11,3917.7500000000005,5,3,5,13,Loyal
13726,36,10,1437.15,5,3,3,11,Loyal
13727,102,14,2079.21,4,5,4,13,Champions
13728,17,12,1208.6200000000001,5,4,2,11,Loyal
13729,399,10,1893.6499999999996,2,3,4,9,Regulars
13730,400,13,1175.8,2,4,2,8,At Risk
13731,270,11,1815.29,2,3,4,9,Regulars
13732,284,10,1692.4,2,3,3,8,Regulars
13733,252,10,945.56,2,3,2,7,Regulars
13734,8,6,885.11,5,1,2,8,Regulars
13735,298,14,1623.57,2,5,3,10,At Risk
13736,372,5,1376.9399999999998,2,1,3,6,Regulars
13737,164,7,1293.0399999999997,3,1,3,7,Regulars
13738,623,11,1711.97,1,3,3,7,Regulars
13739,147,11,1526.3899999999999,4,3,3,10,Loyal
13740,76,13,998.54,4,4,2,10,Loyal
13741,526,9,1524.24,1,2,3,6,Regulars
13742,236,10,897.12,3,3,2,8,Regulars
13743,109,18,1936.81,4,5,4,13,Champions
13744,149,21,2637.85,3,5,5,13,Big Spenders
13745,446,9,3000.28,2,2,5,9,Regulars
13746,35,15,1576.1200000000001,5,5,3,13,Loyal
13747,327,11,1966.57,2,3,4,9,Regulars
13748,383,4,2148.2799999999997,2,1,4,7,Regulars
13749,98,14,2796.37,4,5,5,14,Champions
13750,55,10,898.52,5,3,2,10,Loyal
13751,310,8,1695.8799999999999,2,2,3,7,Regulars
13752,117,11,1475.85,4,3,3,10,Loyal
13753,85,8,549.09,4,2,1,7,Regulars
13754,31,15,2379.96,5,5,4,14,Champions
13755,15,11,1320.0500000000002,5,3,3,11,Loyal
13756,354,9,1742.5,2,2,4,8,Regulars
13757,1081,5,660.58,1,1,1,3,Hibernating
13758,240,7,723.57,3,1,1,5,Regulars
13759,48,13,1113.04,5,4,2,11,Loyal
13760,141,6,588.32,4,1,1,6,Regulars
13761,78,13,1746.01,4,4,4,12,Champions
13762,479,8,945.35,1,2,2,5,Hibernating
13763,498,9,3519.9,1,2,5,8,Regulars
13764,1254,9,1077.49,1,2,2,5,Hibernating
13765,18,11,2535.9,5,3,4,12,Loyal
13766,19,14,2420.64,5,5,4,14,Champions
13767,69,17,2723.02,4,5,5,14,Champions
13768,255,12,1465.8799999999999,2,4,3,9,At Risk
13769,100,11,1970.15,4,3,4,11,Loyal
13770,54,10,3822.5299999999997,5,3,5,13,Loyal
13771,113,11,1619.69,4,3,3,10,Loyal
13772,211,11,2509.68,3,3,4,10,Big Spenders
13773,51,8,763.36,5,2,1,8,Regulars
13774,360,11,1698.4,2,3,3,8,Regulars
13775,541,8,1445.26,1,2,3,6,Regulars
13776,10,7,1038.71,5,1,2,8,Regulars
13777,436,10,1068.3,2,3,2,7,Regulars
13778,635,6,304.74,1,1,1,3,Hibernating
13779,400,11,2744.9700000000003,2,3,5,10,Regulars
13780,351,10,1461.31,2,3,3,8,Regulars
13781,137,16,2848.58,4,5,5,14,Champions
13782,387,15,2069.87,2,5,4,11,At Risk
13783,65,14,2113.6,5,5,4,14,Champions
13784,258,10,2171.71,2,3,4,9,Regulars
13785,817,7,1513.86,1,1,3,5,Regulars
13786,277,9,1264.6100000000001,2,2,3,7,Regulars
13787,162,7,800.53,3,1,1,5,Regulars
13788,135,12,1892.82,4,4,4,12,Champions
13789,725,10,2804.23,1,3,5,9,Regulars
13790,1289,8,1684.68,1,2,3,6,Regulars
13791,1254,8,1239.29,1,2,2,5,Hibernating
13792,50,10,943.64,5,3,2,10,Loyal
13793,272,11,1006.3399999999999,2,3,2,7,Regulars
13794,40,16,2268.45,5,5,4,14,Champions
13795,26,9,1146.8999999999999,5,2,2,9,Regulars
13796,90,5,1361.21,4,1,3,8,Regulars
13797,52,18,2776.9,5,5,5,15,Champions
13798,220,13,996.84,3,4,2,9,Regulars
13799,66,7,444.51,4,1,1,6,Regulars
13800,225,12,2042.8200000000002,3,4,4,11,Big Spenders
13801,161,10,845.86,3,3,2,8,Regulars
13802,84,8,654.23,4,2,1,7,Regulars
13803,251,5,282.56,2,1,1,4,Hibernating
13804,45,22,2371.34,5,5,4,14,Champions
13805,260,12,1808.87,2,4,4,10,At Risk
13806,259,10,2337.92,2,3,4,9,Regulars
13807,113,11,1173.84,4,3,2,9,Loyal
13808,291,14,2755.82,2,5,5,12,At Risk
13809,191,9,791.3,3,2,1,6,Regulars
13810,629,8,1375.68,1,2,3,6,Regulars
13811,165,8,346.73,3,2,1,6,Regulars
13812,498,11,1271.48,1,3,3,7,Regulars
13813,368,10,980.12,2,3,2,7,Regulars
13814,5,11,1310.42,5,3,3,11,Loyal
13815,156,8,499.53000000000003,3,2,1,6,Regulars
13816,638,10,3556.2799999999997,1,3,5,9,Regulars
13817,139,13,1219.61,4,4,2,10,Loyal
13818,144,12,1530.85,4,4,3,11,Loyal
13819,152,5,461.48,3,1,1,5,Regulars
13820,594,18,3029.6,1,5,5,11,At Risk
13821,522,7,1939.9799999999998,1,1,4,6,Regulars
13822,366,14,1810.96,2,5,4,11,At Risk
13823,757,4,202.18,1,1,1,3,Hibernating
13824,538,8,703.77,1,2,1,4,Hibernating
13825,395,9,578.26,2,2,1,5,Hibernating
13826,14,9,1615.45,5,2,3,10,Regulars
13827,337,14,3034.6099999999997,2,5,5,12,At Risk
13828,1735,6,2306.6,1,1,4,6,Regulars
13829,330,9,1121.64,2,2,2,6,Hibernating
13830,431,10,1599.31,2,3,3,8,Regulars
13831,910,8,565.72,1,2,1,4,Hibernating
13832,35,16,2266.91,5,5,4,14,Champions
13833,104,11,1987.34,4,3,4,11,Loyal
13834,8,14,3397.15,5,5,5,15,Champions
13835,28,9,2390.53,5,2,4,11,Big Spenders
13836,724,9,1764.25,1,2,4,7,Regulars
13837,286,8,1689.4,2,2,3,7,Regulars
13838,168,11,2915.58,3,3,5,11,Big Spenders
13839,257,11,3048.36,2,3,5,10,Regulars
13840,217,10,1301.05,3,3,3,9,Regulars
13841,122,8,1190.06,4,2,2,8,Regulars
13842,190,10,3975.0600000000004,3,3,5,11,Big Spenders
13843,375,14,3317.01,2,5,5,12,At Risk
13844,441,6,1021.29,2,1,2,5,Hibernating
13845,245,10,2445.35,3,3,4,10,Big Spenders
13846,287,10,831.33,2,3,1,6,Regulars
13847,162,13,1620.52,3,4,3,10,Regulars
13848,124,13,1625.51,4,4,3,11,Loyal
13849,404,12,3545.38,2,4,5,11,At Risk
13850,598,10,546.66,1,3,1,5,Regulars
13851,179,10,1057.43,3,3,2,8,Regulars
13852,286,10,969.98,2,3,2,7,Regulars
13853,83,15,3389.0099999999998,4,5,5,14,Champions
13854,269,13,2019.6200000000001,2,4,4,10,At Risk
13855,22,8,1123.1,5,2,2,9,Regulars
13856,161,5,257.46999999999997,3,1,1,5,Regulars
13857,276,14,1328.15,2,5,3,10,At Risk
13858,45,12,899.4,5,4,2,11,Loyal
13859,289,10,622.26,2,3,1,6,Regulars
13860,780,13,4604.38,1,4,5,10,At Risk
13861,244,13,1342.61,3,4,3,10,Regulars
13862,324,7,938.2299999999999,2,1,2,5,Hibernating
13863,126,9,1304.84,4,2,3,9,Regulars
13864,522,8,768.63,1,2,1,4,Hibernating
13865,248,7,633.74,2,1,1,4,Hibernating
13866,250,9,1412.08,2,2,3,7,Regulars
13867,175,7,2115.64,3,1,4,8,Big Spenders
13868,88,11,994.09,4,3,2,9,Loyal
13869,23,11,2313.28,5,3,4,12,Loyal
13870,93,10,2704.8,4,3,5,12,Loyal
13871,82,6,2082.26,4,1,4,9,Big Spenders
13872,80,8,809.37,4,2,1,7,Regulars
13873,263,12,2581.36,2,4,5,11,At Risk
13874,135,14,2106.42,4,5,4,13,Champions
13875,244,12,749.39,3,4,1,8,Regulars
13876,442,9,900.74,2,2,2,6,Hibernating
13877,102,11,1194.49,4,3,2,9,Loyal
13878,237,11,1209.08,3,3,2,8,Regulars
13879,322,7,674.4499999999999,2,1,1,4,Hibernating
13880,160,10,800.5,3,3,1,7,Regulars
13881,101,10,1037.86,4,3,2,9,Loyal
13882,198,7,861.27,3,1,2,6,Regulars
13883,375,8,1221.6,2,2,2,6,Hibernating
13884,309,10,2094.19,2,3,4,9,Regulars
13885,311,8,1181.19,2,2,2,6,Hibernating
13886,48,6,502.11,5,1,1,7,Regulars
13887,55,7,692.41,5,1,1,7,Regulars
13888,281,15,2044.35,2,5,4,11,At Risk
13889,106,13,3479.0299999999997,4,4,5,13,Champions
13890,5,10,2332.1,5,3,4,12,Loyal
13891,913,8,1686.3400000000001,1,2,3,6,Regulars
13892,49,15,1779.13,5,5,4,14,Champions
13893,1257,6,1864.5900000000001,1,1,4,6,Regulars
13894,107,13,1501.76,4,4,3,11,Loyal
13895,814,9,2983.22,1,2,5,8,Regulars
13896,113,7,1028.52,4,1,2,7,Regulars
13897,76,11,1817.2599999999998,4,3,4,11,Loyal
13898,1464,10,1851.34,1,3,4,8,Regulars
13899,249,14,1374.91,2,5,3,10,At Risk
13900,753,9,649.9300000000001,1,2,1,4,Hibernating
13901,650,5,723.1700000000001,1,1,1,3,Hibernating
13902,1371,6,380.53000000000003,1,1,1,3,Hibernating
13903,828,2,102.28999999999999,1,1,1,3,Hibernating
13904,37,5,718.5799999999999,5,1,1,7,Regulars
13905,78,12,1417.3,4,4,3,11,Loyal
13906,195,9,1062.71,3,2,2,7,Regulars
13907,461,8,548.43,1,2,1,4,Hibernating
13908,99,15,4678.58,4,5,5,14,Champions
13909,188,15,3116.11,3,5,5,13,Big Spenders
13910,31,13,1069.43,5,4,2,11,Loyal
13911,378,8,749.23,2,2,1,5,Hibernating
13912,85,12,2788.8599999999997,4,4,5,13,Champions
13913,317,9,2721.64,2,2,5,9,Regulars
13914,390,12,1011.71,2,4,2,8,At Risk
13915,24,11,3630.33,5,3,5,13,Loyal
13916,36,13,3362.02,5,4,5,14,Champions
13917,79,8,3060.9900000000002,4,2,5,11,Big Spenders
13918,253,14,2325.24,2,5,4,11,At Risk
13919,58,15,1993.54,5,5,4,14,Champions
13920,252,6,449.64,2,1,1,4,Hibernating
13921,146,7,1466.14,4,1,3,8,Regulars
13922,375,6,2864.8199999999997,2,1,5,8,Regulars
13923,259,12,1372.01,2,4,3,9,At Risk
13924,214,8,721.5699999999999,3,2,1,6,Regulars
13925,158,12,2872.88,3,4,5,12,Big Spenders
13926,183,11,1330.04,3,3,3,9,Regulars
13927,305,7,841.88,2,1,1,4,Hibernating
13928,190,10,1647.35,3,3,3,9,Regulars
13929,35,18,4666.65,5,5,5,15,Champions
13930,165,9,1952.2400000000002,3,2,4,9,Big Spenders
13931,88,9,1074.3600000000001,4,2,2,8,Regulars
13932,292,8,1058.8999999999999,2,2,2,6,Hibernating
13933,690,8,3128.68,1,2,5,8,Regulars
13934,56,14,3770.7200000000003,5,5,5,15,Champions
13935,458,15,1581.72,2,5,3,10,At Risk
13936,218,11,4095.99,3,3,5,11,Big Spenders
13937,170,12,1281.39,3,4,3,10,Regulars
13938,32,10,1660.1100000000001,5,3,3,11,Loyal
13939,306,6,850.39,2,1,2,5,Hibernating
13940,1780,4,493.22,1,1,1,3,Hibernating
13941,80,14,1632.07,4,5,3,12,Loyal
13942,35,7,1258.28,5,1,3,9,Regulars
13943,22,18,4154.09,5,5,5,15,Champions
13944,57,16,4008.61,5,5,5,15,Champions
13945,105,5,790.87,4,1,1,6,Regulars
13946,389,5,1279.25,2,1,3,6,Regulars
13947,61,12,3312.23,5,4,5,14,Champions
13948,149,12,2081.15,3,4,4,11,Big Spenders
13949,69,7,472.49,4,1,1,6,Regulars
13950,91,9,927.99,4,2,2,8,Regulars
13951,563,15,1599.29,1,5,3,9,At Risk
13952,867,6,1953.44,1,1,4,6,Regulars
13953,397,10,1825.0,2,3,4,9,Regulars
13954,346,16,1803.89,2,5,4,11,At Risk
13955,243,10,1615.31,3,3,3,9,Regulars
13956,186,6,944.16,3,1,2,6,Regulars
13957,111,12,2661.71,4,4,5,13,Champions
13958,48,18,2442.41,5,5,4,14,Champions
13959,567,4,345.37,1,1,1,3,Hibernating
13960,124,12,1567.3700000000001,4,4,3,11,Loyal
13961,198,12,1311.28,3,4,3,10,Regulars
13962,94,15,3108.86,4,5,5,14,Champions
13963,87,11,1160.44,4,3,2,9,Loyal
13964,303,10,3411.83,2,3,5,10,Regulars
13965,101,9,2117.03,4,2,4,10,Big Spenders
13966,7,8,761.16,5,2,1,8,Regulars
13967,175,13,1673.2,3,4,3,10,Regulars
13968,237,6,1230.35,3,1,2,6,Regulars
13969,309,3,1374.08,2,1,3,6,Regulars
13970,139,13,3325.5199999999995,4,4,5,13,Champions
13971,1230,6,1016.55,1,1,2,4,Hibernating
13972,60,6,401.36,5,1,1,7,Regulars
13973,243,9,3029.7900000000004,3,2,5,10,Big Spenders
13974,231,10,794.51,3,3,1,7,Regulars
13975,90,7,1262.74,4,1,3,8,Regulars
13976,297,6,628.9200000000001,2,1,1,4,Hibernating
13977,239,12,1217.04,3,4,2,9,Regulars
13978,63,12,2287.19,5,4,4,13,Champions
13979,43,7,865.03,5,1,2,8,Regulars
13980,478,7,1085.1399999999999,1,1,2,4,Hibernating
13981,159,8,846.24,3,2,2,7,Regulars
13982,107,9,1296.18,4,2,3,9,Regulars
13983,81,13,1058.95,4,4,2,10,Loyal
13984,400,8,878.77,2,2,2,6,Hibernating
13985,278,13,3034.76,2,4,5,11,At Risk
13986,174,10,1213.27,3,3,2,8,Regulars
13987,99,9,2442.54,4,2,4,10,Big Spenders
13988,23,9,1049.69,5,2,2,9,Regulars
13989,381,13,1325.03,2,4,3,9,At Risk
13990,324,7,908.89,2,1,2,5,Hibernating
13991,91,10,2007.72,4,3,4,11,Loyal
13992,75,14,1483.0300000000002,4,5,3,12,Loyal
13993,956,8,1510.1899999999998,1,2,3,6,Regulars
13994,238,6,4129.410000000001,3,1,5,9,Big Spenders
13995,162,9,1314.44,3,2,3,8,Regulars
13996,201,8,3277.08,3,2,5,10,Big Spenders
13997,108,10,1843.08,4,3,4,11,Loyal
13998,10,9,1477.71,5,2,3,10,Regulars
13999,580,10,835.58,1,3,1,5,Regulars
14000,1457,12,3264.31,1,4,5,10,At Risk
14001,316,12,1758.0100000000002,2,4,4,10,At Risk
14002,168,12,1157.76,3,4,2,9,Regulars
14003,64,6,682.29,5,1,1,7,Regulars
14004,268,8,1392.03,2,2,3,7,Regulars
14005,234,13,2262.14,3,4,4,11,Big Spenders
14006,238,9,1128.28,3,2,2,7,Regulars
14007,22,13,1540.49,5,4,3,12,Loyal
14008,74,14,1233.7,4,5,2,11,Loyal
14009,91,12,2376.3199999999997,4,4,4,12,Champions
14010,984,6,2448.16,1,1,4,6,Regulars
14011,1128,12,1700.1200000000001,1,4,3,8,At Risk
14012,909,7,2908.61,1,1,5,7,Regulars
14013,41,14,1487.21,5,5,3,13,Loyal
14014,545,8,820.16,1,2,1,4,Hibernating
14015,197,17,1509.45,3,5,3,11,Regulars
14016,467,10,3039.6400000000003,1,3,5,9,Regulars
14017,425,16,2024.1599999999999,2,5,4,11,At Risk
14018,103,14,1552.07,4,5,3,12,Loyal
14019,262,10,1390.51,2,3,3,8,Regulars
14020,217,9,565.6800000000001,3,2,1,6,Regulars
14021,114,15,1333.42,4,5,3,12,Loyal
14022,600,9,794.03,1,2,1,4,Hibernating
14023,61,9,716.24,5,2,1,8,Regulars
14024,542,7,924.5600000000001,1,1,2,4,Hibernating
14025,527,7,1152.0,1,1,2,4,Hibernating
14026,281,8,1261.77,2,2,3,7,Regulars
14027,74,10,1306.17,4,3,3,10,Loyal
14028,83,14,1512.54,4,5,3,12,Loyal
14029,207,17,5052.870000000001,3,5,5,13,Big Spenders
14030,166,10,1605.27,3,3,3,9,Regulars
14031,216,9,1753.13,3,2,4,9,Big Spenders
14032,274,13,1208.28,2,4,2,8,At Risk
14033,5,12,1803.6100000000001,5,4,4,13,Champions
14034,391,13,1821.3799999999999,2,4,4,10,At Risk
14035,20,14,1000.75,5,5,2,12,Loyal
14036,198,8,538.27,3,2,1,6,Regulars
14037,812,10,1035.1599999999999,1,3,2,6,Regulars
14038,466,11,1638.55,1,3,3,7,Regulars
14039,52,8,743.76,5,2,1,8,Regulars
14040,287,10,537.29,2,3,1,6,Regulars
14041,231,17,1911.9,3,5,4,12,Big Spenders
14042,144,13,746.26,4,4,1,9,Loyal
14043,132,11,1230.38,4,3,2,9,Loyal
14044,6,9,2542.2799999999997,5,2,4,11,Big Spenders
14045,345,5,432.57,2,1,1,4,Hibernating
14046,190,9,647.76,3,2,1,6,Regulars
14047,38,12,1212.8600000000001,5,4,2,11,Loyal
14048,894,9,1913.3,1,2,4,7,Regulars
14049,526,16,2624.0499999999997,1,5,5,11,At Risk
14050,302,7,546.91,2,1,1,4,Hibernating
14051,504,12,1295.51,1,4,3,8,At Risk
14052,6,11,1055.05,5,3,2,10,Loyal
14053,122,14,5591.59,4,5,5,14,Champions
14054,109,10,551.43,4,3,1,8,Loyal
14055,32,8,1321.44,5,2,3,10,Regulars
14056,26,11,5547.72,5,3,5,13,Loyal
14057,390,7,1255.03,2,1,3,6,Regulars
14058,212,5,524.54,3,1,1,5,Regulars
14059,53,14,1383.38,5,5,3,13,Loyal
14060,278,10,1438.72,2,3,3,8,Regulars
14061,349,11,425.15,2,3,1,6,Regulars
14062,8,10,1044.54,5,3,2,10,Loyal
14063,916,10,1247.56,1,3,3,7,Regulars
14064,1147,4,615.9499999999999,1,1,1,3,Hibernating
14065,154,10,2332.9900000000002,3,3,4,10,Big Spenders
14066,220,7,4192.55,3,1,5,9,Big Spenders
14067,27,13,2603.21,5,4,5,14,Champions
14068,1137,5,399.3,1,1,1,3,Hibernating
14069,205,13,1414.09,3,4,3,10,Regulars
14070,231,7,615.89,3,1,1,5,Regulars
14071,120,9,1549.91,4,2,3,9,Regulars
14072,549,6,731.45,1,1,1,3,Hibernating
14073,285,7,948.1899999999999,2,1,2,5,Hibernating
14074,135,10,5041.3,4,3,5,12,Loyal
14075,436,14,1970.7,2,5,4,11,At Risk
14076,923,10,1693.3600000000001,1,3,3,7,Regulars
14077,24,7,3380.28,5,1,5,11,Big Spenders
14078,75,8,1395.0100000000002,4,2,3,9,Regulars
14079,194,11,2085.5,3,3,4,10,Big Spenders
14080,578,10,1084.76,1,3,2,6,Regulars
14081,172,7,2130.4700000000003,3,1,4,8,Big Spenders
14082,40,12,2052.34,5,4,4,13,Champions
14083,299,10,2050.92,2,3,4,9,Regulars
14084,90,8,507.56,4,2,1,7,Regulars
14085,471,8,3000.45,1,2,5,8,Regulars
14086,147,13,1404.47,4,4,3,11,Loyal
14087,1036,5,887.52,1,1,2,4,Hibernating
14088,400,15,2564.76,2,5,4,11,At Risk
14089,239,15,5751.67,3,5,5,13,Big Spenders
14090,861,6,591.02,1,1,1,3,Hibernating
14091,331,8,526.91,2,2,1,5,Hibernating
14092,199,5,2719.15,3,1,5,9,Big Spenders
14093,913,7,674.42,1,1,1,3,Hibernating
14094,94,9,1428.07,4,2,3,9,Regulars
14095,18,9,900.38,5,2,2,9,Regulars
14096,424,15,3542.7200000000003,2,5,5,12,At Risk
14097,6,15,1044.51,5,5,2,12,Loyal
14098,876,8,691.88,1,2,1,4,Hibernating
14099,195,13,1394.43,3,4,3,10,Regulars
14100,64,9,693.54,5,2,1,8,Regulars
14101,330,10,1836.01,2,3,4,9,Regulars
14102,770,6,572.22,1,1,1,3,Hibernating
14103,60,11,1049.15,5,3,2,10,Loyal
14104,42,11,1007.9200000000001,5,3,2,10,Loyal
14105,15,9,1922.67,5,2,4,11,Big Spenders
14106,154,14,1402.69,3,5,3,11,Regulars
14107,44,13,3185.12,5,4,5,14,Champions
14108,857,6,297.69,1,1,1,3,Hibernating
14109,76,17,1984.99,4,5,4,13,Champions
14110,303,5,1102.29,2,1,2,5,Hibernating
14111,160,14,2540.0,3,5,4,12,Big Spenders
14112,185,15,1348.22,3,5,3,11,Regulars
14113,175,14,1981.62,3,5,4,12,Big Spenders
14114,43,12,1436.52,5,4,3,12,Loyal
14115,49,13,5079.56,5,4,5,14,Champions
14116,584,6,1118.74,1,1,2,4,Hibernating
14117,177,13,2091.48,3,4,4,11,Big Spenders
14118,23,9,1556.56,5,2,3,10,Regulars
14119,1088,5,612.79,1,1,1,3,Hibernating
14120,174,10,922.33,3,3,2,8,Regulars
14121,49,8,573.52,5,2,1,8,Regulars
14122,140,12,434.41999999999996,4,4,1,9,Loyal
14123,86,9,693.59,4,2,1,7,Regulars
14124,246,9,1735.09,3,2,4,9,Big Spenders
14125,269,8,688.59,2,2,1,5,Hibernating
14126,158,12,3247.03,3,4,5,12,Big Spenders
14127,1176,4,360.21000000000004,1,1,1,3,Hibernating
14128,552,8,2653.1000000000004,1,2,5,8,Regulars
14129,317,7,534.9399999999999,2,1,1,4,Hibernating
14130,297,12,1823.25,2,4,4,10,At Risk
14131,560,8,1685.77,1,2,3,6,Regulars
14132,628,11,1307.74,1,3,3,7,Regulars
14133,135,14,2293.6400000000003,4,5,4,13,Champions
14134,76,12,1045.97,4,4,2,10,Loyal
14135,181,15,1712.7199999999998,3,5,3,11,Regulars
14136,160,11,2969.48,3,3,5,11,Big Spenders
14137,268,11,1580.97,2,3,3,8,Regulars
14138,300,14,4567.11,2,5,5,12,At Risk
14139,367,15,5889.2699999999995,2,5,5,12,At Risk
14140,123,16,1625.1,4,5,3,12,Loyal
14141,107,15,4650.8,4,5,5,14,Champions
14142,33,10,2173.92,5,3,4,12,Loyal
14143,247,10,1929.44,3,3,4,10,Big Spenders
14144,559,7,1785.49,1,1,4,6,Regulars
14145,504,6,912.3,1,1,2,4,Hibernating
14146,175,13,4884.01,3,4,5,12,Big Spenders
14147,297,8,1914.67,2,2,4,8,Regulars
14148,208,12,1281.53,3,4,3,10,Regulars
14149,145,14,3966.0899999999997,4,5,5,14,Champions
14150,498,16,4609.8099999999995,1,5,5,11,At Risk
14151,135,12,2222.81,4,4,4,12,Champions
14152,1222,3,411.9,1,1,1,3,Hibernating
14153,69,10,2552.66,4,3,4,11,Loyal
14154,288,7,417.09000000000003,2,1,1,4,Hibernating
14155,338,12,1216.2,2,4,2,8,At Risk
14156,909,12,2785.11,1,4,5,10,At Risk
14157,165,13,1279.8700000000001,3,4,3,10,Regulars
14158,272,6,617.58,2,1,1,4,Hibernating
14159,107,7,722.98,4,1,1,6,Regulars
14160,92,7,930.92,4,1,2,7,Regulars
14161,175,14,1767.94,3,5,4,12,Big Spenders
14162,654,9,1156.82,1,2,2,5,Hibernating
14163,124,9,1157.4199999999998,4,2,2,8,Regulars
14164,284,13,1079.3,2,4,2,8,At Risk
14165,450,6,768.89,2,1,1,4,Hibernating
14166,251,7,414.76,2,1,1,4,Hibernating
14167,140,9,1115.21,4,2,2,8,Regulars
14168,45,14,6165.62,5,5,5,15,Champions
14169,489,11,1109.2,1,3,2,6,Regulars
14170,237,10,1770.76,3,3,4,10,Big Spenders
14171,19,10,982.2900000000001,5,3,2,10,Loyal
14172,367,11,2575.48,2,3,5,10,Regulars
14173,68,11,2847.23,4,3,5,12,Loyal
14174,152,8,5473.05,3,2,5,10,Big Spenders
14175,534,10,811.31,1,3,1,5,Regulars
14176,326,11,1185.17,2,3,2,7,Regulars
14177,151,8,822.34,3,2,1,6,Regulars
14178,214,9,1230.32,3,2,2,7,Regulars
14179,631,12,1261.72,1,4,3,8,At Risk
14180,77,11,1224.21,4,3,2,9,Loyal
14181,570,8,1065.3200000000002,1,2,2,5,Hibernating
14182,12,16,1275.46,5,5,3,13,Loyal
14183,335,12,3806.61,2,4,5,11,At Risk
14184,55,6,1742.1100000000001,5,1,4,10,Big Spenders
14185,176,11,3317.1700000000005,3,3,5,11,Big Spenders
14186,33,10,701.53,5,3,1,9,Loyal
14187,61,10,1423.19,5,3,3,11,Loyal
14188,94,7,560.24,4,1,1,6,Regulars
14189,111,10,660.0500000000001,4,3,1,8,Loyal
14190,31,7,944.14,5,1,2,8,Regulars
14191,20,17,4525.96,5,5,5,15,Champions
14192,393,14,1708.9,2,5,3,10,At Risk
14193,624,10,990.3800000000001,1,3,2,6,Regulars
14194,49,7,4796.59,5,1,5,11,Big Spenders
14195,237,6,2516.4199999999996,3,1,4,8,Big Spenders
14196,197,15,2132.12,3,5,4,12,Big Spenders
14197,132,13,2430.23,4,4,4,12,Champions
14198,262,8,752.97,2,2,1,5,Hibernating
14199,579,8,1015.61,1,2,2,5,Hibernating
14200,54,16,2049.75,5,5,4,14,Champions
14201,112,9,1537.3600000000001,4,2,3,9,Regulars
14202,460,9,883.5600000000001,1,2,2,5,Hibernating
14203,264,7,895.0699999999999,2,1,2,5,Hibernating
14204,216,16,2511.7599999999998,3,5,4,12,Big Spenders
14205,214,9,888.25,3,2,2,7,Regulars
14206,744,6,960.69,1,1,2,4,Hibernating
14207,639,9,1106.3899999999999,1,2,2,5,Hibernating
14208,899,5,509.90000000000003,1,1,1,3,Hibernating
14209,204,9,1172.97,3,2,2,7,Regulars
14210,132,9,1271.09,4,2,3,9,Regulars
14211,104,8,1919.68,4,2,4,10,Big Spenders
14212,25,11,1618.2,5,3,3,11,Loyal
14213,156,14,1891.8000000000002,3,5,4,12,Big Spenders
14214,236,10,1187.8,3,3,2,8,Regulars
14215,9,14,1587.11,5,5,3,13,Loyal
14216,0,14,1764.62,5,5,4,14,Champions
14217,28,15,1000.36,5,5,2,12,Loyal
14218,348,9,905.9399999999999,2,2,2,6,Hibernating
14219,497,11,2969.59,1,3,5,9,Regulars
14220,482,10,6065.86,1,3,5,9,Regulars
14221,103,14,3584.29,4,5,5,14,Champions
14222,235,17,3818.1499999999996,3,5,5,13,Big Spenders
14223,235,16,3078.59,3,5,5,13,Big Spenders
14224,515,9,2530.45,1,2,4,7,Regulars
14225,217,9,1357.6399999999999,3,2,3,8,Regulars
14226,449,11,848.0,2,3,2,7,Regulars
14227,90,11,5132.46,4,3,5,12,Loyal
14228,323,7,1761.5900000000001,2,1,4,7,Regulars
14229,432,8,1220.44,2,2,2,6,Hibernating
14230,417,14,1924.87,2,5,4,11,At Risk
14231,95,7,1286.07,4,1,3,8,Regulars
14232,77,12,1821.95,4,4,4,12,Champions
14233,121,9,1060.91,4,2,2,8,Regulars
14234,236,8,783.77,3,2,1,6,Regulars
14235,196,19,1929.14,3,5,4,12,Big Spenders
14236,212,14,1287.46,3,5,3,11,Regulars
14237,521,8,737.17,1,2,1,4,Hibernating
14238,480,12,3484.0699999999997,1,4,5,10,At Risk
14239,77,7,2172.98,4,1,4,9,Big Spenders
14240,206,13,1893.99,3,4,4,11,Big Spenders
14241,556,8,2008.6,1,2,4,7,Regulars
14242,4,11,1467.28,5,3,3,11,Loyal
14243,664,9,1538.4299999999998,1,2,3,6,Regulars
14244,118,7,934.19,4,1,2,7,Regulars
14245,27,17,2805.95,5,5,5,15,Champions
14246,339,11,1320.49,2,3,3,8,Regulars
14247,48,10,1816.35,5,3,4,12,Loyal
14248,491,8,629.41,1,2,1,4,Hibernating
14249,182,14,3093.5499999999997,3,5,5,13,Big Spenders
14250,31,4,1456.5,5,1,3,9,Regulars
14251,285,11,1837.01,2,3,4,9,Regulars
14252,82,13,1637.97,4,4,3,11,Loyal
14253,34,11,1271.45,5,3,3,11,Loyal
14254,55,12,3888.95,5,4,5,14,Champions
14255,120,15,2710.91,4,5,5,14,Champions
14256,1004,7,681.81,1,1,1,3,Hibernating
14257,166,12,1952.34,3,4,4,11,Big Spenders
14258,406,7,877.55,2,1,2,5,Hibernating
14259,882,9,1034.4099999999999,1,2,2,5,Hibernating
14260,213,13,1660.6799999999998,3,4,3,10,Regulars
14261,139,7,399.03999999999996,4,1,1,6,Regulars
14262,363,5,525.29,2,1,1,4,Hibernating
14263,235,12,4091.96,3,4,5,12,Big Spenders
14264,121,13,1141.86,4,4,2,10,Loyal
14265,116,12,2256.47,4,4,4,12,Champions
14266,105,14,1026.73,4,5,2,11,Loyal
14267,846,6,586.2099999999999,1,1,1,3,Hibernating
14268,11,12,3370.17,5,4,5,14,Champions
14269,762,10,1451.01,1,3,3,7,Regulars
14270,92,12,2070.96,4,4,4,12,Champions
14271,204,11,1911.41,3,3,4,10,Big Spenders
14272,25,12,1740.19,5,4,4,13,Champions
14273,95,12,3942.8599999999997,4,4,5,13,Champions
14274,162,17,2988.79,3,5,5,13,Big Spenders
14275,488,7,1290.46,1,1,3,5,Regulars
14276,99,13,2795.2799999999997,4,4,5,13,Champions
14277,208,16,3972.84,3,5,5,13,Big Spenders
14278,324,9,615.33,2,2,1,5,Hibernating
14279,70,13,1907.51,4,4,4,12,Champions
14280,144,11,5109.93,4,3,5,12,Loyal
14281,495,8,450.36,1,2,1,4,Hibernating
14282,54,10,1557.06,5,3,3,11,Loyal
14283,122,10,1885.1799999999998,4,3,4,11,Loyal
14284,321,10,722.64,2,3,1,6,Regulars
14285,104,10,1628.43,4,3,3,10,Loyal
14286,301,12,6613.74,2,4,5,11,At Risk
14287,23,10,2147.7799999999997,5,3,4,12,Loyal
14288,30,12,3650.98,5,4,5,14,Champions
14289,166,9,1358.57,3,2,3,8,Regulars
14290,21,7,730.6800000000001,5,1,1,7,Regulars
14291,178,11,1083.62,3,3,2,8,Regulars
14292,471,16,3105.45,1,5,5,11,At Risk
14293,269,8,1888.47,2,2,4,8,Regulars
14294,154,13,1640.6,3,4,3,10,Regulars
14295,359,9,1855.64,2,2,4,8,Regulars
14296,230,13,2218.16,3,4,4,11,Big Spenders
14297,129,11,3007.7400000000002,4,3,5,12,Loyal
14298,190,11,1007.66,3,3,2,8,Regulars
14299,672,6,715.58,1,1,1,3,Hibernating
14300,238,10,1463.69,3,3,3,9,Regulars
14301,591,7,636.69,1,1,1,3,Hibernating
14302,103,12,1188.72,4,4,2,10,Loyal
14303,558,8,334.23,1,2,1,4,Hibernating
14304,261,15,1375.98,2,5,3,10,At Risk
14305,11,16,2694.68,5,5,5,15,Champions
14306,468,9,4260.4400000000005,1,2,5,8,Regulars
14307,127,17,6498.25,4,5,5,14,Champions
14308,1079,4,555.84,1,1,1,3,Hibernating
14309,127,11,1809.13,4,3,4,11,Loyal
14310,218,11,1296.14,3,3,3,9,Regulars
14311,619,5,424.75,1,1,1,3,Hibernating
14312,558,7,1787.0800000000002,1,1,4,6,Regulars
14313,1183,8,1354.67,1,2,3,6,Regulars
14314,31,17,4262.2,5,5,5,15,Champions
14315,307,12,1387.04,2,4,3,9,At Risk
14316,302,6,1013.34,2,1,2,5,Hibernating
14317,111,6,410.84,4,1,1,6,Regulars
14318,0,11,1549.6,5,3,3,11,Loyal
14319,257,11,3771.93,2,3,5,10,Regulars
14320,324,14,2926.09,2,5,5,12,At Risk
14321,42,6,1712.96,5,1,3,9,Regulars
14322,288,9,898.52,2,2,2,6,Hibernating
14323,821,8,902.7,1,2,2,5,Hibernating
14324,20,13,2973.35,5,4,5,14,Champions
14325,85,10,2181.2,4,3,4,11,Loyal
14326,300,11,3461.5,2,3,5,10,Regulars
14327,517,6,2168.58,1,1,4,6,Regulars
14328,90,12,1888.95,4,4,4,12,Champions
14329,680,4,261.15000000000003,1,1,1,3,Hibernating
14330,201,18,3356.12,3,5,5,13,Big Spenders
14331,68,8,699.2,4,2,1,7,Regulars
14332,388,6,1449.6399999999999,2,1,3,6,Regulars
14333,145,8,5180.92,4,2,5,11,Big Spenders
14334,17,12,3856.2700000000004,5,4,5,14,Champions
14335,36,14,1324.79,5,5,3,13,Loyal
14336,185,13,1373.6,3,4,3,10,Regulars
14337,965,13,2137.95,1,4,4,9,At Risk
14338,247,11,1897.78,3,3,4,10,Big Spenders
14339,441,11,3503.98,2,3,5,10,Regulars
14340,1067,10,785.86,1,3,1,5,Regulars
14341,17,11,1258.91,5,3,3,11,Loyal
14342,166,10,1594.75,3,3,3,9,Regulars
14343,84,6,757.14,4,1,1,6,Regulars
14344,301,14,3225.86,2,5,5,12,At Risk
14345,260,10,1585.45,2,3,3,8,Regulars
14346,84,8,842.79,4,2,1,7,Regulars
14347,139,7,1973.01,4,1,4,9,Big Spenders
14348,23,8,2380.79,5,2,4,11,Big Spenders
14349,937,4,404.40000000000003,1,1,1,3,Hibernating
14350,107,11,1014.84,4,3,2,9,Loyal
14351,455,5,900.4899999999999,2,1,2,5,Hibernating
14352,129,11,1243.4,4,3,3,10,Loyal
14353,195,7,1213.12,3,1,2,6,Regulars
14354,50,11,969.9300000000001,5,3,2,10,Loyal
14355,126,9,2756.2599999999998,4,2,5,11,Big Spenders
14356,341,11,2074.59,2,3,4,9,Regulars
14357,237,15,3312.9300000000003,3,5,5,13,Big Spenders
14358,149,12,1614.71,3,4,3,10,Regulars
14359,373,12,2621.76,2,4,5,11,At Risk
14360,30,13,1485.57,5,4,3,12,Loyal
14361,143,9,927.71,4,2,2,8,Regulars
14362,206,9,483.32000000000005,3,2,1,6,Regulars
14363,452,7,719.58,2,1,1,4,Hibernating
14364,125,14,1413.71,4,5,3,12,Loyal
14365,964,9,3334.0000000000005,1,2,5,8,Regulars
14366,478,13,927.48,1,4,2,7,At Risk
14367,23,12,1429.0900000000001,5,4,3,12,Loyal
14368,267,9,1143.55,2,2,2,6,Hibernating
14369,114,13,3855.05,4,4,5,13,Champions
14370,521,7,1192.67,1,1,2,4,Hibernating
14371,391,7,1311.4099999999999,2,1,3,6,Regulars
14372,104,13,1233.31,4,4,2,10,Loyal
14373,442,9,2487.1,2,2,4,8,Regulars
14374,30,10,1214.89,5,3,2,10,Loyal
14375,49,19,2330.92,5,5,4,14,Champions
14376,105,10,2209.55,4,3,4,11,Loyal
14377,50,8,2779.2,5,2,5,12,Big Spenders
14378,175,9,738.1,3,2,1,6,Regulars
14379,544,12,3244.33,1,4,5,10,At Risk
14380,79,8,1205.19,4,2,2,8,Regulars
14381,141,7,725.65,4,1,1,6,Regulars
14382,94,16,1767.98,4,5,4,13,Champions
14383,113,11,3130.49,4,3,5,12,Loyal
14384,379,6,1840.16,2,1,4,7,Regulars
14385,839,6,755.75,1,1,1,3,Hibernating
14386,16,11,1210.07,5,3,2,10,Loyal
14387,21,16,1705.81,5,5,3,13,Loyal
14388,248,11,926.22,2,3,2,7,Regulars
14389,13,16,1491.3799999999999,5,5,3,13,Loyal
14390,259,7,1219.5700000000002,2,1,2,5,Hibernating
14391,16,9,1144.8899999999999,5,2,2,9,Regulars
14392,121,9,515.42,4,2,1,7,Regulars
14393,140,8,1415.97,4,2,3,9,Regulars
14394,185,9,1086.29,3,2,2,7,Regulars
14395,142,7,560.65,4,1,1,6,Regulars
14396,116,11,1291.71,4,3,3,10,Loyal
14397,75,11,3134.76,4,3,5,12,Loyal
14398,194,6,765.2,3,1,1,5,Regulars
14399,167,9,2468.21,3,2,4,9,Big Spenders
14400,316,10,2669.7700000000004,2,3,5,10,Regulars
14401,144,9,986.7800000000001,4,2,2,8,Regulars
14402,94,15,1858.55,4,5,4,13,Champions
14403,102,10,907.51,4,3,2,9,Loyal
14404,94,9,1938.0900000000001,4,2,4,10,Big Spenders
14405,570,5,476.57,1,1,1,3,Hibernating
14406,182,18,1823.28,3,5,4,12,Big Spenders
14407,27,9,1177.97,5,2,2,9,Regulars
14408,604,8,1886.8899999999999,1,2,4,7,Regulars
14409,364,7,1319.76,2,1,3,6,Regulars
14410,662,11,927.8100000000001,1,3,2,6,Regulars
14411,379,11,2222.6000000000004,2,3,4,9,Regulars
14412,1,6,237.85,5,1,1,7,Regulars
14413,1240,4,430.08,1,1,1,3,Hibernating
14414,785,10,1781.29,1,3,4,8,Regulars
14415,441,10,2302.52,2,3,4,9,Regulars
14416,75,11,2573.3300000000004,4,3,4,11,Loyal
14417,525,7,1908.8,1,1,4,6,Regulars
14418,523,8,385.91999999999996,1,2,1,4,Hibernating
14419,265,9,1781.4299999999998,2,2,4,8,Regulars
14420,554,10,1269.0,1,3,3,7,Regulars
14421,758,9,690.62,1,2,1,4,Hibernating
14422,92,14,1546.53,4,5,3,12,Loyal
14423,265,7,981.5699999999999,2,1,2,5,Hibernating
14424,483,11,969.65,1,3,2,6,Regulars
14425,478,8,525.59,1,2,1,4,Hibernating
14426,78,10,767.79,4,3,1,8,Loyal
14427,518,4,206.33,1,1,1,3,Hibernating
14428,1139,15,1014.59,1,5,2,8,At Risk
14429,109,14,4398.86,4,5,5,14,Champions
14430,20,8,435.03000000000003,5,2,1,8,Regulars
14431,200,10,1121.12,3,3,2,8,Regulars
14432,177,11,2551.54,3,3,4,10,Big Spenders
14433,156,6,948.95,3,1,2,6,Regulars
14434,129,8,3175.4799999999996,4,2,5,11,Big Spenders
14435,2,11,4445.78,5,3,5,13,Loyal
14436,589,10,699.3199999999999,1,3,1,5,Regulars
14437,122,14,2223.77,4,5,4,13,Champions
14438,102,11,1325.75,4,3,3,10,Loyal
14439,506,19,3995.7,1,5,5,11,At Risk
14440,72,11,1684.75,4,3,3,10,Loyal
14441,92,12,1278.45,4,4,3,11,Loyal
14442,196,9,431.69,3,2,1,6,Regulars
14443,470,7,1195.59,1,1,2,4,Hibernating
14444,84,10,1503.17,4,3,3,10,Loyal
14445,447,7,957.09,2,1,2,5,Hibernating
14446,165,8,5666.12,3,2,5,10,Big Spenders
14447,311,7,716.4,2,1,1,4,Hibernating
14448,75,16,1568.76,4,5,3,12,Loyal
14449,442,7,1070.4399999999998,2,1,2,5,Hibernating
14450,84,7,1853.62,4,1,4,9,Big Spenders
14451,161,9,1173.8500000000001,3,2,2,7,Regulars
14452,40,10,885.04,5,3,2,10,Loyal
14453,813,8,2415.26,1,2,4,7,Regulars
14454,100,12,1469.19,4,4,3,11,Loyal
14455,156,12,2908.2,3,4,5,12,Big Spenders
14456,540,6,369.15000000000003,1,1,1,3,Hibernating
14457,149,18,2174.9900000000002,3,5,4,12,Big Spenders
14458,12,7,829.89,5,1,1,7,Regulars
14459,234,13,2072.6,3,4,4,11,Big Spenders
14460,52,12,3675.48,5,4,5,14,Champions
14461,196,14,2638.79,3,5,5,13,Big Spenders
14462,220,15,5201.610000000001,3,5,5,13,Big Spenders
14463,205,7,1026.38,3,1,2,6,Regulars
14464,499,9,3084.6299999999997,1,2,5,8,Regulars
14465,71,8,989.66,4,2,2,8,Regulars
14466,505,13,1099.28,1,4,2,7,At Risk
14467,438,11,2121.92,2,3,4,9,Regulars
14468,298,8,891.72,2,2,2,6,Hibernating
14469,76,15,1493.72,4,5,3,12,Loyal
14470,155,11,1119.42,3,3,2,8,Regulars
14471,110,11,839.9,4,3,1,8,Loyal
14472,295,12,3905.1800000000003,2,4,5,11,At Risk
14473,196,10,1169.98,3,3,2,8,Regulars
14474,131,11,3433.09,4,3,5,12,Loyal
14475,916,9,800.51,1,2,1,4,Hibernating
14476,22,15,1743.8,5,5,4,14,Champions
14477,79,12,3848.9,4,4,5,13,Champions
14478,450,9,2938.5,2,2,5,9,Regulars
14479,11,11,1238.3,5,3,2,10,Loyal
14480,158,11,947.3100000000001,3,3,2,8,Regulars
14481,3,9,576.8,5,2,1,8,Regulars
14482,637,13,3348.1499999999996,1,4,5,10,At Risk
14483,893,6,411.63,1,1,1,3,Hibernating
14484,73,9,1331.55,4,2,3,9,Regulars
14485,220,16,2492.03,3,5,4,12,Big Spenders
14486,663,7,965.56,1,1,2,4,Hibernating
14487,54,7,3188.57,5,1,5,11,Big Spenders
14488,173,16,2351.52,3,5,4,12,Big Spenders
14489,823,8,5913.459999999999,1,2,5,8,Regulars
14490,269,10,1532.95,2,3,3,8,Regulars
14491,272,17,1727.3400000000001,2,5,4,11,At Risk
14492,214,13,1822.1899999999998,3,4,4,11,Big Spenders
14493,697,13,1991.83,1,4,4,9,At Risk
14494,136,7,711.69,4,1,1,6,Regulars
14495,98,16,2297.64,4,5,4,13,Champions
14496,350,7,1210.66,2,1,2,5,Hibernating
14497,3,12,1157.46,5,4,2,11,Loyal
14498,382,9,977.61,2,2,2,6,Hibernating
14499,0,7,1683.91,5,1,3,9,Regulars
14500,443,4,328.27,2,1,1,4,Hibernating
14501,101,16,4647.92,4,5,5,14,Champions
14502,777,8,1148.76,1,2,2,5,Hibernating
14503,727,10,1974.08,1,3,4,8,Regulars
14504,128,8,1596.79,4,2,3,9,Regulars
14505,160,10,1914.8600000000001,3,3,4,10,Big Spenders
14506,676,11,2573.6299999999997,1,3,4,8,Regulars
14507,154,12,2306.75,3,4,4,11,Big Spenders
14508,101,13,1225.56,4,4,2,10,Loyal
14509,152,12,828.3199999999999,3,4,1,8,Regulars
14510,164,8,424.38,3,2,1,6,Regulars
14511,64,10,1025.83,5,3,2,10,Loyal
14512,606,4,457.76,1,1,1,3,Hibernating
14513,12,10,3963.16,5,3,5,13,Loyal
14514,945,8,2131.65,1,2,4,7,Regulars
14515,199,9,1057.84,3,2,2,7,Regulars
14516,224,10,2001.67,3,3,4,10,Big Spenders
14517,7,10,877.02,5,3,2,10,Loyal
14518,369,12,2393.23,2,4,4,10,At Risk
14519,127,10,1003.46,4,3,2,9,Loyal
14520,17,13,1652.67,5,4,3,12,Loyal
14521,333,8,1379.02,2,2,3,7,Regulars
14522,3,9,506.61,5,2,1,8,Regulars
14523,32,14,5659.26,5,5,5,15,Champions
14524,742,6,388.49,1,1,1,3,Hibernating
14525,1329,10,1982.2699999999998,1,3,4,8,Regulars
14526,9,16,3182.6699999999996,5,5,5,15,Champions
14527,92,12,6493.64,4,4,5,13,Champions
14528,229,7,960.5300000000001,3,1,2,6,Regulars
14529,122,11,947.71,4,3,2,9,Loyal
14530,274,9,985.87,2,2,2,6,Hibernating
14531,44,6,653.78,5,1,1,7,Regulars
14532,537,8,792.88,1,2,1,4,Hibernating
14533,188,10,2333.62,3,3,4,10,Big Spenders
14534,26,8,1161.05,5,2,2,9,Regulars
14535,200,14,5569.13,3,5,5,13,Big Spenders
14536,7,10,1801.6299999999999,5,3,4,12,Loyal
14537,176,10,1449.48,3,3,3,9,Regulars
14538,384,8,1977.3400000000001,2,2,4,8,Regulars
14539,920,5,2244.5299999999997,1,1,4,6,Regulars
14540,174,10,1401.04,3,3,3,9,Regulars
14541,78,11,719.33,4,3,1,8,Loyal
14542,46,15,4685.12,5,5,5,15,Champions
14543,71,8,1216.0,4,2,2,8,Regulars
14544,379,11,1957.6,2,3,4,9,Regulars
14545,127,10,1255.94,4,3,3,10,Loyal
14546,34,11,1489.6599999999999,5,3,3,11,Loyal
14547,663,10,800.73,1,3,1,5,Regulars
14548,14,14,1906.6299999999999,5,5,4,14,Champions
14549,27,12,3319.5099999999998,5,4,5,14,Champions
14550,181,13,1703.15,3,4,3,10,Regulars
14551,23,10,2110.57,5,3,4,12,Loyal
14552,299,14,2608.28,2,5,5,12,At Risk
14553,290,11,950.5799999999999,2,3,2,7,Regulars
14554,28,13,2337.33,5,4,4,13,Champions
14555,87,8,476.48,4,2,1,7,Regulars
14556,62,17,2119.44,5,5,4,14,Champions
14557,156,9,1224.67,3,2,2,7,Regulars
14558,198,8,823.29,3,2,1,6,Regulars
14559,64,9,1018.3499999999999,5,2,2,9,Regulars
14560,174,10,894.09,3,3,2,8,Regulars
14561,202,10,1150.03,3,3,2,8,Regulars
14562,220,11,1419.3899999999999,3,3,3,9,Regulars
14563,685,8,4511.73,1,2,5,8,Regulars
14564,511,6,1607.7399999999998,1,1,3,5,Regulars
14565,243,14,2691.85,3,5,5,13,Big Spenders
14566,465,9,811.5699999999999,1,2,1,4,Hibernating
14567,101,13,1450.1799999999998,4,4,3,11,Loyal
14568,738,8,723.83,1,2,1,4,Hibernating
14569,98,16,2400.05,4,5,4,13,Champions
14570,189,12,2091.77,3,4,4,11,Big Spenders
14571,362,8,958.6,2,2,2,6,Hibernating
14572,129,14,1910.96,4,5,4,13,Champions
14573,159,11,1930.34,3,3,4,10,Big Spenders
14574,197,13,1924.5,3,4,4,11,Big Spenders
14575,330,7,394.75,2,1,1,4,Hibernating
14576,993,8,1833.66,1,2,4,7,Regulars
14577,357,12,2249.0299999999997,2,4,4,10,At Risk
14578,302,11,2159.59,2,3,4,9,Regulars
14579,151,14,3761.55,3,5,5,13,Big Spenders
14580,187,12,2960.42,3,4,5,12,Big Spenders
14581,302,13,2505.75,2,4,4,10,At Risk
14582,111,10,1163.53,4,3,2,9,Loyal
14583,419,13,2067.43,2,4,4,10,At Risk
14584,305,12,3010.94,2,4,5,11,At Risk
14585,120,9,988.76,4,2,2,8,Regulars
14586,462,8,1324.57,1,2,3,6,Regulars
14587,13,16,1409.08,5,5,3,13,Loyal
14588,163,11,3150.12,3,3,5,11,Big Spenders
14589,439,8,1699.0800000000002,2,2,3,7,Regulars
14590,281,16,3337.79,2,5,5,12,At Risk
14591,146,13,1583.1200000000001,4,4,3,11,Loyal
14592,141,13,1722.35,4,4,3,11,Loyal
14593,14,16,4154.22,5,5,5,15,Champions
14594,327,13,1598.3799999999999,2,4,3,9,At Risk
14595,239,12,588.08,3,4,1,8,Regulars
14596,216,9,735.75,3,2,1,6,Regulars
14597,163,7,2784.8900000000003,3,1,5,9,Big Spenders
14598,305,16,2989.98,2,5,5,12,At Risk
14599,277,14,3752.77,2,5,5,12,At Risk
14600,33,16,2113.37,5,5,4,14,Champions
14601,179,8,581.54,3,2,1,6,Regulars
14602,187,15,1447.3600000000001,3,5,3,11,Regulars
14603,514,12,829.8199999999999,1,4,1,6,At Risk
14604,113,18,2347.09,4,5,4,13,Champions
14605,222,10,874.03,3,3,2,8,Regulars
14606,156,8,495.0,3,2,1,6,Regulars
14607,28,10,1544.45,5,3,3,11,Loyal
14608,17,10,943.13,5,3,2,10,Loyal
14609,68,12,2403.7999999999997,4,4,4,12,Champions
14610,965,9,1623.4199999999998,1,2,3,6,Regulars
14611,301,14,3259.56,2,5,5,12,At Risk
14612,517,7,303.93,1,1,1,3,Hibernating
14613,177,11,1287.12,3,3,3,9,Regulars
14614,615,7,774.92,1,1,1,3,Hibernating
14615,41,10,5405.33,5,3,5,13,Loyal
14616,499,9,662.98,1,2,1,4,Hibernating
14617,119,14,1148.66,4,5,2,11,Loyal
14618,184,4,1524.79,3,1,3,7,Regulars
14619,437,10,891.33,2,3,2,7,Regulars
14620,91,11,2716.65,4,3,5,12,Loyal
14621,341,8,1953.0199999999998,2,2,4,8,Regulars
14622,48,14,3673.76,5,5,5,15,Champions
14623,272,14,1636.47,2,5,3,10,At Risk
14624,175,8,970.39,3,2,2,7,Regulars
14625,888,3,584.4200000000001,1,1,1,3,Hibernating
14626,93,14,3467.56,4,5,5,14,Champions
14627,316,11,1692.24,2,3,3,8,Regulars
14628,15,8,5631.65,5,2,5,12,Big Spenders
14629,463,15,3833.1,1,5,5,11,At Risk
14630,207,10,735.2,3,3,1,7,Regulars
14631,468,13,1381.77,1,4,3,8,At Risk
14632,196,11,1657.8,3,3,3,9,Regulars
14633,138,8,1179.64,4,2,2,8,Regulars
14634,297,7,1430.29,2,1,3,6,Regulars
14635,1293,11,655.1,1,3,1,5,Regulars
14636,614,8,515.09,1,2,1,4,Hibernating
14637,152,13,1335.5900000000001,3,4,3,10,Regulars
14638,234,13,3139.53,3,4,5,12,Big Spenders
14639,212,10,2162.61,3,3,4,10,Big Spenders
14640,104,5,416.92,4,1,1,6,Regulars
14641,718,9,1283.2,1,2,3,6,Regulars
14642,379,10,1532.21,2,3,3,8,Regulars
14643,232,14,1749.54,3,5,4,12,Big Spenders
14644,384,7,868.91,2,1,2,5,Hibernating
14645,100,11,2061.83,4,3,4,11,Loyal
14646,219,15,5025.4800000000005,3,5,5,13,Big Spenders
14647,563,7,4420.23,1,1,5,7,Regulars
14648,499,4,2308.52,1,1,4,6,Regulars
14649,125,9,1920.32,4,2,4,10,Big Spenders
14650,47,12,2295.24,5,4,4,13,Champions
14651,27,7,612.2900000000001,5,1,1,7,Regulars
14652,166,10,6135.37,3,3,5,11,Big Spenders
14653,184,7,363.65999999999997,3,1,1,5,Regulars
14654,6,12,1462.69,5,4,3,12,Loyal
14655,155,18,2332.97,3,5,4,12,Big Spenders
14656,56,6,490.34999999999997,5,1,1,7,Regulars
14657,61,12,2192.39,5,4,4,13,Champions
14658,522,8,1085.52,1,2,2,5,Hibernating
14659,118,11,2619.37,4,3,5,12,Loyal
14660,102,7,1636.3500000000001,4,1,3,8,Regulars
14661,94,12,1849.0799999999997,4,4,4,12,Champions
14662,3,9,1970.83,5,2,4,11,Big Spenders
14663,2,10,715.24,5,3,1,9,Loyal
14664,255,7,876.03,2,1,2,5,Hibernating
14665,440,8,1832.24,2,2,4,8,Regulars
14666,198,6,486.49,3,1,1,5,Regulars
14667,283,10,2790.3,2,3,5,10,Regulars
14668,111,7,1212.7800000000002,4,1,2,7,Regulars
14669,284,11,2849.04,2,3,5,10,Regulars
14670,111,10,1974.19,4,3,4,11,Loyal
14671,1,8,1023.1700000000001,5,2,2,9,Regulars
14672,424,10,3205.8900000000003,2,3,5,10,Regulars
14673,304,7,1488.64,2,1,3,6,Regulars
14674,6,11,1103.43,5,3,2,10,Loyal
14675,290,13,1969.8400000000001,2,4,4,10,At Risk
14676,198,17,2460.4,3,5,4,12,Big Spenders
14677,282,7,415.82,2,1,1,4,Hibernating
14678,1300,3,375.36,1,1,1,3,Hibernating
14679,395,10,708.01,2,3,1,6,Regulars
14680,1,10,835.04,5,3,1,9,Loyal
14681,186,10,3063.82,3,3,5,11,Big Spenders
14682,15,13,5485.33,5,4,5,14,Champions
14683,247,15,1237.31,3,5,2,10,Regulars
14684,139,9,1224.67,4,2,2,8,Regulars
14685,29,15,1391.6200000000001,5,5,3,13,Loyal
14686,281,11,2407.3399999999997,2,3,4,9,Regulars
14687,350,9,1656.88,2,2,3,7,Regulars
14688,199,11,5626.85,3,3,5,11,Big Spenders
14689,57,7,2649.1199999999994,5,1,5,11,Big Spenders
14690,365,11,838.6299999999999,2,3,1,6,Regulars
14691,447,8,1205.54,2,2,2,6,Hibernating
14692,21,6,857.42,5,1,2,8,Regulars
14693,988,13,1959.67,1,4,4,9,At Risk
14694,798,3,1384.3899999999999,1,1,3,5,Regulars
14695,266,11,1269.96,2,3,3,8,Regulars
14696,187,6,374.31,3,1,1,5,Regulars
14697,236,12,1334.89,3,4,3,10,Regulars
14698,454,10,1528.4099999999999,2,3,3,8,Regulars
14699,212,11,2432.47,3,3,4,10,Big Spenders
14700,86,9,668.18,4,2,1,7,Regulars
14701,4,13,1208.14,5,4,2,11,Loyal
14702,647,9,808.67,1,2,1,4,Hibernating
14703,394,12,4747.71,2,4,5,11,At Risk
14704,426,9,1131.2,2,2,2,6,Hibernating
14705,100,12,3722.6400000000003,4,4,5,13,Champions
14706,84,14,1063.1399999999999,4,5,2,11,Loyal
14707,145,5,2441.51,4,1,4,9,Big Spenders
14708,365,8,1103.22,2,2,2,6,Hibernating
14709,163,9,877.55,3,2,2,7,Regulars
14710,60,8,764.91,5,2,1,8,Regulars
14711,655,4,260.18,1,1,1,3,Hibernating
14712,1097,8,3844.7,1,2,5,8,Regulars
14713,841,12,1622.17,1,4,3,8,At Risk
14714,70,5,1157.81,4,1,2,7,Regulars
14715,405,9,972.21,2,2,2,6,Hibernating
14716,415,18,2178.03,2,5,4,11,At Risk
14717,132,12,892.64,4,4,2,10,Loyal
14718,925,7,1037.2,1,1,2,4,Hibernating
14719,124,12,1286.97,4,4,3,11,Loyal
14720,45,17,1117.6699999999998,5,5,2,12,Loyal
14721,293,6,2327.19,2,1,4,7,Regulars
14722,60,7,1164.8400000000001,5,1,2,8,Regulars
14723,80,6,775.88,4,1,1,6,Regulars
14724,139,14,3273.67,4,5,5,14,Champions
14725,268,6,1100.03,2,1,2,5,Hibernating
14726,518,14,1620.93,1,5,3,9,At Risk
14727,94,10,908.06,4,3,2,9,Loyal
14728,101,10,2641.28,4,3,5,12,Loyal
14729,249,10,1273.55,2,3,3,8,Regulars
14730,124,12,3818.7000000000003,4,4,5,13,Champions
14731,81,8,3323.4199999999996,4,2,5,11,Big Spenders
14732,43,10,2539.46,5,3,4,12,Loyal
14733,1775,2,463.09,1,1,1,3,Hibernating
14734,269,12,1787.01,2,4,4,10,At Risk
14735,27,8,1258.04,5,2,3,10,Regulars
14736,25,6,2491.35,5,1,4,10,Big Spenders
14737,327,7,966.12,2,1,2,5,Hibernating
14738,92,12,1287.93,4,4,3,11,Loyal
14739,14,13,2381.69,5,4,4,13,Champions
14740,118,5,424.90999999999997,4,1,1,6,Regulars
14741,1688,6,1276.8600000000001,1,1,3,5,Regulars
14742,361,6,725.45,2,1,1,4,Hibernating
14743,224,12,1362.42,3,4,3,10,Regulars
14744,329,6,1122.1399999999999,2,1,2,5,Hibernating
14745,227,10,1555.92,3,3,3,9,Regulars
14746,203,7,1356.0700000000002,3,1,3,7,Regulars
14747,93,6,2740.96,4,1,5,10,Big Spenders
14748,285,10,1103.1,2,3,2,7,Regulars
14749,87,8,3425.6099999999997,4,2,5,11,Big Spenders
14750,106,7,2068.4300000000003,4,1,4,9,Big Spenders
14751,73,14,3554.8900000000003,4,5,5,14,Champions
14752,350,9,1690.93,2,2,3,7,Regulars
14753,247,14,4565.69,3,5,5,13,Big Spenders
14754,54,8,913.4200000000001,5,2,2,9,Regulars
14755,139,13,1865.16,4,4,4,12,Champions
14756,187,10,958.0699999999999,3,3,2,8,Regulars
14757,76,13,1805.04,4,4,4,12,Champions
14758,277,9,863.1600000000001,2,2,2,6,Hibernating
14759,852,8,1540.04,1,2,3,6,Regulars
14760,119,17,719.3,4,5,1,10,Loyal
14761,158,14,1255.93,3,5,3,11,Regulars
14762,173,9,780.67,3,2,1,6,Regulars
14763,142,15,1464.52,4,5,3,12,Loyal
14764,111,13,1489.91,4,4,3,11,Loyal
14765,109,7,916.5999999999999,4,1,2,7,Regulars
14766,380,13,2069.39,2,4,4,10,At Risk
14767,1293,6,2849.83,1,1,5,7,Regulars
14768,197,14,2176.26,3,5,4,12,Big Spenders
14769,266,10,1436.92,2,3,3,8,Regulars
14770,156,18,2498.92,3,5,4,12,Big Spenders
14771,22,12,1365.79,5,4,3,12,Loyal
14772,115,9,492.4,4,2,1,7,Regulars
14773,49,12,1234.02,5,4,2,11,Loyal
14774,19,11,3780.2799999999997,5,3,5,13,Loyal
14775,272,12,1411.37,2,4,3,9,At Risk
14776,738,6,391.6,1,1,1,3,Hibernating
14777,67,17,3730.07,4,5,5,14,Champions
14778,463,13,1211.54,1,4,2,7,At Risk
14779,536,11,839.86,1,3,1,5,Regulars
14780,206,10,1676.85,3,3,3,9,Regulars
14781,31,12,2921.3199999999997,5,4,5,14,Champions
14782,186,10,1561.7800000000002,3,3,3,9,Regulars
14783,228,11,1514.58,3,3,3,9,Regulars
14784,147,6,1646.5,4,1,3,8,Regulars
14785,118,9,1332.1399999999999,4,2,3,9,Regulars
14786,103,16,4668.41,4,5,5,14,Champions
14787,220,9,969.19,3,2,2,7,Regulars
14788,406,11,3314.5400000000004,2,3,5,10,Regulars
14789,520,13,1130.44,1,4,2,7,At Risk
14790,44,9,1488.62,5,2,3,10,Regulars
14791,207,10,2952.84,3,3,5,11,Big Spenders
14792,99,10,1873.27,4,3,4,11,Loyal
14793,857,4,762.18,1,1,1,3,Hibernating
14794,184,12,1176.01,3,4,2,9,Regulars
14795,159,12,756.98,3,4,1,8,Regulars
14796,253,8,509.78,2,2,1,5,Hibernating
14797,54,9,1006.66,5,2,2,9,Regulars
14798,48,13,2916.04,5,4,5,14,Champions
14799,20,13,3630.58,5,4,5,14,Champions
14800,278,12,1983.1,2,4,4,10,At Risk
14801,143,9,844.04,4,2,1,7,Regulars
14802,222,6,1084.86,3,1,2,6,Regulars
14803,141,13,2080.56,4,4,4,12,Champions
14804,392,8,732.62,2,2,1,5,Hibernating
14805,104,9,687.59,4,2,1,7,Regulars
14806,56,9,2227.19,5,2,4,11,Big Spenders
14807,248,8,1180.56,2,2,2,6,Hibernating
14808,182,11,1194.54,3,3,2,8,Regulars
14809,221,8,1037.11,3,2,2,7,Regulars
14810,172,14,795.3199999999999,3,5,1,9,Regulars
14811,242,7,678.11,3,1,1,5,Regulars
14812,209,9,2273.76,3,2,4,9,Big Spenders
14813,60,13,2532.48,5,4,4,13,Champions
14814,455,11,653.7900000000001,2,3,1,6,Regulars
14815,210,8,1281.18,3,2,3,8,Regulars
14816,462,9,1272.99,1,2,3,6,Regulars
14817,41,10,471.59,5,3,1,9,Loyal
14818,103,10,1638.6599999999999,4,3,3,10,Loyal
14819,241,13,1870.96,3,4,4,11,Big Spenders
14820,19,10,1353.44,5,3,3,11,Loyal
14821,83,12,1817.0800000000002,4,4,4,12,Champions
14822,286,7,1650.7,2,1,3,6,Regulars
14823,255,9,1766.62,2,2,4,8,Regulars
14824,67,6,1167.91,4,1,2,7,Regulars
14825,76,6,2418.57,4,1,4,9,Big Spenders
14826,544,8,600.06,1,2,1,4,Hibernating
14827,527,10,1786.67,1,3,4,8,Regulars
14828,77,16,2891.7400000000002,4,5,5,14,Champions
14829,377,13,1765.51,2,4,4,10,At Risk
14830,53,7,778.95,5,1,1,7,Regulars
14831,43,12,3019.7599999999998,5,4,5,14,Champions
14832,15,10,1144.1299999999999,5,3,2,10,Loyal
14833,148,13,2473.75,3,4,4,11,Big Spenders
14834,83,11,824.51,4,3,1,8,Loyal
14835,383,15,1640.4099999999999,2,5,3,10,At Risk
14836,116,14,3103.01,4,5,5,14,Champions
14837,121,13,1329.1799999999998,4,4,3,11,Loyal
14838,103,14,1735.6399999999999,4,5,4,13,Champions
14839,426,7,3246.3,2,1,5,8,Regulars
14840,275,14,7089.7,2,5,5,12,At Risk
14841,198,15,2829.61,3,5,5,13,Big Spenders
14842,767,8,960.3199999999999,1,2,2,5,Hibernating
14843,41,7,862.45,5,1,2,8,Regulars
14844,49,17,2737.82,5,5,5,15,Champions
14845,257,10,905.54,2,3,2,7,Regulars
14846,194,11,2400.9500000000003,3,3,4,10,Big Spenders
14847,213,6,848.52,3,1,2,6,Regulars
14848,35,16,1277.46,5,5,3,13,Loyal
14849,646,8,1761.0900000000001,1,2,4,7,Regulars
14850,84,5,1408.15,4,1,3,8,Regulars
14851,127,8,1969.5100000000002,4,2,4,10,Big Spenders
14852,63,6,462.78,5,1,1,7,Regulars
14853,48,11,1227.08,5,3,2,10,Loyal
14854,962,8,1862.14,1,2,4,7,Regulars
14855,19,7,1933.8999999999999,5,1,4,10,Big Spenders
14856,84,12,1555.75,4,4,3,11,Loyal
14857,132,9,1057.27,4,2,2,8,Regulars
14858,219,10,1865.1599999999999,3,3,4,10,Big Spenders
14859,83,15,1516.91,4,5,3,12,Loyal
14860,156,13,2307.5,3,4,4,11,Big Spenders
14861,97,11,1551.81,4,3,3,10,Loyal
14862,271,9,1496.54,2,2,3,7,Regulars
14863,250,12,2450.71,2,4,4,10,At Risk
14864,540,6,1607.33,1,1,3,5,Regulars
14865,392,8,2229.31,2,2,4,8,Regulars
14866,161,12,1577.3799999999999,3,4,3,10,Regulars
14867,154,8,2325.88,3,2,4,9,Big Spenders
14868,46,17,2357.08,5,5,4,14,Champions
14869,14,12,1136.3,5,4,2,11,Loyal
14870,69,7,1193.86,4,1,2,7,Regulars
14871,92,9,1115.69,4,2,2,8,Regulars
14872,153,14,2770.1299999999997,3,5,5,13,Big Spenders
14873,22,11,1105.8,5,3,2,10,Loyal
14874,359,3,614.16,2,1,1,4,Hibernating
14875,491,5,390.42,1,1,1,3,Hibernating
14876,142,17,2719.64,4,5,5,14,Champions
14877,3,11,3496.01,5,3,5,13,Loyal
14878,390,14,1800.6799999999998,2,5,4,11,At Risk
14879,24,11,898.6999999999999,5,3,2,10,Loyal
14880,439,8,1336.52,2,2,3,7,Regulars
14881,36,4,843.21,5,1,1,7,Regulars
14882,86,8,2500.41,4,2,4,10,Big Spenders
14883,4,10,4049.1099999999997,5,3,5,13,Loyal
14884,85,5,311.99,4,1,1,6,Regulars
14885,204,7,661.89,3,1,1,5,Regulars
14886,27,6,1399.5,5,1,3,9,Regulars
14887,587,10,1763.02,1,3,4,8,Regulars
14888,460,13,1846.3799999999999,1,4,4,9,At Risk
14889,302,7,1173.8300000000002,2,1,2,5,Hibernating
14890,497,13,1283.3799999999999,1,4,3,8,At Risk
14891,205,10,5500.76,3,3,5,11,Big Spenders
14892,213,19,2136.75,3,5,4,12,Big Spenders
14893,148,11,1185.34,3,3,2,8,Regulars
14894,69,10,925.49,4,3,2,9,Loyal
14895,37,7,1961.75,5,1,4,10,Big Spenders
14896,100,11,850.2900000000001,4,3,2,9,Loyal
14897,83,12,2253.92,4,4,4,12,Champions
14898,197,11,1817.92,3,3,4,10,Big Spenders
14899,21,7,947.5300000000001,5,1,2,8,Regulars
14900,39,10,1875.15,5,3,4,12,Loyal
14901,221,14,2295.25,3,5,4,12,Big Spenders
14902,387,19,2986.86,2,5,5,12,At Risk
14903,141,12,1003.2,4,4,2,10,Loyal
14904,154,13,1809.46,3,4,4,11,Big Spenders
14905,427,8,1455.54,2,2,3,7,Regulars
14906,529,11,4504.8,1,3,5,9,Regulars
14907,604,6,3059.37,1,1,5,7,Regulars
14908,230,11,1241.43,3,3,3,9,Regulars
14909,110,9,2832.67,4,2,5,11,Big Spenders
14910,195,10,5483.95,3,3,5,11,Big Spenders
14911,297,10,3683.01,2,3,5,10,Regulars
14912,750,8,1334.41,1,2,3,6,Regulars
14913,259,12,2313.3,2,4,4,10,At Risk
14914,19,14,1465.57,5,5,3,13,Loyal
14915,876,8,1356.02,1,2,3,6,Regulars
14916,449,13,4219.28,2,4,5,11,At Risk
14917,296,8,868.5799999999999,2,2,2,6,Hibernating
14918,525,7,708.62,1,1,1,3,Hibernating
14919,526,14,3049.56,1,5,5,11,At Risk
14920,613,12,2019.07,1,4,4,9,At Risk
14921,142,11,1365.55,4,3,3,10,Loyal
14922,414,16,6661.200000000001,2,5,5,12,At Risk
14923,109,13,1636.01,4,4,3,11,Loyal
14924,523,7,666.3399999999999,1,1,1,3,Hibernating
14925,1,12,1424.17,5,4,3,12,Loyal
14926,344,12,1844.74,2,4,4,10,At Risk
14927,445,1,62.77,2,1,1,4,Hibernating
14928,44,22,5239.84,5,5,5,15,Champions
14929,193,10,827.07,3,3,1,7,Regulars
14930,512,12,1136.8799999999999,1,4,2,7,At Risk
14931,427,10,1123.72,2,3,2,7,Regulars
14932,897,3,407.65999999999997,1,1,1,3,Hibernating
14933,74,12,2687.96,4,4,5,13,Champions
14934,20,12,3606.8300000000004,5,4,5,14,Champions
14935,547,14,1558.38,1,5,3,9,At Risk
14936,471,9,1191.4699999999998,1,2,2,5,Hibernating
14937,176,10,1708.94,3,3,3,9,Regulars
14938,93,7,1019.84,4,1,2,7,Regulars
14939,362,8,4072.8300000000004,2,2,5,9,Regulars
14940,458,10,3732.78,2,3,5,10,Regulars
14941,53,9,2191.77,5,2,4,11,Big Spenders
14942,13,10,650.72,5,3,1,9,Loyal
14943,154,12,3678.49,3,4,5,12,Big Spenders
14944,54,11,3223.34,5,3,5,13,Loyal
14945,205,8,2211.12,3,2,4,9,Big Spenders
14946,206,11,1734.99,3,3,4,10,Big Spenders
14947,387,11,3735.51,2,3,5,10,Regulars
14948,13,11,1025.43,5,3,2,10,Loyal
14949,71,13,2450.96,4,4,4,12,Champions
14950,195,6,3094.35,3,1,5,9,Big Spenders
14951,176,11,1517.22,3,3,3,9,Regulars
14952,500,12,1831.63,1,4,4,9,At Risk
14953,72,8,2017.45,4,2,4,10,Big Spenders
14954,229,7,688.58,3,1,1,5,Regulars
14955,16,9,2309.06,5,2,4,11,Big Spenders
14956,334,5,418.4,2,1,1,4,Hibernating
14957,417,10,1431.53,2,3,3,8,Regulars
14958,271,8,1645.16,2,2,3,7,Regulars
14959,138,8,749.5799999999999,4,2,1,7,Regulars
14960,160,10,3018.66,3,3,5,11,Big Spenders
14961,2,13,3100.67,5,4,5,14,Champions
14962,492,7,1126.52,1,1,2,4,Hibernating
14963,166,12,1724.1699999999998,3,4,3,10,Regulars
14964,183,19,1890.8700000000001,3,5,4,12,Big Spenders
14965,236,9,2045.09,3,2,4,9,Big Spenders
14966,284,6,1589.29,2,1,3,6,Regulars
14967,302,8,1924.31,2,2,4,8,Regulars
14968,751,5,524.73,1,1,1,3,Hibernating
14969,462,11,1753.63,1,3,4,8,Regulars
14970,274,20,2050.91,2,5,4,11,At Risk
14971,946,10,1230.15,1,3,2,6,Regulars
14972,84,8,780.49,4,2,1,7,Regulars
14973,252,7,1298.29,2,1,3,6,Regulars
14974,886,4,365.29,1,1,1,3,Hibernating
14975,564,9,925.38,1,2,2,5,Hibernating
14976,201,9,1993.0800000000002,3,2,4,9,Big Spenders
14977,1011,6,694.87,1,1,1,3,Hibernating
14978,284,10,1981.78,2,3,4,9,Regulars
14979,110,10,774.6,4,3,1,8,Loyal
14980,687,9,949.98,1,2,2,5,Hibernating
14981,377,12,1877.35,2,4,4,10,At Risk
14982,204,14,4535.01,3,5,5,13,Big Spenders
14983,165,13,2414.59,3,4,4,11,Big Spenders
14984,146,7,862.73,4,1,2,7,Regulars
14985,428,10,1420.77,2,3,3,8,Regulars
14986,595,6,1100.93,1,1,2,4,Hibernating
14987,56,11,1646.7,5,3,3,11,Loyal
14988,239,13,4236.58,3,4,5,12,Big Spenders
14989,313,16,1770.67,2,5,4,11,At Risk
14990,462,11,1812.04,1,3,4,8,Regulars
14991,933,7,940.6,1,1,2,4,Hibernating
14992,345,6,841.01,2,1,1,4,Hibernating
14993,279,11,1012.11,2,3,2,7,Regulars
14994,154,6,743.73,3,1,1,5,Regulars
14995,90,12,1464.88,4,4,3,11,Loyal
14996,920,11,2432.7999999999997,1,3,4,8,Regulars
14997,160,8,503.29999999999995,3,2,1,6,Regulars
14998,117,19,1950.56,4,5,4,13,Champions
14999,189,12,817.7,3,4,1,8,Regulars
15000,378,7,542.98,2,1,1,4,Hibernating
15001,317,12,1349.75,2,4,3,9,At Risk
15002,90,13,1455.47,4,4,3,11,Loyal
15003,379,7,1008.9599999999999,2,1,2,5,Hibernating
15004,573,14,2275.61,1,5,4,10,At Risk
15005,14,18,3937.58,5,5,5,15,Champions
15006,751,10,2033.48,1,3,4,8,Regulars
15007,36,12,2450.6,5,4,4,13,Champions
15008,429,8,1227.72,2,2,2,6,Hibernating
15009,76,10,2027.67,4,3,4,11,Loyal
15010,214,8,1304.78,3,2,3,8,Regulars
15011,242,7,3606.6499999999996,3,1,5,9,Big Spenders
15012,418,9,2585.1200000000003,2,2,5,9,Regulars
15013,351,9,1744.4599999999998,2,2,4,8,Regulars
15014,335,5,271.22,2,1,1,4,Hibernating
15015,734,7,585.55,1,1,1,3,Hibernating
15016,114,8,2677.12,4,2,5,11,Big Spenders
15017,64,11,2201.58,5,3,4,12,Loyal
15018,436,7,2837.09,2,1,5,8,Regulars
15019,122,13,4437.15,4,4,5,13,Champions
15020,606,12,1382.22,1,4,3,8,At Risk
15021,227,14,1536.03,3,5,3,11,Regulars
15022,234,11,5244.84,3,3,5,11,Big Spenders
15023,536,10,2056.76,1,3,4,8,Regulars
15024,517,13,1302.51,1,4,3,8,At Risk
15025,17,11,2645.1800000000003,5,3,5,13,Loyal
15026,305,16,3396.65,2,5,5,12,At Risk
15027,313,7,745.34,2,1,1,4,Hibernating
15028,224,5,609.8199999999999,3,1,1,5,Regulars
15029,31,6,531.34,5,1,1,7,Regulars
15030,384,9,2764.4599999999996,2,2,5,9,Regulars
15031,763,8,978.39,1,2,2,5,Hibernating
15032,223,10,939.37,3,3,2,8,Regulars
15033,367,14,2091.55,2,5,4,11,At Risk
15034,104,4,189.0,4,1,1,6,Regulars
15035,21,7,336.42,5,1,1,7,Regulars
15036,57,11,2148.17,5,3,4,12,Loyal
15037,76,10,922.94,4,3,2,9,Loyal
15038,104,9,670.52,4,2,1,7,Regulars
15039,322,8,1909.96,2,2,4,8,Regulars
15040,27,13,1601.66,5,4,3,12,Loyal
15041,530,6,513.47,1,1,1,3,Hibernating
15042,47,8,935.25,5,2,2,9,Regulars
15043,119,15,2801.94,4,5,5,14,Champions
15044,175,10,1490.3899999999999,3,3,3,9,Regulars
15045,3,17,2755.45,5,5,5,15,Champions
15046,50,10,870.1800000000001,5,3,2,10,Loyal
15047,167,10,2966.72,3,3,5,11,Big Spenders
15048,52,9,3293.3,5,2,5,12,Big Spenders
15049,444,7,661.88,2,1,1,4,Hibernating
15050,64,10,989.84,5,3,2,10,Loyal
15051,171,11,1051.59,3,3,2,8,Regulars
15052,105,13,3305.0499999999997,4,4,5,13,Champions
15053,142,11,745.66,4,3,1,8,Loyal
15054,1969,3,520.27,1,1,1,3,Hibernating
15055,184,10,1330.15,3,3,3,9,Regulars
15056,379,11,3025.87,2,3,5,10,Regulars
15057,67,12,1831.18,4,4,4,12,Champions
15058,620,7,702.95,1,1,1,3,Hibernating
15059,269,15,1684.42,2,5,3,10,At Risk
15060,495,15,5177.63,1,5,5,11,At Risk
15061,104,14,999.48,4,5,2,11,Loyal
15062,0,11,3151.35,5,3,5,13,Loyal
15063,69,12,2972.01,4,4,5,13,Champions
15064,232,13,3657.83,3,4,5,12,Big Spenders
15065,795,7,1085.89,1,1,2,4,Hibernating
15066,150,9,1575.99,3,2,3,8,Regulars
15067,45,9,957.14,5,2,2,9,Regulars
15068,310,5,546.99,2,1,1,4,Hibernating
15069,75,8,2206.1499999999996,4,2,4,10,Big Spenders
15070,71,15,2725.85,4,5,5,14,Champions
15071,122,15,2255.05,4,5,4,13,Champions
15072,468,14,4444.81,1,5,5,11,At Risk
15073,7,13,1737.64,5,4,4,13,Champions
15074,198,8,2213.06,3,2,4,9,Big Spenders
15075,250,5,254.99,2,1,1,4,Hibernating
15076,4,12,1986.34,5,4,4,13,Champions
15077,306,9,989.0799999999999,2,2,2,6,Hibernating
15078,902,12,3731.67,1,4,5,10,At Risk
15079,35,6,411.8,5,1,1,7,Regulars
15080,210,12,1641.0500000000002,3,4,3,10,Regulars
15081,196,6,1724.03,3,1,3,7,Regulars
15082,345,9,2034.0000000000002,2,2,4,8,Regulars
15083,925,7,534.53,1,1,1,3,Hibernating
15084,28,5,378.1,5,1,1,7,Regulars
15085,211,7,625.55,3,1,1,5,Regulars
15086,61,8,1032.98,5,2,2,9,Regulars
15087,200,8,942.4899999999999,3,2,2,7,Regulars
15088,76,12,2101.8,4,4,4,12,Champions
15089,521,3,641.61,1,1,1,3,Hibernating
15090,48,12,1529.29,5,4,3,12,Loyal
15091,135,11,4561.25,4,3,5,12,Loyal
15092,38,12,1325.0700000000002,5,4,3,12,Loyal
15093,111,11,2433.86,4,3,4,11,Loyal
15094,307,6,780.02,2,1,1,4,Hibernating
15095,7,14,1725.98,5,5,4,14,Champions
15096,0,13,1572.87,5,4,3,12,Loyal
15097,23,5,653.98,5,1,1,7,Regulars
15098,257,8,1532.7,2,2,3,7,Regulars
15099,9,8,1815.33,5,2,4,11,Big Spenders
15100,224,11,1932.5600000000002,3,3,4,10,Big Spenders
15101,399,8,1145.17,2,2,2,6,Hibernating
15102,869,8,530.5500000000001,1,2,1,4,Hibernating
15103,28,12,1490.11,5,4,3,12,Loyal
15104,281,7,2722.73,2,1,5,8,Regulars
15105,44,9,933.6700000000001,5,2,2,9,Regulars
15106,149,11,937.61,3,3,2,8,Regulars
15107,318,11,959.37,2,3,2,7,Regulars
15108,32,13,2437.94,5,4,4,13,Champions
15109,118,9,1088.19,4,2,2,8,Regulars
15110,875,10,2118.51,1,3,4,8,Regulars
15111,460,11,1674.84,1,3,3,7,Regulars
15112,96,14,3771.42,4,5,5,14,Champions
15113,774,11,1698.7800000000002,1,3,3,7,Regulars
15114,243,9,4665.25,3,2,5,10,Big Spenders
15115,156,6,561.66,3,1,1,5,Regulars
15116,64,15,3173.58,5,5,5,15,Champions
15117,147,6,434.25,4,1,1,6,Regulars
15118,171,10,1022.6,3,3,2,8,Regulars
15119,114,12,3270.92,4,4,5,13,Champions
15120,209,8,2041.39,3,2,4,9,Big Spenders
15121,194,10,2472.0,3,3,4,10,Big Spenders
15122,398,6,672.69,2,1,1,4,Hibernating
15123,139,7,2561.31,4,1,4,9,Big Spenders
15124,675,11,1200.75,1,3,2,6,Regulars
15125,382,9,612.44,2,2,1,5,Hibernating
15126,119,7,996.8,4,1,2,7,Regulars
15127,459,8,572.64,2,2,1,5,Hibernating
15128,54,11,5234.0,5,3,5,13,Loyal
15129,503,3,179.06,1,1,1,3,Hibernating
15130,102,15,3241.75,4,5,5,14,Champions
15131,31,13,1149.21,5,4,2,11,Loyal
15132,90,11,2390.02,4,3,4,11,Loyal
15133,6,9,1072.31,5,2,2,9,Regulars
15134,40,9,2564.06,5,2,4,11,Big Spenders
15135,426,15,2347.2200000000003,2,5,4,11,At Risk
15136,73,11,2102.28,4,3,4,11,Loyal
15137,639,13,1481.99,1,4,3,8,At Risk
15138,376,10,1510.59,2,3,3,8,Regulars
15139,13,11,1715.03,5,3,3,11,Loyal
15140,512,7,901.27,1,1,2,4,Hibernating
15141,85,18,2631.6400000000003,4,5,5,14,Champions
15142,361,12,1572.03,2,4,3,9,At Risk
15143,104,5,1270.37,4,1,3,8,Regulars
15144,25,7,1047.12,5,1,2,8,Regulars
15145,24,10,2092.8099999999995,5,3,4,12,Loyal
15146,305,11,2730.9,2,3,5,10,Regulars
15147,238,10,3130.29,3,3,5,11,Big Spenders
15148,306,12,2323.4700000000003,2,4,4,10,At Risk
15149,97,14,1514.96,4,5,3,12,Loyal
15150,239,16,1141.28,3,5,2,10,Regulars
15151,204,11,746.77,3,3,1,7,Regulars
15152,2,9,1701.0,5,2,3,10,Regulars
15153,345,8,596.46,2,2,1,5,Hibernating
15154,483,8,592.15,1,2,1,4,Hibernating
15155,75,12,2162.2,4,4,4,12,Champions
15156,41,5,222.47,5,1,1,7,Regulars
15157,298,12,2385.0899999999997,2,4,4,10,At Risk
15158,0,10,790.42,5,3,1,9,Loyal
15159,469,5,2765.75,1,1,5,7,Regulars
15160,89,8,611.9399999999999,4,2,1,7,Regulars
15161,19,7,3075.14,5,1,5,11,Big Spenders
15162,441,11,1980.8200000000002,2,3,4,9,Regulars
15163,222,10,1825.37,3,3,4,10,Big Spenders
15164,50,16,1781.13,5,5,4,14,Champions
15165,124,9,484.93,4,2,1,7,Regulars
15166,326,14,2289.81,2,5,4,11,At Risk
15167,180,6,1420.73,3,1,3,7,Regulars
15168,300,9,1952.56,2,2,4,8,Regulars
15169,148,15,1946.1599999999999,3,5,4,12,Big Spenders
15170,100,10,1310.6399999999999,4,3,3,10,Loyal
15171,1038,9,1087.97,1,2,2,5,Hibernating
15172,201,12,720.45,3,4,1,8,Regulars
15173,1021,8,2050.09,1,2,4,7,Regulars
15174,187,13,2475.51,3,4,4,11,Big Spenders
15175,386,5,573.91,2,1,1,4,Hibernating
15176,194,13,3258.46,3,4,5,12,Big Spenders
15177,176,11,3199.91,3,3,5,11,Big Spenders
15178,594,6,355.6,1,1,1,3,Hibernating
15179,9,12,938.15,5,4,2,11,Loyal
15180,392,11,2932.91,2,3,5,10,Regulars
15181,125,14,1235.3899999999999,4,5,2,11,Loyal
15182,139,8,355.03,4,2,1,7,Regulars
15183,82,15,1600.69,4,5,3,12,Loyal
15184,171,14,1375.47,3,5,3,11,Regulars
15185,70,6,1019.1600000000001,4,1,2,7,Regulars
15186,8,13,1564.3799999999999,5,4,3,12,Loyal
15187,600,8,957.97,1,2,2,5,Hibernating
15188,261,9,650.3,2,2,1,5,Hibernating
15189,72,17,1742.37,4,5,4,13,Champions
15190,573,10,752.8299999999999,1,3,1,5,Regulars
15191,506,9,973.03,1,2,2,5,Hibernating
15192,147,12,2880.78,4,4,5,13,Champions
15193,188,12,1560.79,3,4,3,10,Regulars
15194,345,7,1703.83,2,1,3,6,Regulars
15195,141,11,4190.59,4,3,5,12,Loyal
15196,1257,6,1470.94,1,1,3,5,Regulars
15197,267,9,4146.82,2,2,5,9,Regulars
15198,420,14,1933.9,2,5,4,11,At Risk
15199,61,7,1233.1399999999999,5,1,2,8,Regulars
15200,16,16,3275.62,5,5,5,15,Champions
15201,133,12,1218.83,4,4,2,10,Loyal
15202,388,7,1124.28,2,1,2,5,Hibernating
15203,248,11,1505.5,2,3,3,8,Regulars
15204,21,8,1124.03,5,2,2,9,Regulars
15205,89,5,1474.24,4,1,3,8,Regulars
15206,908,4,134.81,1,1,1,3,Hibernating
15207,103,7,1218.02,4,1,2,7,Regulars
15208,258,12,4258.549999999999,2,4,5,11,At Risk
15209,208,9,1216.8999999999999,3,2,2,7,Regulars
15210,139,8,800.42,4,2,1,7,Regulars
15211,129,14,1330.77,4,5,3,12,Loyal
15212,185,4,2131.3700000000003,3,1,4,8,Big Spenders
15213,33,12,1751.11,5,4,4,13,Champions
15214,383,9,870.53,2,2,2,6,Hibernating
15215,236,8,1176.48,3,2,2,7,Regulars
15216,364,13,3034.75,2,4,5,11,At Risk
15217,151,19,1947.3,3,5,4,12,Big Spenders
15218,238,8,368.93,3,2,1,6,Regulars
15219,164,18,1600.53,3,5,3,11,Regulars
15220,119,10,1987.01,4,3,4,11,Loyal
15221,224,6,659.8399999999999,3,1,1,5,Regulars
15222,347,8,2960.33,2,2,5,9,Regulars
15223,656,12,2965.58,1,4,5,10,At Risk
15224,366,15,3598.55,2,5,5,12,At Risk
15225,16,11,1742.33,5,3,4,12,Loyal
15226,288,8,941.33,2,2,2,6,Hibernating
15227,514,9,791.9,1,2,1,4,Hibernating
15228,89,6,473.34000000000003,4,1,1,6,Regulars
15229,1264,6,1055.04,1,1,2,4,Hibernating
15230,56,15,1136.15,5,5,2,12,Loyal
15231,226,11,2897.52,3,3,5,11,Big Spenders
15232,245,15,1117.01,3,5,2,10,Regulars
15233,111,13,3909.9900000000002,4,4,5,13,Champions
15234,127,12,888.62,4,4,2,10,Loyal
15235,165,16,2766.61,3,5,5,13,Big Spenders
15236,5,16,873.39,5,5,2,12,Loyal
15237,85,14,4257.65,4,5,5,14,Champions
15238,155,9,838.7900000000001,3,2,1,6,Regulars
15239,379,12,2374.1800000000003,2,4,4,10,At Risk
15240,6,10,2885.8,5,3,5,13,Loyal
15241,79,14,2286.6,4,5,4,13,Champions
15242,745,5,250.65,1,1,1,3,Hibernating
15243,237,8,3100.33,3,2,5,10,Big Spenders
15244,244,9,1345.52,3,2,3,8,Regulars
15245,512,9,1100.92,1,2,2,5,Hibernating
15246,562,8,544.15,1,2,1,4,Hibernating
15247,247,9,1366.1499999999999,3,2,3,8,Regulars
15248,348,10,1126.53,2,3,2,7,Regulars
15249,397,8,983.22,2,2,2,6,Hibernating
15250,296,6,589.83,2,1,1,4,Hibernating
15251,72,10,3463.4799999999996,4,3,5,12,Loyal
15252,42,15,1874.88,5,5,4,14,Champions
15253,207,11,2176.55,3,3,4,10,Big Spenders
15254,155,15,754.4599999999999,3,5,1,9,Regulars
15255,9,15,3098.6099999999997,5,5,5,15,Champions
15256,188,10,1402.1,3,3,3,9,Regulars
15257,14,12,2277.86,5,4,4,13,Champions
15258,130,10,822.6800000000001,4,3,1,8,Loyal
15259,97,12,1842.9099999999999,4,4,4,12,Champions
15260,207,8,505.11,3,2,1,6,Regulars
15261,421,8,550.52,2,2,1,5,Hibernating
15262,278,13,1364.1000000000001,2,4,3,9,At Risk
15263,28,12,2664.24,5,4,5,14,Champions
15264,443,7,1972.08,2,1,4,7,Regulars
15265,2,12,1105.75,5,4,2,11,Loyal
15266,138,12,764.9,4,4,1,9,Loyal
15267,71,8,462.0,4,2,1,7,Regulars
15268,3,12,2452.94,5,4,4,13,Champions
15269,21,10,3367.08,5,3,5,13,Loyal
15270,101,10,516.27,4,3,1,8,Loyal
15271,408,8,531.4300000000001,2,2,1,5,Hibernating
15272,88,8,1398.19,4,2,3,9,Regulars
15273,344,8,1141.14,2,2,2,6,Hibernating
15274,252,8,731.33,2,2,1,5,Hibernating
15275,286,14,3348.41,2,5,5,12,At Risk
15276,19,15,3815.21,5,5,5,15,Champions
15277,66,7,1130.8899999999999,4,1,2,7,Regulars
15278,418,6,1394.91,2,1,3,6,Regulars
15279,943,7,657.98,1,1,1,3,Hibernating
15280,147,13,2050.3,4,4,4,12,Champions
15281,89,7,1162.44,4,1,2,7,Regulars
15282,852,12,2394.03,1,4,4,9,At Risk
15283,17,8,2267.29,5,2,4,11,Big Spenders
15284,484,6,2077.85,1,1,4,6,Regulars
15285,169,10,716.0600000000001,3,3,1,7,Regulars
15286,432,8,1005.3299999999999,2,2,2,6,Hibernating
15287,98,16,3262.39,4,5,5,14,Champions
15288,64,7,908.5199999999999,5,1,2,8,Regulars
15289,309,6,863.7900000000001,2,1,2,5,Hibernating
15290,243,16,1766.46,3,5,4,12,Big Spenders
15291,257,10,2370.64,2,3,4,9,Regulars
15292,89,9,1129.32,4,2,2,8,Regulars
15293,223,10,2341.0899999999997,3,3,4,10,Big Spenders
15294,176,8,1002.75,3,2,2,7,Regulars
15295,794,10,1155.78,1,3,2,6,Regulars
15296,862,7,770.02,1,1,1,3,Hibernating
15297,228,11,3011.34,3,3,5,11,Big Spenders
15298,246,5,689.09,3,1,1,5,Regulars
15299,163,9,1451.81,3,2,3,8,Regulars
15300,417,2,100.97999999999999,2,1,1,4,Hibernating
15301,43,19,1989.27,5,5,4,14,Champions
15302,455,7,3268.19,2,1,5,8,Regulars
15303,189,7,964.4599999999999,3,1,2,6,Regulars
15304,225,11,2849.9500000000003,3,3,5,11,Big Spenders
15305,35,8,1527.38,5,2,3,10,Regulars
15306,44,10,1517.0099999999998,5,3,3,11,Loyal
15307,253,11,1152.79,2,3,2,7,Regulars
15308,11,17,2688.95,5,5,5,15,Champions
15309,45,10,699.79,5,3,1,9,Loyal
15310,372,10,2371.47,2,3,4,9,Regulars
15311,240,17,3239.7400000000002,3,5,5,13,Big Spenders
15312,99,12,1003.63,4,4,2,10,Loyal
15313,363,6,629.49,2,1,1,4,Hibernating
15314,869,11,2186.23,1,3,4,8,Regulars
15315,244,11,830.04,3,3,1,7,Regulars
15316,11,12,960.8100000000001,5,4,2,11,Loyal
15317,130,11,3558.83,4,3,5,12,Loyal
15318,333,9,4030.76,2,2,5,9,Regulars
15319,543,11,1974.06,1,3,4,8,Regulars
15320,127,8,1282.4,4,2,3,9,Regulars
15321,213,13,4606.3,3,4,5,12,Big Spenders
15322,497,11,1030.45,1,3,2,6,Regulars
15323,611,6,845.9900000000001,1,1,2,4,Hibernating
15324,20,9,833.5699999999999,5,2,1,8,Regulars
15325,101,7,925.91,4,1,2,7,Regulars
15326,201,6,468.16999999999996,3,1,1,5,Regulars
15327,23,16,2139.79,5,5,4,14,Champions
15328,85,19,5012.65,4,5,5,14,Champions
15329,495,10,1379.31,1,3,3,7,Regulars
15330,1008,9,588.84,1,2,1,4,Hibernating
15331,1200,6,552.78,1,1,1,3,Hibernating
15332,241,7,763.12,3,1,1,5,Regulars
15333,532,11,2194.81,1,3,4,8,Regulars
15334,8,11,1180.0,5,3,2,10,Loyal
15335,67,10,1885.03,4,3,4,11,Loyal
15336,103,11,2254.75,4,3,4,11,Loyal
15337,382,10,1158.22,2,3,2,7,Regulars
15338,424,5,711.56,2,1,1,4,Hibernating
15339,367,13,1469.2499999999998,2,4,3,9,At Risk
15340,90,13,3899.1,4,4,5,13,Champions
15341,665,12,1480.94,1,4,3,8,At Risk
15342,1329,8,2328.13,1,2,4,7,Regulars
15343,213,10,2778.2000000000003,3,3,5,11,Big Spenders
15344,609,8,1889.45,1,2,4,7,Regulars
15345,1124,6,1199.73,1,1,2,4,Hibernating
15346,1590,4,622.6899999999999,1,1,1,3,Hibernating
15347,286,8,924.4200000000001,2,2,2,6,Hibernating
15348,94,10,1055.54,4,3,2,9,Loyal
15349,109,11,1137.04,4,3,2,9,Loyal
15350,240,9,642.25,3,2,1,6,Regulars
15351,22,11,1527.1100000000001,5,3,3,11,Loyal
15352,490,11,1116.52,1,3,2,6,Regulars
15353,51,9,710.87,5,2,1,8,Regulars
15354,545,8,2287.62,1,2,4,7,Regulars
15355,344,9,1147.52,2,2,2,6,Hibernating
15356,255,12,1331.17,2,4,3,9,At Risk
15357,89,9,892.0999999999999,4,2,2,8,Regulars
15358,811,7,824.03,1,1,1,3,Hibernating
15359,325,6,694.12,2,1,1,4,Hibernating
15360,42,9,662.12,5,2,1,8,Regulars
15361,711,10,2487.06,1,3,4,8,Regulars
15362,1203,4,1151.8999999999999,1,1,2,4,Hibernating
15363,274,9,4723.240000000001,2,2,5,9,Regulars
15364,420,10,737.21,2,3,1,6,Regulars
15365,48,14,3025.67,5,5,5,15,Champions
15366,22,16,1479.55,5,5,3,13,Loyal
15367,489,9,2059.31,1,2,4,7,Regulars
15368,20,5,697.75,5,1,1,7,Regulars
15369,241,11,1721.57,3,3,3,9,Regulars
15370,73,11,1038.31,4,3,2,9,Loyal
15371,153,13,1470.56,3,4,3,10,Regulars
15372,57,13,2929.31,5,4,5,14,Champions
15373,127,8,972.0699999999999,4,2,2,8,Regulars
15374,107,8,1372.32,4,2,3,9,Regulars
15375,405,7,1006.13,2,1,2,5,Hibernating
15376,202,9,2398.12,3,2,4,9,Big Spenders
15377,201,13,3760.52,3,4,5,12,Big Spenders
15378,109,11,3953.25,4,3,5,12,Loyal
15379,546,12,2102.04,1,4,4,9,At Risk
15380,167,13,1433.5,3,4,3,10,Regulars
15381,272,15,3312.65,2,5,5,12,At Risk
15382,147,10,5465.9400000000005,4,3,5,12,Loyal
15383,75,11,838.97,4,3,1,8,Loyal
15384,444,9,1206.24,2,2,2,6,Hibernating
15385,340,5,676.43,2,1,1,4,Hibernating
15386,63,11,1199.74,5,3,2,10,Loyal
15387,96,6,601.89,4,1,1,6,Regulars
15388,54,6,2053.2999999999997,5,1,4,10,Big Spenders
15389,610,6,1172.44,1,1,2,4,Hibernating
15390,209,9,938.88,3,2,2,7,Regulars
15391,280,17,2236.47,2,5,4,11,At Risk
15392,8,13,1794.71,5,4,4,13,Champions
15393,211,9,1611.41,3,2,3,8,Regulars
15394,100,10,1640.27,4,3,3,10,Loyal
15395,161,12,2765.06,3,4,5,12,Big Spenders
15396,160,10,1414.3400000000001,3,3,3,9,Regulars
15397,56,8,733.1,5,2,1,8,Regulars
15398,253,11,2407.46,2,3,4,9,Regulars
15399,15,9,1283.8,5,2,3,10,Regulars
15400,190,13,907.8,3,4,2,9,Regulars
15401,200,8,2311.35,3,2,4,9,Big Spenders
15402,817,6,609.29,1,1,1,3,Hibernating
15403,305,6,511.83000000000004,2,1,1,4,Hibernating
15404,186,12,1142.66,3,4,2,9,Regulars
15405,56,6,305.43,5,1,1,7,Regulars
15406,8,12,2678.63,5,4,5,14,Champions
15407,287,14,2014.8600000000001,2,5,4,11,At Risk
15408,121,15,2150.19,4,5,4,13,Champions
15409,213,7,1604.79,3,1,3,7,Regulars
15410,1957,6,787.65,1,1,1,3,Hibernating
15411,707,7,810.63,1,1,1,3,Hibernating
15412,185,9,863.0,3,2,2,7,Regulars
15413,464,7,729.3000000000001,1,1,1,3,Hibernating
15414,0,10,2125.59,5,3,4,12,Loyal
15415,661,9,1287.08,1,2,3,6,Regulars
15416,292,11,1199.6,2,3,2,7,Regulars
15417,188,13,2640.52,3,4,5,12,Big Spenders
15418,38,10,1023.79,5,3,2,10,Loyal
15419,78,11,1558.24,4,3,3,10,Loyal
15420,203,4,282.41999999999996,3,1,1,5,Regulars
15421,309,8,1218.54,2,2,2,6,Hibernating
15422,16,9,1430.58,5,2,3,10,Regulars
15423,664,10,447.59999999999997,1,3,1,5,Regulars
15424,40,9,1505.3,5,2,3,10,Regulars
15425,91,12,1767.6399999999999,4,4,4,12,Champions
15426,169,15,3283.6400000000003,3,5,5,13,Big Spenders
15427,620,6,885.02,1,1,2,4,Hibernating
15428,932,6,359.83,1,1,1,3,Hibernating
15429,1338,6,247.91,1,1,1,3,Hibernating
15430,45,8,1322.69,5,2,3,10,Regulars
15431,166,14,1726.68,3,5,4,12,Big Spenders
15432,288,5,641.9200000000001,2,1,1,4,Hibernating
15433,201,11,1865.84,3,3,4,10,Big Spenders
15434,100,8,824.15,4,2,1,7,Regulars
15435,108,10,4961.32,4,3,5,12,Loyal
15436,145,10,1269.56,4,3,3,10,Loyal
15437,593,13,1217.44,1,4,2,7,At Risk
15438,242,11,568.8800000000001,3,3,1,7,Regulars
15439,289,7,3478.48,2,1,5,8,Regulars
15440,419,13,3758.05,2,4,5,11,At Risk
15441,414,12,1569.2499999999998,2,4,3,9,At Risk
15442,155,8,2952.33,3,2,5,10,Big Spenders
15443,22,9,1838.1499999999999,5,2,4,11,Big Spenders
15444,379,11,1392.47,2,3,3,8,Regulars
15445,78,9,381.95,4,2,1,7,Regulars
15446,182,12,1214.44,3,4,2,9,Regulars
15447,68,12,1493.2800000000002,4,4,3,11,Loyal
15448,110,6,483.37,4,1,1,6,Regulars
15449,320,9,689.08,2,2,1,5,Hibernating
15450,67,7,3227.21,4,1,5,10,Big Spenders
15451,5,16,1285.65,5,5,3,13,Loyal
15452,599,11,1288.22,1,3,3,7,Regulars
15453,246,7,532.48,3,1,1,5,Regulars
15454,161,13,1158.6,3,4,2,9,Regulars
15455,635,13,1217.04,1,4,2,7,At Risk
15456,639,10,2638.33,1,3,5,9,Regulars
15457,23,7,4035.24,5,1,5,11,Big Spenders
15458,0,17,6818.05,5,5,5,15,Champions
15459,57,11,1986.69,5,3,4,12,Loyal
15460,935,4,434.21000000000004,1,1,1,3,Hibernating
15461,802,9,463.21999999999997,1,2,1,4,Hibernating
15462,91,11,1948.03,4,3,4,11,Loyal
15463,29,13,1512.04,5,4,3,12,Loyal
15464,578,7,1882.73,1,1,4,6,Regulars
15465,830,5,1272.77,1,1,3,5,Regulars
15466,116,8,994.22,4,2,2,8,Regulars
15467,110,14,3122.81,4,5,5,14,Champions
15468,131,10,723.37,4,3,1,8,Loyal
15469,0,8,807.68,5,2,1,8,Regulars
15470,506,8,1208.55,1,2,2,5,Hibernating
15471,31,15,4157.34,5,5,5,15,Champions
15472,1118,7,933.19,1,1,2,4,Hibernating
15473,22,12,2926.4,5,4,5,14,Champions
15474,296,10,896.19,2,3,2,7,Regulars
15475,97,14,2253.11,4,5,4,13,Champions
15476,75,13,4338.08,4,4,5,13,Champions
15477,213,10,1523.3,3,3,3,9,Regulars
15478,654,9,1271.08,1,2,3,6,Regulars
15479,361,12,1516.33,2,4,3,9,At Risk
15480,14,7,4360.120000000001,5,1,5,11,Big Spenders
15481,82,11,1549.85,4,3,3,10,Loyal
15482,142,13,3099.92,4,4,5,13,Champions
15483,407,10,1807.73,2,3,4,9,Regulars
15484,608,6,667.69,1,1,1,3,Hibernating
15485,10,10,2971.1000000000004,5,3,5,13,Loyal
15486,167,11,1232.67,3,3,2,8,Regulars
15487,350,4,309.39,2,1,1,4,Hibernating
15488,69,11,1134.52,4,3,2,9,Loyal
15489,75,10,1069.78,4,3,2,9,Loyal
15490,219,12,1783.41,3,4,4,11,Big Spenders
15491,83,11,1335.61,4,3,3,10,Loyal
15492,118,16,1588.19,4,5,3,12,Loyal
15493,453,9,1509.47,2,2,3,7,Regulars
15494,296,9,1089.69,2,2,2,6,Hibernating
15495,454,9,1043.5,2,2,2,6,Hibernating
15496,22,17,2556.97,5,5,4,14,Champions
15497,195,8,803.24,3,2,1,6,Regulars
15498,4,14,1132.52,5,5,2,12,Loyal
15499,1985,2,15.09,1,1,1,3,Hibernating
15500,65,12,1258.7,5,4,3,12,Loyal
15501,12,7,571.17,5,1,1,7,Regulars
15502,228,8,1020.2800000000001,3,2,2,7,Regulars
15503,861,7,170.79999999999998,1,1,1,3,Hibernating
15504,20,10,1618.12,5,3,3,11,Loyal
15505,401,10,1698.82,2,3,3,8,Regulars
15506,394,13,4536.59,2,4,5,11,At Risk
15507,54,7,3519.6400000000003,5,1,5,11,Big Spenders
15508,239,11,2293.2799999999997,3,3,4,10,Big Spenders
15509,1537,8,370.38,1,2,1,4,Hibernating
15510,479,6,669.05,1,1,1,3,Hibernating
15511,96,12,1560.13,4,4,3,11,Loyal
15512,130,9,784.8199999999999,4,2,1,7,Regulars
15513,20,10,843.22,5,3,1,9,Loyal
15514,90,19,4225.98,4,5,5,14,Champions
15515,170,8,2790.01,3,2,5,10,Big Spenders
15516,239,12,1954.29,3,4,4,11,Big Spenders
15517,364,5,605.9300000000001,2,1,1,4,Hibernating
15518,431,5,301.7,2,1,1,4,Hibernating
15519,676,8,1013.2600000000001,1,2,2,5,Hibernating
15520,1015,6,1031.15,1,1,2,4,Hibernating
15521,164,13,2692.3500000000004,3,4,5,12,Big Spenders
15522,331,10,2095.37,2,3,4,9,Regulars
15523,283,16,4937.280000000001,2,5,5,12,At Risk
15524,156,13,1198.29,3,4,2,9,Regulars
15525,215,9,2101.96,3,2,4,9,Big Spenders
15526,181,7,374.84,3,1,1,5,Regulars
15527,227,8,1053.77,3,2,2,7,Regulars
15528,159,10,2710.5,3,3,5,11,Big Spenders
15529,30,10,3178.75,5,3,5,13,Loyal
15530,357,10,562.4399999999999,2,3,1,6,Regulars
15531,152,8,852.75,3,2,2,7,Regulars
15532,30,15,1647.56,5,5,3,13,Loyal
15533,0,13,3317.5800000000004,5,4,5,14,Champions
15534,328,5,2837.0699999999997,2,1,5,8,Regulars
15535,261,9,1113.8,2,2,2,6,Hibernating
15536,110,14,6169.41,4,5,5,14,Champions
15537,108,11,1972.04,4,3,4,11,Loyal
15538,73,15,3447.02,4,5,5,14,Champions
15539,165,10,813.5899999999999,3,3,1,7,Regulars
15540,600,11,1279.79,1,3,3,7,Regulars
15541,668,8,1163.53,1,2,2,5,Hibernating
15542,204,9,2531.72,3,2,4,9,Big Spenders
15543,868,8,680.87,1,2,1,4,Hibernating
15544,268,9,587.1700000000001,2,2,1,5,Hibernating
15545,125,6,730.8599999999999,4,1,1,6,Regulars
15546,238,11,1117.6399999999999,3,3,2,8,Regulars
15547,187,8,851.27,3,2,2,7,Regulars
15548,320,6,1424.42,2,1,3,6,Regulars
15549,222,14,3460.31,3,5,5,13,Big Spenders
15550,417,11,1255.69,2,3,3,8,Regulars
15551,43,10,2547.92,5,3,4,12,Loyal
15552,415,9,804.65,2,2,1,5,Hibernating
15553,233,12,1652.15,3,4,3,10,Regulars
15554,46,11,824.88,5,3,1,9,Loyal
15555,141,8,1203.4099999999999,4,2,2,8,Regulars
15556,55,13,2239.04,5,4,4,13,Champions
15557,144,5,1496.54,4,1,3,8,Regulars
15558,800,10,1715.02,1,3,3,7,Regulars
15559,2,10,2660.5,5,3,5,13,Loyal
15560,121,11,1835.55,4,3,4,11,Loyal
15561,40,13,1663.67,5,4,3,12,Loyal
15562,184,8,1777.46,3,2,4,9,Big Spenders
15563,42,14,1713.98,5,5,3,13,Loyal
15564,59,7,2248.23,5,1,4,10,Big Spenders
15565,351,14,1338.53,2,5,3,10,At Risk
15566,623,9,1053.8899999999999,1,2,2,5,Hibernating
15567,42,8,796.65,5,2,1,8,Regulars
15568,174,3,207.62,3,1,1,5,Regulars
15569,56,8,688.56,5,2,1,8,Regulars
15570,75,7,1485.23,4,1,3,8,Regulars
15571,2,7,786.9399999999999,5,1,1,7,Regulars
15572,48,10,698.2,5,3,1,9,Loyal
15573,1467,7,984.44,1,1,2,4,Hibernating
15574,327,6,410.8,2,1,1,4,Hibernating
15575,207,12,2247.91,3,4,4,11,Big Spenders
15576,79,14,4354.42,4,5,5,14,Champions
15577,439,5,311.83,2,1,1,4,Hibernating
15578,60,9,2199.0299999999997,5,2,4,11,Big Spenders
15579,199,9,3393.63,3,2,5,10,Big Spenders
15580,1,9,4849.21,5,2,5,12,Big Spenders
15581,375,11,1512.67,2,3,3,8,Regulars
15582,113,13,1121.66,4,4,2,10,Loyal
15583,365,6,890.77,2,1,2,5,Hibernating
15584,141,15,1852.5,4,5,4,13,Champions
15585,207,14,1173.53,3,5,2,10,Regulars
15586,290,6,1749.57,2,1,4,7,Regulars
15587,547,5,470.67,1,1,1,3,Hibernating
15588,67,7,4627.94,4,1,5,10,Big Spenders
15589,134,8,1614.44,4,2,3,9,Regulars
15590,5,15,2788.48,5,5,5,15,Champions
15591,1049,11,3538.1,1,3,5,9,Regulars
15592,683,12,2683.99,1,4,5,10,At Risk
15593,39,11,980.5600000000001,5,3,2,10,Loyal
15594,267,9,1377.37,2,2,3,7,Regulars
15595,559,9,2209.63,1,2,4,7,Regulars
15596,29,9,2662.97,5,2,5,12,Big Spenders
15597,194,14,3451.71,3,5,5,13,Big Spenders
15598,46,9,1627.0,5,2,3,10,Regulars
15599,205,13,2973.39,3,4,5,12,Big Spenders
15600,48,16,2211.81,5,5,4,14,Champions
15601,792,8,3653.59,1,2,5,8,Regulars
15602,39,9,701.8,5,2,1,8,Regulars
15603,4,12,994.93,5,4,2,11,Loyal
15604,699,4,1225.83,1,1,2,4,Hibernating
15605,522,8,437.33000000000004,1,2,1,4,Hibernating
15606,8,18,2976.65,5,5,5,15,Champions
15607,1228,12,1916.87,1,4,4,9,At Risk
15608,96,9,2837.7,4,2,5,11,Big Spenders
15609,160,15,1385.45,3,5,3,11,Regulars
15610,318,12,1134.8899999999999,2,4,2,8,At Risk
15611,933,10,2316.79,1,3,4,8,Regulars
15612,665,7,2955.3599999999997,1,1,5,7,Regulars
15613,36,8,615.21,5,2,1,8,Regulars
15614,153,6,1450.56,3,1,3,7,Regulars
15615,302,10,1447.43,2,3,3,8,Regulars
15616,101,14,2486.5600000000004,4,5,4,13,Champions
15617,38,7,2165.32,5,1,4,10,Big Spenders
15618,63,15,1734.31,5,5,4,14,Champions
15619,68,12,2462.0,4,4,4,12,Champions
15620,95,10,3059.51,4,3,5,12,Loyal
15621,659,8,1167.1299999999999,1,2,2,5,Hibernating
15622,369,10,1194.46,2,3,2,7,Regulars
15623,687,14,2056.0,1,5,4,10,At Risk
15624,277,10,1408.81,2,3,3,8,Regulars
15625,217,12,2526.35,3,4,4,11,Big Spenders
15626,196,9,1306.96,3,2,3,8,Regulars
15627,24,11,4122.12,5,3,5,13,Loyal
15628,186,9,911.61,3,2,2,7,Regulars
15629,250,9,561.33,2,2,1,5,Hibernating
15630,410,8,1035.95,2,2,2,6,Hibernating
15631,400,14,1161.71,2,5,2,9,At Risk
15632,401,12,1330.7,2,4,3,9,At Risk
15633,0,10,1214.72,5,3,2,10,Loyal
15634,158,14,1676.04,3,5,3,11,Regulars
15635,252,10,2419.95,2,3,4,9,Regulars
15636,515,7,480.6,1,1,1,3,Hibernating
15637,323,12,3323.7299999999996,2,4,5,11,At Risk
15638,271,9,1154.21,2,2,2,6,Hibernating
15639,600,8,914.96,1,2,2,5,Hibernating
15640,183,11,4201.05,3,3,5,11,Big Spenders
15641,56,5,1474.01,5,1,3,9,Regulars
15642,6,11,1760.55,5,3,4,12,Loyal
15643,485,5,288.81,1,1,1,3,Hibernating
15644,138,8,514.31,4,2,1,7,Regulars
15645,268,11,933.74,2,3,2,7,Regulars
15646,107,10,1214.78,4,3,2,9,Loyal
15647,62,13,1546.82,5,4,3,12,Loyal
15648,142,12,950.66,4,4,2,10,Loyal
15649,191,9,737.05,3,2,1,6,Regulars
15650,33,9,965.1,5,2,2,9,Regulars
15651,360,18,1211.3899999999999,2,5,2,9,At Risk
15652,52,10,1145.81,5,3,2,10,Loyal
15653,130,8,1466.7,4,2,3,9,Regulars
15654,542,11,1340.93,1,3,3,7,Regulars
15655,41,14,1559.12,5,5,3,13,Loyal
15656,127,14,630.99,4,5,1,10,Loyal
15657,189,12,1513.3,3,4,3,10,Regulars
15658,514,7,3919.6499999999996,1,1,5,7,Regulars
15659,799,11,762.33,1,3,1,5,Regulars
15660,853,13,1951.47,1,4,4,9,At Risk
15661,31,11,3451.35,5,3,5,13,Loyal
15662,236,15,1817.97,3,5,4,12,Big Spenders
15663,165,7,609.83,3,1,1,5,Regulars
15664,23,8,3283.12,5,2,5,12,Big Spenders
15665,321,8,2564.7299999999996,2,2,4,8,Regulars
15666,361,8,917.7,2,2,2,6,Hibernating
15667,383,6,1842.1,2,1,4,7,Regulars
15668,172,11,1713.6599999999999,3,3,3,9,Regulars
15669,175,5,2139.87,3,1,4,8,Big Spenders
15670,168,10,2929.09,3,3,5,11,Big Spenders
15671,248,7,1410.48,2,1,3,6,Regulars
15672,209,20,6415.799999999999,3,5,5,13,Big Spenders
15673,25,16,2191.99,5,5,4,14,Champions
15674,96,9,1299.8700000000001,4,2,3,9,Regulars
15675,259,11,2963.37,2,3,5,10,Regulars
15676,68,10,921.81,4,3,2,9,Loyal
15677,187,11,1073.69,3,3,2,8,Regulars
15678,625,16,4370.92,1,5,5,11,At Risk
15679,949,5,365.78000000000003,1,1,1,3,Hibernating
15680,236,13,1394.73,3,4,3,10,Regulars
15681,102,12,1660.75,4,4,3,11,Loyal
15682,80,10,1291.01,4,3,3,10,Loyal
15683,186,11,809.0,3,3,1,7,Regulars
15684,334,7,668.06,2,1,1,4,Hibernating
15685,182,12,1411.19,3,4,3,10,Regulars
15686,104,8,2105.79,4,2,4,10,Big Spenders
15687,380,10,5547.35,2,3,5,10,Regulars
15688,3,15,1759.08,5,5,4,14,Champions
15689,5,14,2102.9700000000003,5,5,4,14,Champions
15690,71,8,1458.78,4,2,3,9,Regulars
15691,172,5,1249.03,3,1,3,7,Regulars
15692,304,14,4832.67,2,5,5,12,At Risk
15693,126,11,2095.0299999999997,4,3,4,11,Loyal
15694,67,6,1101.69,4,1,2,7,Regulars
15695,156,12,3073.56,3,4,5,12,Big Spenders
15696,78,12,1928.92,4,4,4,12,Champions
15697,101,8,730.5300000000001,4,2,1,7,Regulars
15698,400,15,2138.5499999999997,2,5,4,11,At Risk
15699,136,10,1383.44,4,3,3,10,Loyal
15700,5,14,3662.51,5,5,5,15,Champions
15701,312,14,2483.78,2,5,4,11,At Risk
15702,246,10,1663.33,3,3,3,9,Regulars
15703,542,13,1430.26,1,4,3,8,At Risk
15704,206,14,1358.53,3,5,3,11,Regulars
15705,434,10,1278.69,2,3,3,8,Regulars
15706,207,11,1425.9099999999999,3,3,3,9,Regulars
15707,220,11,2260.21,3,3,4,10,Big Spenders
15708,296,6,2782.08,2,1,5,8,Regulars
15709,3,12,3958.53,5,4,5,14,Champions
15710,432,11,778.69,2,3,1,6,Regulars
15711,183,12,2876.7,3,4,5,12,Big Spenders
15712,221,12,2622.27,3,4,5,12,Big Spenders
15713,536,8,1035.89,1,2,2,5,Hibernating
15714,630,11,2195.94,1,3,4,8,Regulars
15715,205,13,1323.22,3,4,3,10,Regulars
15716,141,8,1735.43,4,2,4,10,Big Spenders
15717,28,12,1266.47,5,4,3,12,Loyal
15718,78,18,6195.969999999999,4,5,5,14,Champions
15719,261,7,793.9300000000001,2,1,1,4,Hibernating
15720,229,11,1545.04,3,3,3,9,Regulars
15721,490,7,751.03,1,1,1,3,Hibernating
15722,461,13,2258.74,1,4,4,9,At Risk
15723,613,7,1540.28,1,1,3,5,Regulars
15724,28,17,3842.1900000000005,5,5,5,15,Champions
15725,726,10,4468.45,1,3,5,9,Regulars
15726,19,10,1433.02,5,3,3,11,Loyal
15727,620,9,992.15,1,2,2,5,Hibernating
15728,74,12,1097.12,4,4,2,10,Loyal
15729,573,11,729.69,1,3,1,5,Regulars
15730,561,12,1719.95,1,4,3,8,At Risk
15731,9,19,2783.45,5,5,5,15,Champions
15732,46,16,1837.83,5,5,4,14,Champions
15733,402,10,396.88,2,3,1,6,Regulars
15734,25,11,512.0699999999999,5,3,1,9,Loyal
15735,88,17,1370.8,4,5,3,12,Loyal
15736,873,13,2036.51,1,4,4,9,At Risk
15737,472,7,413.24,1,1,1,3,Hibernating
15738,343,10,904.37,2,3,2,7,Regulars
15739,90,8,891.1,4,2,2,8,Regulars
15740,489,9,2913.85,1,2,5,8,Regulars
15741,595,8,508.85,1,2,1,4,Hibernating
15742,477,13,2464.35,1,4,4,9,At Risk
15743,188,9,2805.2999999999997,3,2,5,10,Big Spenders
15744,230,8,1071.79,3,2,2,7,Regulars
15745,40,6,1075.57,5,1,2,8,Regulars
15746,1043,6,350.61,1,1,1,3,Hibernating
15747,261,13,1613.97,2,4,3,9,At Risk
15748,455,9,3395.9200000000005,2,2,5,9,Regulars
15749,62,12,1447.77,5,4,3,12,Loyal
15750,175,10,1588.45,3,3,3,9,Regulars
15751,132,16,3246.4,4,5,5,14,Champions
15752,258,11,1610.46,2,3,3,8,Regulars
15753,125,16,1775.6,4,5,4,13,Champions
15754,366,10,2059.95,2,3,4,9,Regulars
15755,376,10,882.91,2,3,2,7,Regulars
15756,53,10,1139.53,5,3,2,10,Loyal
15757,240,13,1332.34,3,4,3,10,Regulars
15758,24,12,1150.0900000000001,5,4,2,11,Loyal
15759,418,5,741.76,2,1,1,4,Hibernating
15760,220,17,4501.4800000000005,3,5,5,13,Big Spenders
15761,276,10,539.86,2,3,1,6,Regulars
15762,38,9,845.8,5,2,2,9,Regulars
15763,205,20,3598.41,3,5,5,13,Big Spenders
15764,213,9,677.24,3,2,1,6,Regulars
15765,853,5,162.89,1,1,1,3,Hibernating
15766,615,9,1085.9099999999999,1,2,2,5,Hibernating
15767,406,7,738.37,2,1,1,4,Hibernating
15768,1394,6,510.20000000000005,1,1,1,3,Hibernating
15769,953,11,2359.39,1,3,4,8,Regulars
15770,447,10,4207.78,2,3,5,10,Regulars
15771,203,7,711.44,3,1,1,5,Regulars
15772,424,9,2460.17,2,2,4,8,Regulars
15773,99,14,1495.5300000000002,4,5,3,12,Loyal
15774,343,11,1443.3,2,3,3,8,Regulars
15775,243,11,1161.81,3,3,2,8,Regulars
15776,23,11,2145.68,5,3,4,12,Loyal
15777,63,10,1299.1100000000001,5,3,3,11,Loyal
15778,597,6,1314.29,1,1,3,5,Regulars
15779,19,10,2996.93,5,3,5,13,Loyal
15780,23,11,1699.33,5,3,3,11,Loyal
15781,149,8,1507.7600000000002,3,2,3,8,Regulars
15782,64,7,409.82,5,1,1,7,Regulars
15783,205,9,1023.42,3,2,2,7,Regulars
15784,639,16,3382.1099999999997,1,5,5,11,At Risk
15785,10,13,1606.04,5,4,3,12,Loyal
15786,468,10,3011.24,1,3,5,9,Regulars
15787,16,13,1039.24,5,4,2,11,Loyal
15788,892,8,763.87,1,2,1,4,Hibernating
15789,21,13,817.48,5,4,1,10,Loyal
15790,834,7,995.76,1,1,2,4,Hibernating
15791,32,13,1482.8899999999999,5,4,3,12,Loyal
15792,29,7,386.86,5,1,1,7,Regulars
15793,152,17,3090.0,3,5,5,13,Big Spenders
15794,327,15,1227.43,2,5,2,9,At Risk
15795,303,13,1528.04,2,4,3,9,At Risk
15796,55,12,4447.7,5,4,5,14,Champions
15797,238,9,1449.19,3,2,3,8,Regulars
15798,1220,5,1657.66,1,1,3,5,Regulars
15799,495,8,1758.28,1,2,4,7,Regulars
15800,629,4,483.52,1,1,1,3,Hibernating
15801,102,18,2027.05,4,5,4,13,Champions
15802,64,8,1743.55,5,2,4,11,Big Spenders
15803,89,13,2629.42,4,4,5,13,Champions
15804,173,12,1138.02,3,4,2,9,Regulars
15805,0,7,1175.4499999999998,5,1,2,8,Regulars
15806,87,9,1436.13,4,2,3,9,Regulars
15807,595,11,1041.04,1,3,2,6,Regulars
15808,187,5,1576.78,3,1,3,7,Regulars
15809,9,9,1219.82,5,2,2,9,Regulars
15810,679,6,555.48,1,1,1,3,Hibernating
15811,51,7,842.65,5,1,1,7,Regulars
15812,120,13,2882.16,4,4,5,13,Champions
15813,246,8,1025.95,3,2,2,7,Regulars
15814,84,10,711.29,4,3,1,8,Loyal
15815,372,9,636.78,2,2,1,5,Hibernating
15816,159,13,2441.4,3,4,4,11,Big Spenders
15817,218,10,872.79,3,3,2,8,Regulars
15818,189,6,551.05,3,1,1,5,Regulars
15819,393,8,1228.15,2,2,2,6,Hibernating
15820,225,8,1063.15,3,2,2,7,Regulars
15821,377,10,1206.41,2,3,2,7,Regulars
15822,145,9,1684.3200000000002,4,2,3,9,Regulars
15823,178,10,1138.17,3,3,2,8,Regulars
15824,195,11,1625.4099999999999,3,3,3,9,Regulars
15825,36,13,4464.86,5,4,5,14,Champions
15826,474,13,1547.59,1,4,3,8,At Risk
15827,35,13,1471.29,5,4,3,12,Loyal
15828,456,8,2840.43,2,2,5,9,Regulars
15829,213,11,1848.52,3,3,4,10,Big Spenders
15830,187,10,641.84,3,3,1,7,Regulars
15831,40,13,2649.64,5,4,5,14,Champions
15832,326,6,1197.52,2,1,2,5,Hibernating
15833,239,17,1312.27,3,5,3,11,Regulars
15834,309,12,2121.54,2,4,4,10,At Risk
15835,457,10,1056.7300000000002,2,3,2,7,Regulars
15836,497,13,4313.66,1,4,5,10,At Risk
15837,123,7,1309.79,4,1,3,8,Regulars
15838,6,7,705.64,5,1,1,7,Regulars
15839,162,14,1557.48,3,5,3,11,Regulars
15840,668,5,692.12,1,1,1,3,Hibernating
15841,103,10,1899.73,4,3,4,11,Loyal
15842,493,10,3437.1699999999996,1,3,5,9,Regulars
15843,887,14,3582.7000000000003,1,5,5,11,At Risk
15844,441,13,936.1999999999999,2,4,2,8,At Risk
15845,165,14,2367.32,3,5,4,12,Big Spenders
15846,82,21,2669.91,4,5,5,14,Champions
15847,238,10,3539.49,3,3,5,11,Big Spenders
15848,1,7,1835.86,5,1,4,10,Big Spenders
15849,55,13,972.65,5,4,2,11,Loyal
15850,134,13,1533.1100000000001,4,4,3,11,Loyal
15851,122,13,1908.62,4,4,4,12,Champions
15852,144,8,1024.98,4,2,2,8,Regulars
15853,460,7,725.1700000000001,1,1,1,3,Hibernating
15854,595,10,614.85,1,3,1,5,Regulars
15855,226,13,3733.7400000000002,3,4,5,12,Big Spenders
15856,692,10,1104.03,1,3,2,6,Regulars
15857,213,15,1356.6000000000001,3,5,3,11,Regulars
15858,831,9,3730.13,1,2,5,8,Regulars
15859,6,13,1570.13,5,4,3,12,Loyal
15860,169,15,2006.57,3,5,4,12,Big Spenders
15861,45,9,1491.47,5,2,3,10,Regulars
15862,166,10,785.77,3,3,1,7,Regulars
15863,386,7,1111.44,2,1,2,5,Hibernating
15864,14,13,1513.4399999999998,5,4,3,12,Loyal
15865,101,10,4080.06,4,3,5,12,Loyal
15866,144,14,1285.15,4,5,3,12,Loyal
15867,71,8,1571.4,4,2,3,9,Regulars
15868,820,10,1033.04,1,3,2,6,Regulars
15869,786,6,328.19,1,1,1,3,Hibernating
15870,11,18,3690.6,5,5,5,15,Champions
15871,208,11,1046.1399999999999,3,3,2,8,Regulars
15872,60,12,2323.1,5,4,4,13,Champions
15873,127,16,2487.87,4,5,4,13,Champions
15874,331,9,989.99,2,2,2,6,Hibernating
15875,28,17,3358.9700000000003,5,5,5,15,Champions
15876,210,12,3142.77,3,4,5,12,Big Spenders
15877,260,15,2366.38,2,5,4,11,At Risk
15878,357,12,1017.05,2,4,2,8,At Risk
15879,893,7,661.98,1,1,1,3,Hibernating
15880,368,10,1073.5700000000002,2,3,2,7,Regulars
15881,233,13,4497.46,3,4,5,12,Big Spenders
15882,1248,10,1191.81,1,3,2,6,Regulars
15883,179,14,2502.55,3,5,4,12,Big Spenders
15884,214,14,1418.03,3,5,3,11,Regulars
15885,53,11,3224.7200000000003,5,3,5,13,Loyal
15886,258,7,1248.56,2,1,3,6,Regulars
15887,84,8,414.65999999999997,4,2,1,7,Regulars
15888,535,11,2190.52,1,3,4,8,Regulars
15889,958,9,2416.2000000000003,1,2,4,7,Regulars
15890,119,10,1041.29,4,3,2,9,Loyal
15891,6,12,1596.27,5,4,3,12,Loyal
15892,33,10,780.9100000000001,5,3,1,9,Loyal
15893,725,6,658.8,1,1,1,3,Hibernating
15894,46,10,1102.96,5,3,2,10,Loyal
15895,92,4,371.6,4,1,1,6,Regulars
15896,231,6,1187.3,3,1,2,6,Regulars
15897,514,9,3347.8599999999997,1,2,5,8,Regulars
15898,238,11,2253.35,3,3,4,10,Big Spenders
15899,400,12,1131.6,2,4,2,8,At Risk
15900,127,7,1640.46,4,1,3,8,Regulars
15901,154,15,2749.64,3,5,5,13,Big Spenders
15902,63,11,1467.41,5,3,3,11,Loyal
15903,364,13,2314.2000000000003,2,4,4,10,At Risk
15904,351,16,3342.57,2,5,5,12,At Risk
15905,361,10,1440.73,2,3,3,8,Regulars
15906,154,11,1498.59,3,3,3,9,Regulars
15907,92,12,2515.21,4,4,4,12,Champions
15908,791,10,983.12,1,3,2,6,Regulars
15909,289,7,3741.81,2,1,5,8,Regulars
15910,308,8,666.35,2,2,1,5,Hibernating
15911,238,14,2631.26,3,5,5,13,Big Spenders
15912,51,5,890.25,5,1,2,8,Regulars
15913,46,12,1152.43,5,4,2,11,Loyal
15914,152,4,2433.85,3,1,4,8,Big Spenders
15915,405,6,222.28,2,1,1,4,Hibernating
15916,147,15,1720.47,4,5,3,12,Loyal
15917,738,13,1412.68,1,4,3,8,At Risk
15918,139,9,674.63,4,2,1,7,Regulars
15919,122,5,363.43,4,1,1,6,Regulars
15920,974,10,1641.36,1,3,3,7,Regulars
15921,201,12,3125.7999999999997,3,4,5,12,Big Spenders
15922,69,9,931.76,4,2,2,8,Regulars
15923,206,12,1667.34,3,4,3,10,Regulars
15924,40,8,4767.92,5,2,5,12,Big Spenders
15925,787,5,478.34000000000003,1,1,1,3,Hibernating
15926,110,9,668.66,4,2,1,7,Regulars
15927,379,7,483.41999999999996,2,1,1,4,Hibernating
15928,245,12,2375.68,3,4,4,11,Big Spenders
15929,58,4,252.42,5,1,1,7,Regulars
15930,145,13,4497.22,4,4,5,13,Champions
15931,186,13,2453.79,3,4,4,11,Big Spenders
15932,388,9,1363.02,2,2,3,7,Regulars
15933,408,6,2169.16,2,1,4,7,Regulars
15934,45,10,2277.8,5,3,4,12,Loyal
15935,130,13,1310.42,4,4,3,11,Loyal
15936,49,12,2930.04,5,4,5,14,Champions
15937,803,7,980.3299999999999,1,1,2,4,Hibernating
15938,225,12,1637.0,3,4,3,10,Regulars
15939,50,12,968.65,5,4,2,11,Loyal
15940,138,18,3203.09,4,5,5,14,Champions
15941,692,6,355.22,1,1,1,3,Hibernating
15942,54,8,1017.9100000000001,5,2,2,9,Regulars
15943,165,8,2383.1499999999996,3,2,4,9,Big Spenders
15944,749,8,911.76,1,2,2,5,Hibernating
15945,365,11,2394.94,2,3,4,9,Regulars
15946,152,10,1721.24,3,3,3,9,Regulars
15947,353,13,2225.34,2,4,4,10,At Risk
15948,321,15,3000.06,2,5,5,12,At Risk
15949,269,13,2145.4700000000003,2,4,4,10,At Risk
15950,270,7,496.14,2,1,1,4,Hibernating
15951,149,13,2968.9300000000003,3,4,5,12,Big Spenders
15952,191,11,878.43,3,3,2,8,Regulars
15953,26,23,3054.5899999999997,5,5,5,15,Champions
15954,658,10,729.77,1,3,1,5,Regulars
15955,124,9,677.6999999999999,4,2,1,7,Regulars
15956,159,14,3864.26,3,5,5,13,Big Spenders
15957,282,10,2705.0,2,3,5,10,Regulars
15958,156,10,1323.48,3,3,3,9,Regulars
15959,57,15,2553.56,5,5,4,14,Champions
15960,118,9,1073.8,4,2,2,8,Regulars
15961,38,12,3608.8200000000006,5,4,5,14,Champions
15962,148,11,2451.73,3,3,4,10,Big Spenders
15963,342,8,2748.63,2,2,5,9,Regulars
15964,208,14,1574.18,3,5,3,11,Regulars
15965,49,10,2000.3999999999999,5,3,4,12,Loyal
15966,282,11,1677.3700000000001,2,3,3,8,Regulars
15967,141,7,1273.52,4,1,3,8,Regulars
15968,91,6,650.28,4,1,1,6,Regulars
15969,192,9,1677.94,3,2,3,8,Regulars
15970,402,8,1342.85,2,2,3,7,Regulars
15971,193,9,2273.51,3,2,4,9,Big Spenders
15972,58,9,480.62,5,2,1,8,Regulars
15973,44,7,1899.9,5,1,4,10,Big Spenders
15974,99,13,1801.41,4,4,4,12,Champions
15975,45,9,546.47,5,2,1,8,Regulars
15976,122,10,1030.34,4,3,2,9,Loyal
15977,50,6,980.8299999999999,5,1,2,8,Regulars
15978,177,9,804.33,3,2,1,6,Regulars
15979,585,8,3053.58,1,2,5,8,Regulars
15980,182,14,1230.43,3,5,2,10,Regulars
15981,126,12,3568.47,4,4,5,13,Champions
15982,652,6,448.46,1,1,1,3,Hibernating
15983,737,7,403.64,1,1,1,3,Hibernating
15984,167,10,4708.72,3,3,5,11,Big Spenders
15985,87,13,3217.2200000000003,4,4,5,13,Champions
15986,400,17,2097.69,2,5,4,11,At Risk
15987,453,12,1903.18,2,4,4,10,At Risk
15988,24,7,393.26,5,1,1,7,Regulars
15989,622,6,2191.3199999999997,1,1,4,6,Regulars
15990,483,11,2488.3500000000004,1,3,4,8,Regulars
15991,385,12,1459.3,2,4,3,9,At Risk
15992,402,7,652.77,2,1,1,4,Hibernating
15993,208,10,1297.4500000000003,3,3,3,9,Regulars
15994,57,11,6277.54,5,3,5,13,Loyal
15995,482,12,2134.58,1,4,4,9,At Risk
15996,59,7,990.88,5,1,2,8,Regulars
15997,613,10,1108.93,1,3,2,6,Regulars
15998,121,8,1034.25,4,2,2,8,Regulars
15999,240,8,765.1899999999999,3,2,1,6,Regulars
16000,126,11,1510.28,4,3,3,10,Loyal
16001,267,15,1856.73,2,5,4,11,At Risk
16002,441,15,6757.12,2,5,5,12,At Risk
16003,164,10,734.8199999999999,3,3,1,7,Regulars
16004,201,13,1244.49,3,4,3,10,Regulars
16005,88,6,2296.09,4,1,4,9,Big Spenders
16006,1869,4,1273.07,1,1,3,5,Regulars
16007,223,7,966.12,3,1,2,6,Regulars
16008,187,10,2148.39,3,3,4,10,Big Spenders
16009,215,5,1058.29,3,1,2,6,Regulars
16010,397,9,1241.43,2,2,3,7,Regulars
16011,195,13,1958.71,3,4,4,11,Big Spenders
16012,149,7,307.75,3,1,1,5,Regulars
16013,56,9,1608.98,5,2,3,10,Regulars
16014,231,12,2423.6,3,4,4,11,Big Spenders
16015,248,11,1330.3400000000001,2,3,3,8,Regulars
16016,140,11,870.1,4,3,2,9,Loyal
16017,267,10,1003.48,2,3,2,7,Regulars
16018,18,7,395.45,5,1,1,7,Regulars
16019,573,10,1430.3100000000002,1,3,3,7,Regulars
16020,271,11,2051.3500000000004,2,3,4,9,Regulars
16021,45,19,3494.8,5,5,5,15,Champions
16022,561,7,720.31,1,1,1,3,Hibernating
16023,220,7,309.55,3,1,1,5,Regulars
16024,10,9,901.72,5,2,2,9,Regulars
16025,232,13,4337.54,3,4,5,12,Big Spenders
16026,122,10,1330.1599999999999,4,3,3,10,Loyal
16027,523,8,600.14,1,2,1,4,Hibernating
16028,195,9,1254.84,3,2,3,8,Regulars
16029,574,16,6704.16,1,5,5,11,At Risk
16030,356,7,2233.19,2,1,4,7,Regulars
16031,2,11,1221.97,5,3,2,10,Loyal
16032,516,8,2082.12,1,2,4,7,Regulars
16033,133,12,2489.04,4,4,4,12,Champions
16034,860,7,593.25,1,1,1,3,Hibernating
16035,174,10,1183.96,3,3,2,8,Regulars
16036,85,12,1362.7,4,4,3,11,Loyal
16037,835,8,2114.52,1,2,4,7,Regulars
16038,100,6,905.74,4,1,2,7,Regulars
16039,208,7,3387.93,3,1,5,9,Big Spenders
16040,87,7,1576.3999999999999,4,1,3,8,Regulars
16041,23,12,1384.67,5,4,3,12,Loyal
16042,139,7,6076.37,4,1,5,10,Big Spenders
16043,417,10,525.67,2,3,1,6,Regulars
16044,179,10,948.11,3,3,2,8,Regulars
16045,88,9,811.8199999999999,4,2,1,7,Regulars
16046,605,8,1369.3600000000001,1,2,3,6,Regulars
16047,92,10,1251.1100000000001,4,3,3,10,Loyal
16048,308,11,3698.5199999999995,2,3,5,10,Regulars
16049,1095,7,620.6800000000001,1,1,1,3,Hibernating
16050,200,11,1525.5900000000001,3,3,3,9,Regulars
16051,36,7,804.6300000000001,5,1,1,7,Regulars
16052,146,12,3117.77,4,4,5,13,Champions
16053,195,9,1015.01,3,2,2,7,Regulars
16054,218,15,1520.71,3,5,3,11,Regulars
16055,151,8,4084.5600000000004,3,2,5,10,Big Spenders
16056,49,12,1862.27,5,4,4,13,Champions
16057,191,19,4283.66,3,5,5,13,Big Spenders
16058,399,10,1852.45,2,3,4,9,Regulars
16059,566,7,2636.06,1,1,5,7,Regulars
16060,152,9,878.87,3,2,2,7,Regulars
16061,400,11,631.37,2,3,1,6,Regulars
16062,64,11,1975.48,5,3,4,12,Loyal
16063,161,18,3098.17,3,5,5,13,Big Spenders
16064,144,5,269.12,4,1,1,6,Regulars
16065,331,9,2911.72,2,2,5,9,Regulars
16066,69,6,1082.8,4,1,2,7,Regulars
16067,615,4,308.51,1,1,1,3,Hibernating
16068,45,9,1093.3300000000002,5,2,2,9,Regulars
16069,99,9,1335.4499999999998,4,2,3,9,Regulars
16070,12,15,2104.56,5,5,4,14,Champions
16071,89,9,1162.82,4,2,2,8,Regulars
16072,110,8,494.24,4,2,1,7,Regulars
16073,66,9,1423.84,4,2,3,9,Regulars
16074,119,8,742.67,4,2,1,7,Regulars
16075,1298,11,1815.6899999999998,1,3,4,8,Regulars
16076,55,15,1467.9,5,5,3,13,Loyal
16077,244,6,489.06,3,1,1,5,Regulars
16078,326,13,2172.27,2,4,4,10,At Risk
16079,97,7,1358.1100000000001,4,1,3,8,Regulars
16080,301,12,6693.5599999999995,2,4,5,11,At Risk
16081,98,15,1392.15,4,5,3,12,Loyal
16082,48,14,1474.54,5,5,3,13,Loyal
16083,501,13,1513.71,1,4,3,8,At Risk
16084,76,13,2122.5299999999997,4,4,4,12,Champions
16085,194,12,1555.84,3,4,3,10,Regulars
16086,12,7,1143.85,5,1,2,8,Regulars
16087,11,12,4443.56,5,4,5,14,Champions
16088,16,10,1099.37,5,3,2,10,Loyal
16089,428,9,2228.48,2,2,4,8,Regulars
16090,268,8,2519.69,2,2,4,8,Regulars
16091,281,6,2053.98,2,1,4,7,Regulars
16092,20,14,1196.68,5,5,2,12,Loyal
16093,118,15,3062.67,4,5,5,14,Champions
16094,98,17,2848.79,4,5,5,14,Champions
16095,620,11,2751.4100000000003,1,3,5,9,Regulars
16096,127,4,2456.48,4,1,4,9,Big Spenders
16097,1,11,783.06,5,3,1,9,Loyal
16098,215,13,3504.1,3,4,5,12,Big Spenders
16099,124,11,1493.47,4,3,3,10,Loyal
16100,62,8,712.48,5,2,1,8,Regulars
16101,201,10,1776.61,3,3,4,10,Big Spenders
16102,99,11,1293.6,4,3,3,10,Loyal
16103,252,12,2727.3999999999996,2,4,5,11,At Risk
16104,216,13,1999.8799999999999,3,4,4,11,Big Spenders
16105,54,8,765.28,5,2,1,8,Regulars
16106,391,10,3303.08,2,3,5,10,Regulars
16107,215,4,1641.1899999999998,3,1,3,7,Regulars
16108,317,10,2014.3099999999997,2,3,4,9,Regulars
16109,792,10,857.05,1,3,2,6,Regulars
16110,577,9,5544.95,1,2,5,8,Regulars
16111,28,12,1655.27,5,4,3,12,Loyal
16112,489,11,1463.3700000000001,1,3,3,7,Regulars
16113,239,11,934.3900000000001,3,3,2,8,Regulars
16114,119,11,1919.2000000000003,4,3,4,11,Loyal
16115,181,6,1427.39,3,1,3,7,Regulars
16116,129,11,3830.1899999999996,4,3,5,12,Loyal
16117,561,11,2267.3199999999997,1,3,4,8,Regulars
16118,264,14,2409.63,2,5,4,11,At Risk
16119,106,7,2693.43,4,1,5,10,Big Spenders
16120,225,10,1432.57,3,3,3,9,Regulars
16121,1038,8,878.53,1,2,2,5,Hibernating
16122,689,15,1847.15,1,5,4,10,At Risk
16123,210,11,1287.0900000000001,3,3,3,9,Regulars
16124,461,13,2010.88,1,4,4,9,At Risk
16125,258,9,1876.6799999999998,2,2,4,8,Regulars
16126,15,14,4669.6,5,5,5,15,Champions
16127,173,8,2541.24,3,2,4,9,Big Spenders
16128,186,14,1799.1200000000001,3,5,4,12,Big Spenders
16129,57,13,1804.88,5,4,4,13,Champions
16130,796,9,841.28,1,2,1,4,Hibernating
16131,78,8,1134.81,4,2,2,8,Regulars
16132,73,7,3430.55,4,1,5,10,Big Spenders
16133,42,12,3894.4900000000002,5,4,5,14,Champions
16134,122,9,1425.47,4,2,3,9,Regulars
16135,15,8,2723.93,5,2,5,12,Big Spenders
16136,307,8,1977.5700000000002,2,2,4,8,Regulars
16137,47,5,499.46000000000004,5,1,1,7,Regulars
16138,187,13,3647.79,3,4,5,12,Big Spenders
16139,516,7,403.72999999999996,1,1,1,3,Hibernating
16140,135,13,4522.400000000001,4,4,5,13,Champions
16141,49,6,1905.99,5,1,4,10,Big Spenders
16142,659,8,809.46,1,2,1,4,Hibernating
16143,166,12,3802.13,3,4,5,12,Big Spenders
16144,380,4,195.41,2,1,1,4,Hibernating
16145,23,13,1790.77,5,4,4,13,Champions
16146,156,8,508.97,3,2,1,6,Regulars
16147,62,14,1371.25,5,5,3,13,Loyal
16148,239,11,1855.11,3,3,4,10,Big Spenders
16149,1483,7,671.8900000000001,1,1,1,3,Hibernating
16150,2,15,5642.64,5,5,5,15,Champions
16151,91,9,944.84,4,2,2,8,Regulars
16152,224,6,693.61,3,1,1,5,Regulars
16153,28,11,1969.45,5,3,4,12,Loyal
16154,100,12,1336.31,4,4,3,11,Loyal
16155,83,21,3043.96,4,5,5,14,Champions
16156,398,11,566.26,2,3,1,6,Regulars
16157,183,12,2051.67,3,4,4,11,Big Spenders
16158,467,6,1227.68,1,1,2,4,Hibernating
16159,21,8,342.90999999999997,5,2,1,8,Regulars
16160,240,5,2382.6899999999996,3,1,4,8,Big Spenders
16161,131,11,3581.79,4,3,5,12,Loyal
16162,124,7,615.24,4,1,1,6,Regulars
16163,89,8,874.0500000000001,4,2,2,8,Regulars
16164,286,13,5747.74,2,4,5,11,At Risk
16165,582,7,3383.8,1,1,5,7,Regulars
16166,117,13,1254.35,4,4,3,11,Loyal
16167,162,8,1188.07,3,2,2,7,Regulars
16168,126,6,1560.04,4,1,3,8,Regulars
16169,151,16,1446.48,3,5,3,11,Regulars
16170,483,7,1171.73,1,1,2,4,Hibernating
16171,806,10,1474.82,1,3,3,7,Regulars
16172,670,7,1476.11,1,1,3,5,Regulars
16173,317,9,1982.97,2,2,4,8,Regulars
16174,93,12,1230.24,4,4,2,10,Loyal
16175,83,12,1506.03,4,4,3,11,Loyal
16176,175,13,1910.1599999999999,3,4,4,11,Big Spenders
16177,93,11,748.2,4,3,1,8,Loyal
16178,194,9,2374.45,3,2,4,9,Big Spenders
16179,196,14,2340.25,3,5,4,12,Big Spenders
16180,40,14,2410.12,5,5,4,14,Champions
16181,31,10,3502.05,5,3,5,13,Loyal
16182,284,13,3380.04,2,4,5,11,At Risk
16183,39,15,3263.1,5,5,5,15,Champions
16184,56,13,4302.59,5,4,5,14,Champions
16185,110,9,1606.3,4,2,3,9,Regulars
16186,347,17,2008.57,2,5,4,11,At Risk
16187,201,9,624.71,3,2,1,6,Regulars
16188,33,9,575.21,5,2,1,8,Regulars
16189,868,9,1803.58,1,2,4,7,Regulars
16190,103,7,526.46,4,1,1,6,Regulars
16191,2,15,2883.4700000000003,5,5,5,15,Champions
16192,72,10,798.48,4,3,1,8,Loyal
16193,159,12,2814.04,3,4,5,12,Big Spenders
16194,209,9,953.75,3,2,2,7,Regulars
16195,503,10,4092.22,1,3,5,9,Regulars
16196,296,11,1077.88,2,3,2,7,Regulars
16197,435,11,2397.12,2,3,4,9,Regulars
16198,532,9,976.0899999999999,1,2,2,5,Hibernating
16199,497,9,529.43,1,2,1,4,Hibernating
16200,95,10,980.9,4,3,2,9,Loyal
16201,106,9,2131.4100000000003,4,2,4,10,Big Spenders
16202,210,8,967.22,3,2,2,7,Regulars
16203,554,9,729.66,1,2,1,4,Hibernating
16204,726,7,1036.1,1,1,2,4,Hibernating
16205,496,10,897.7199999999999,1,3,2,6,Regulars
16206,278,9,2469.3,2,2,4,8,Regulars
16207,38,16,4638.33,5,5,5,15,Champions
16208,21,13,2779.0299999999997,5,4,5,14,Champions
16209,120,14,1255.0,4,5,3,12,Loyal
16210,61,12,2412.9,5,4,4,13,Champions
16211,211,10,1340.91,3,3,3,9,Regulars
16212,277,13,3187.14,2,4,5,11,At Risk
16213,20,8,694.5,5,2,1,8,Regulars
16214,352,9,722.44,2,2,1,5,Hibernating
16215,104,12,2361.25,4,4,4,12,Champions
16216,76,1,75.37,4,1,1,6,Regulars
16217,214,7,675.6800000000001,3,1,1,5,Regulars
16218,72,6,822.85,4,1,1,6,Regulars
16219,677,7,423.51,1,1,1,3,Hibernating
16220,796,6,1683.86,1,1,3,5,Regulars
16221,66,19,2637.92,4,5,5,14,Champions
16222,21,7,503.15999999999997,5,1,1,7,Regulars
16223,1087,9,2579.77,1,2,5,8,Regulars
16224,379,10,3336.3999999999996,2,3,5,10,Regulars
16225,2,13,5358.400000000001,5,4,5,14,Champions
16226,565,14,2330.77,1,5,4,10,At Risk
16227,1039,9,1094.3899999999999,1,2,2,5,Hibernating
16228,80,7,2104.54,4,1,4,9,Big Spenders
16229,37,8,1016.17,5,2,2,9,Regulars
16230,770,9,2020.8300000000004,1,2,4,7,Regulars
16231,216,11,2189.65,3,3,4,10,Big Spenders
16232,156,10,2540.47,3,3,4,10,Big Spenders
16233,72,15,3150.1499999999996,4,5,5,14,Champions
16234,58,14,1302.93,5,5,3,13,Loyal
16235,742,10,1124.33,1,3,2,6,Regulars
16236,148,11,1622.92,3,3,3,9,Regulars
16237,55,17,1912.54,5,5,4,14,Champions
16238,100,12,4119.759999999999,4,4,5,13,Champions
16239,157,7,2340.72,3,1,4,8,Big Spenders
16240,94,5,697.59,4,1,1,6,Regulars
16241,0,11,2170.17,5,3,4,12,Loyal
16242,56,15,2000.53,5,5,4,14,Champions
16243,499,16,1026.99,1,5,2,8,At Risk
16244,504,11,1697.98,1,3,3,7,Regulars
16245,76,8,1296.2,4,2,3,9,Regulars
16246,212,8,2061.7000000000003,3,2,4,9,Big Spenders
16247,22,12,983.43,5,4,2,11,Loyal
16248,152,10,2183.83,3,3,4,10,Big Spenders
16249,484,10,788.22,1,3,1,5,Regulars
16250,197,10,2863.83,3,3,5,11,Big Spenders
16251,188,8,1018.67,3,2,2,7,Regulars
16252,14,17,2116.3,5,5,4,14,Champions
16253,105,13,3210.42,4,4,5,13,Champions
16254,119,9,1366.45,4,2,3,9,Regulars
16255,1216,10,685.73,1,3,1,5,Regulars
16256,271,8,2095.34,2,2,4,8,Regulars
16257,541,9,1252.57,1,2,3,6,Regulars
16258,653,10,3649.41,1,3,5,9,Regulars
16259,755,7,463.54,1,1,1,3,Hibernating
16260,816,10,1396.42,1,3,3,7,Regulars
16261,159,14,2381.47,3,5,4,12,Big Spenders
16262,224,5,251.85,3,1,1,5,Regulars
16263,270,7,2750.8599999999997,2,1,5,8,Regulars
16264,148,14,3427.36,3,5,5,13,Big Spenders
16265,35,12,1548.0,5,4,3,12,Loyal
16266,292,9,1094.0200000000002,2,2,2,6,Hibernating
16267,19,5,732.1599999999999,5,1,1,7,Regulars
16268,6,7,512.8100000000001,5,1,1,7,Regulars
16269,191,10,705.2,3,3,1,7,Regulars
16270,255,8,2275.7,2,2,4,8,Regulars
16271,630,5,369.30999999999995,1,1,1,3,Hibernating
16272,115,10,2543.92,4,3,4,11,Loyal
16273,46,19,2465.14,5,5,4,14,Champions
16274,357,11,3475.7,2,3,5,10,Regulars
16275,17,14,3462.77,5,5,5,15,Champions
16276,124,15,3315.04,4,5,5,14,Champions
16277,161,13,3594.59,3,4,5,12,Big Spenders
16278,263,10,3532.52,2,3,5,10,Regulars
16279,320,15,3162.1099999999997,2,5,5,12,At Risk
16280,165,11,1311.6299999999999,3,3,3,9,Regulars
16281,27,17,1429.9099999999999,5,5,3,13,Loyal
16282,97,10,857.82,4,3,2,9,Loyal
16283,220,10,896.38,3,3,2,8,Regulars
16284,253,9,1091.9199999999998,2,2,2,6,Hibernating
16285,497,11,1724.49,1,3,3,7,Regulars
16286,30,7,1368.65,5,1,3,9,Regulars
16287,95,13,1618.8,4,4,3,11,Loyal
16288,442,7,233.05,2,1,1,4,Hibernating
16289,572,8,705.01,1,2,1,4,Hibernating
16290,59,5,448.54,5,1,1,7,Regulars
16291,89,13,1272.82,4,4,3,11,Loyal
16292,506,12,5016.51,1,4,5,10,At Risk
16293,155,1,274.1,3,1,1,5,Regulars
16294,178,10,2739.5400000000004,3,3,5,11,Big Spenders
16295,403,7,416.72,2,1,1,4,Hibernating
16296,203,15,2573.85,3,5,5,13,Big Spenders
16297,223,13,2412.28,3,4,4,11,Big Spenders
16298,28,15,3766.76,5,5,5,15,Champions
16299,19,12,2913.42,5,4,5,14,Champions
16300,45,18,3210.32,5,5,5,15,Champions
16301,133,13,2084.38,4,4,4,12,Champions
16302,42,15,1717.3300000000002,5,5,3,13,Loyal
16303,1086,4,236.47,1,1,1,3,Hibernating
16304,551,8,1196.99,1,2,2,5,Hibernating
16305,313,6,258.87,2,1,1,4,Hibernating
16306,13,4,210.11,5,1,1,7,Regulars
16307,225,13,2387.07,3,4,4,11,Big Spenders
16308,935,3,190.88,1,1,1,3,Hibernating
16309,27,5,509.3,5,1,1,7,Regulars
16310,26,12,1700.6000000000001,5,4,3,12,Loyal
16311,598,8,2509.33,1,2,4,7,Regulars
16312,223,15,1838.11,3,5,4,12,Big Spenders
16313,307,4,3090.27,2,1,5,8,Regulars
16314,577,11,802.24,1,3,1,5,Regulars
16315,41,3,181.05,5,1,1,7,Regulars
16316,523,4,1198.85,1,1,2,4,Hibernating
16317,150,8,2275.96,3,2,4,9,Big Spenders
16318,524,6,1832.04,1,1,4,6,Regulars
16319,1181,5,670.6300000000001,1,1,1,3,Hibernating
16320,279,16,2868.24,2,5,5,12,At Risk
16321,94,14,1129.1100000000001,4,5,2,11,Loyal
16322,105,14,2608.01,4,5,5,14,Champions
16323,1160,8,4079.13,1,2,5,8,Regulars
16324,659,11,1558.42,1,3,3,7,Regulars
16325,196,7,2132.65,3,1,4,8,Big Spenders
16326,211,9,904.03,3,2,2,7,Regulars
16327,80,7,1154.8799999999999,4,1,2,7,Regulars
16328,164,11,3311.95,3,3,5,11,Big Spenders
16329,491,7,1160.37,1,1,2,4,Hibernating
16330,214,17,4636.28,3,5,5,13,Big Spenders
16331,35,12,1850.7299999999998,5,4,4,13,Champions
16332,672,6,592.61,1,1,1,3,Hibernating
16333,547,7,1087.52,1,1,2,4,Hibernating
16334,153,13,4139.91,3,4,5,12,Big Spenders
16335,339,3,223.14999999999998,2,1,1,4,Hibernating
16336,17,9,1822.32,5,2,4,11,Big Spenders
16337,110,9,1023.67,4,2,2,8,Regulars
16338,590,5,761.13,1,1,1,3,Hibernating
16339,206,12,1260.51,3,4,3,10,Regulars
16340,144,11,1419.46,4,3,3,10,Loyal
16341,73,7,332.04,4,1,1,6,Regulars
16342,284,8,2097.8,2,2,4,8,Regulars
16343,6,10,2571.85,5,3,4,12,Loyal
16344,201,17,2122.6,3,5,4,12,Big Spenders
16345,14,12,2243.31,5,4,4,13,Champions
16346,199,11,1346.79,3,3,3,9,Regulars
16347,632,7,657.02,1,1,1,3,Hibernating
16348,528,16,5471.049999999999,1,5,5,11,At Risk
16349,90,10,1406.4199999999998,4,3,3,10,Loyal
16350,233,10,1316.48,3,3,3,9,Regulars
16351,42,4,391.77,5,1,1,7,Regulars
16352,110,10,1043.99,4,3,2,9,Loyal
16353,534,8,771.37,1,2,1,4,Hibernating
16354,356,4,497.3,2,1,1,4,Hibernating
16355,1,15,2561.95,5,5,4,14,Champions
16356,85,13,1113.71,4,4,2,10,Loyal
16357,65,12,1084.8700000000001,5,4,2,11,Loyal
16358,536,16,3007.54,1,5,5,11,At Risk
16359,31,14,2364.82,5,5,4,14,Champions
16360,89,14,2420.33,4,5,4,13,Champions
16361,82,9,1362.6299999999999,4,2,3,9,Regulars
16362,58,12,2785.16,5,4,5,14,Champions
16363,237,6,821.48,3,1,1,5,Regulars
16364,264,5,656.38,2,1,1,4,Hibernating
16365,1286,4,612.88,1,1,1,3,Hibernating
16366,290,7,971.71,2,1,2,5,Hibernating
16367,5,13,1159.96,5,4,2,11,Loyal
16368,128,10,1848.83,4,3,4,11,Loyal
16369,21,13,2339.3999999999996,5,4,4,13,Champions
16370,198,13,3511.7200000000003,3,4,5,12,Big Spenders
16371,0,8,1785.29,5,2,4,11,Big Spenders
16372,409,9,1562.1,2,2,3,7,Regulars
16373,202,14,988.55,3,5,2,10,Regulars
16374,234,11,3239.79,3,3,5,11,Big Spenders
16375,237,7,1435.99,3,1,3,7,Regulars
16376,105,7,632.94,4,1,1,6,Regulars
16377,277,10,2524.92,2,3,4,9,Regulars
16378,208,9,576.27,3,2,1,6,Regulars
16379,549,7,944.5500000000001,1,1,2,4,Hibernating
16380,312,7,487.47,2,1,1,4,Hibernating
16381,836,8,394.82,1,2,1,4,Hibernating
16382,11,18,3524.2799999999997,5,5,5,15,Champions
16383,50,11,850.13,5,3,2,10,Loyal
16384,404,11,1093.12,2,3,2,7,Regulars
16385,180,11,1813.61,3,3,4,10,Big Spenders
16386,50,8,1260.22,5,2,3,10,Regulars
16387,18,11,2470.48,5,3,4,12,Loyal
16388,32,11,2649.25,5,3,5,13,Loyal
16389,2,11,1142.77,5,3,2,10,Loyal
16390,320,5,481.25,2,1,1,4,Hibernating
16391,179,11,1157.06,3,3,2,8,Regulars
16392,385,9,2429.49,2,2,4,8,Regulars
16393,0,14,1324.39,5,5,3,13,Loyal
16394,120,14,1434.42,4,5,3,12,Loyal
16395,142,8,2473.83,4,2,4,10,Big Spenders
16396,333,10,2700.41,2,3,5,10,Regulars
16397,541,13,1481.67,1,4,3,8,At Risk
16398,126,7,1817.6999999999998,4,1,4,9,Big Spenders
16399,2,18,2687.96,5,5,5,15,Champions
16400,851,12,2142.12,1,4,4,9,At Risk
16401,121,12,980.0799999999999,4,4,2,10,Loyal
16402,148,13,1192.99,3,4,2,9,Regulars
16403,344,7,1203.98,2,1,2,5,Hibernating
16404,33,6,1101.09,5,1,2,8,Regulars
16405,137,4,2649.25,4,1,5,10,Big Spenders
16406,52,9,3449.6899999999996,5,2,5,12,Big Spenders
16407,1520,3,202.04000000000002,1,1,1,3,Hibernating
16408,63,10,3847.44,5,3,5,13,Loyal
16409,103,6,1026.47,4,1,2,7,Regulars
16410,81,6,275.59000000000003,4,1,1,6,Regulars
16411,469,10,1414.85,1,3,3,7,Regulars
16412,156,11,3703.38,3,3,5,11,Big Spenders
16413,348,11,4469.86,2,3,5,10,Regulars
16414,101,12,3621.8700000000003,4,4,5,13,Champions
16415,165,17,3009.34,3,5,5,13,Big Spenders
16416,31,8,1005.45,5,2,2,9,Regulars
16417,104,9,1493.15,4,2,3,9,Regulars
16418,37,13,1300.04,5,4,3,12,Loyal
16419,28,10,1125.8300000000002,5,3,2,10,Loyal
16420,232,4,2667.77,3,1,5,9,Big Spenders
16421,286,6,389.68000000000006,2,1,1,4,Hibernating
16422,42,13,2474.26,5,4,4,13,Champions
16423,1478,7,1482.21,1,1,3,5,Regulars
16424,441,13,3145.42,2,4,5,11,At Risk
16425,29,11,2333.7799999999997,5,3,4,12,Loyal
16426,789,6,529.51,1,1,1,3,Hibernating
16427,489,6,241.2,1,1,1,3,Hibernating
16428,161,13,1425.46,3,4,3,10,Regulars
16429,110,20,2651.28,4,5,5,14,Champions
16430,139,12,1078.79,4,4,2,10,Loyal
16431,201,9,4935.679999999999,3,2,5,10,Big Spenders
16432,169,14,1751.8600000000001,3,5,4,12,Big Spenders
16433,139,7,624.93,4,1,1,6,Regulars
16434,997,10,1164.2,1,3,2,6,Regulars
16435,262,10,3140.45,2,3,5,10,Regulars
16436,202,6,2371.09,3,1,4,8,Big Spenders
16437,616,8,2225.66,1,2,4,7,Regulars
16438,47,8,958.0500000000001,5,2,2,9,Regulars
16439,316,8,1030.24,2,2,2,6,Hibernating
16440,21,16,3778.26,5,5,5,15,Champions
16441,90,9,504.1,4,2,1,7,Regulars
16442,1293,9,2001.01,1,2,4,7,Regulars
16443,102,11,883.8,4,3,2,9,Loyal
16444,19,11,1704.62,5,3,3,11,Loyal
16445,185,11,2815.1600000000003,3,3,5,11,Big Spenders
16446,901,8,728.9399999999999,1,2,1,4,Hibernating
16447,336,9,1792.22,2,2,4,8,Regulars
16448,34,16,5154.54,5,5,5,15,Champions
16449,43,14,2930.23,5,5,5,15,Champions
16450,56,13,3213.21,5,4,5,14,Champions
16451,8,9,609.1999999999999,5,2,1,8,Regulars
16452,703,10,1203.59,1,3,2,6,Regulars
16453,74,8,892.64,4,2,2,8,Regulars
16454,335,9,4148.64,2,2,5,9,Regulars
16455,357,4,3731.24,2,1,5,8,Regulars
16456,83,9,1116.57,4,2,2,8,Regulars
16457,120,16,1706.2,4,5,3,12,Loyal
16458,156,9,1291.96,3,2,3,8,Regulars
16459,10,8,676.27,5,2,1,8,Regulars
16460,761,6,960.36,1,1,2,4,Hibernating
16461,100,11,1812.35,4,3,4,11,Loyal
16462,843,10,3270.4900000000002,1,3,5,9,Regulars
16463,296,7,651.72,2,1,1,4,Hibernating
16464,734,11,2604.73,1,3,5,9,Regulars
16465,100,11,1609.2,4,3,3,10,Loyal
16466,244,7,699.28,3,1,1,5,Regulars
16467,27,8,2459.56,5,2,4,11,Big Spenders
16468,270,15,3312.5299999999997,2,5,5,12,At Risk
16469,144,15,3489.42,4,5,5,14,Champions
16470,130,10,4956.7300000000005,4,3,5,12,Loyal
16471,224,10,2920.4900000000002,3,3,5,11,Big Spenders
16472,100,8,889.5799999999999,4,2,2,8,Regulars
16473,76,11,2094.64,4,3,4,11,Loyal
16474,828,8,751.82,1,2,1,4,Hibernating
16475,527,8,1169.07,1,2,2,5,Hibernating
16476,76,11,2051.77,4,3,4,11,Loyal
16477,237,11,947.0999999999999,3,3,2,8,Regulars
16478,35,4,431.17,5,1,1,7,Regulars
16479,114,10,940.29,4,3,2,9,Loyal
16480,241,8,2840.1,3,2,5,10,Big Spenders
16481,176,7,505.86,3,1,1,5,Regulars
16482,218,15,2106.4,3,5,4,12,Big Spenders
16483,178,10,770.74,3,3,1,7,Regulars
16484,87,6,240.04,4,1,1,6,Regulars
16485,112,12,2214.91,4,4,4,12,Champions
16486,50,13,4845.150000000001,5,4,5,14,Champions
16487,257,11,1242.71,2,3,3,8,Regulars
16488,1518,6,523.39,1,1,1,3,Hibernating
16489,23,8,1303.0800000000002,5,2,3,10,Regulars
16490,185,11,1909.6599999999999,3,3,4,10,Big Spenders
16491,153,19,1501.71,3,5,3,11,Regulars
16492,467,7,528.85,1,1,1,3,Hibernating
16493,209,12,1113.76,3,4,2,9,Regulars
16494,195,16,3474.54,3,5,5,13,Big Spenders
16495,73,12,1722.18,4,4,3,11,Loyal
16496,60,5,420.24,5,1,1,7,Regulars
16497,275,10,1891.63,2,3,4,9,Regulars
16498,96,10,684.41,4,3,1,8,Loyal
16499,89,11,879.32,4,3,2,9,Loyal
16500,295,11,923.02,2,3,2,7,Regulars
16501,41,10,1099.96,5,3,2,10,Loyal
16502,83,19,3837.02,4,5,5,14,Champions
16503,183,9,654.48,3,2,1,6,Regulars
16504,91,7,1245.25,4,1,3,8,Regulars
16505,1106,7,648.65,1,1,1,3,Hibernating
16506,473,13,4727.049999999999,1,4,5,10,At Risk
16507,206,7,692.65,3,1,1,5,Regulars
16508,302,15,2465.06,2,5,4,11,At Risk
16509,415,12,1106.63,2,4,2,8,At Risk
16510,279,13,1285.63,2,4,3,9,At Risk
16511,818,10,974.3299999999999,1,3,2,6,Regulars
16512,3,4,535.27,5,1,1,7,Regulars
16513,71,4,519.3499999999999,4,1,1,6,Regulars
16514,318,10,1653.81,2,3,3,8,Regulars
16515,96,11,1195.68,4,3,2,9,Loyal
16516,415,13,1428.76,2,4,3,9,At Risk
16517,378,5,393.18,2,1,1,4,Hibernating
16518,46,8,1250.75,5,2,3,10,Regulars
16519,362,12,1312.34,2,4,3,9,At Risk
16520,250,12,3174.67,2,4,5,11,At Risk
16521,398,6,2542.1899999999996,2,1,4,7,Regulars
16522,733,12,2255.09,1,4,4,9,At Risk
16523,61,8,1411.63,5,2,3,10,Regulars
16524,149,12,748.37,3,4,1,8,Regulars
16525,21,12,2358.52,5,4,4,13,Champions
16526,110,10,2697.93,4,3,5,12,Loyal
16527,164,8,445.41,3,2,1,6,Regulars
16528,329,14,2238.1400000000003,2,5,4,11,At Risk
16529,225,13,3726.78,3,4,5,12,Big Spenders
16530,116,13,1603.06,4,4,3,11,Loyal
16531,338,16,2078.85,2,5,4,11,At Risk
16532,187,13,2447.2200000000003,3,4,4,11,Big Spenders
16533,75,10,1957.71,4,3,4,11,Loyal
16534,156,7,440.7,3,1,1,5,Regulars
16535,484,8,1896.0100000000002,1,2,4,7,Regulars
16536,495,10,5129.160000000001,1,3,5,9,Regulars
16537,462,15,1496.46,1,5,3,9,At Risk
16538,297,11,1710.7,2,3,3,8,Regulars
16539,230,15,1974.99,3,5,4,12,Big Spenders
16540,172,7,2044.26,3,1,4,8,Big Spenders
16541,202,5,521.99,3,1,1,5,Regulars
16542,212,5,300.18,3,1,1,5,Regulars
16543,464,7,717.0500000000001,1,1,1,3,Hibernating
16544,119,7,1081.38,4,1,2,7,Regulars
16545,179,11,4880.89,3,3,5,11,Big Spenders
16546,103,8,958.76,4,2,2,8,Regulars
16547,187,8,1168.2199999999998,3,2,2,7,Regulars
16548,172,11,2397.9,3,3,4,10,Big Spenders
16549,867,6,538.29,1,1,1,3,Hibernating
16550,42,8,2677.61,5,2,5,12,Big Spenders
16551,64,6,433.81,5,1,1,7,Regulars
16552,836,3,228.63,1,1,1,3,Hibernating
16553,104,14,865.94,4,5,2,11,Loyal
16554,98,14,2858.4,4,5,5,14,Champions
16555,139,11,1419.75,4,3,3,10,Loyal
16556,128,10,931.92,4,3,2,9,Loyal
16557,290,7,625.01,2,1,1,4,Hibernating
16558,101,10,1265.05,4,3,3,10,Loyal
16559,833,6,560.72,1,1,1,3,Hibernating
16560,373,13,1314.1100000000001,2,4,3,9,At Risk
16561,860,7,843.72,1,1,1,3,Hibernating
16562,38,7,1450.62,5,1,3,9,Regulars
16563,316,9,2826.13,2,2,5,9,Regulars
16564,647,8,1233.2599999999998,1,2,2,5,Hibernating
16565,11,12,1340.31,5,4,3,12,Loyal
16566,103,10,1245.9899999999998,4,3,3,10,Loyal
16567,237,11,2294.5999999999995,3,3,4,10,Big Spenders
16568,4,10,2418.44,5,3,4,12,Loyal
16569,489,6,724.6,1,1,1,3,Hibernating
16570,945,6,1284.35,1,1,3,5,Regulars
16571,231,9,3172.71,3,2,5,10,Big Spenders
16572,542,10,1100.74,1,3,2,6,Regulars
16573,98,10,1763.44,4,3,4,11,Loyal
16574,44,10,644.37,5,3,1,9,Loyal
16575,245,16,2313.25,3,5,4,12,Big Spenders
16576,27,8,893.3699999999999,5,2,2,9,Regulars
16577,333,10,833.06,2,3,1,6,Regulars
16578,573,13,1103.15,1,4,2,7,At Risk
16579,735,7,735.46,1,1,1,3,Hibernating
16580,162,5,358.24,3,1,1,5,Regulars
16581,80,8,1407.8700000000001,4,2,3,9,Regulars
16582,190,7,1033.59,3,1,2,6,Regulars
16583,35,11,3363.29,5,3,5,13,Loyal
16584,385,8,544.19,2,2,1,5,Hibernating
16585,237,10,1456.8700000000001,3,3,3,9,Regulars
16586,753,5,2118.82,1,1,4,6,Regulars
16587,127,13,1609.77,4,4,3,11,Loyal
16588,756,9,1778.0,1,2,4,7,Regulars
16589,121,12,2742.46,4,4,5,13,Champions
16590,159,10,845.08,3,3,2,8,Regulars
16591,148,9,2037.8600000000001,3,2,4,9,Big Spenders
16592,272,10,715.07,2,3,1,6,Regulars
16593,38,8,551.3,5,2,1,8,Regulars
16594,101,14,3650.7200000000003,4,5,5,14,Champions
16595,18,7,2184.5899999999997,5,1,4,10,Big Spenders
16596,122,8,1053.3,4,2,2,8,Regulars
16597,40,20,2511.3900000000003,5,5,4,14,Champions
16598,36,12,2939.7,5,4,5,14,Champions
16599,89,20,2034.13,4,5,4,13,Champions
16600,600,9,1456.46,1,2,3,6,Regulars
16601,279,9,1147.42,2,2,2,6,Hibernating
16602,372,14,1439.12,2,5,3,10,At Risk
16603,1262,6,1575.18,1,1,3,5,Regulars
16604,488,5,231.51999999999998,1,1,1,3,Hibernating
16605,95,13,1205.55,4,4,2,10,Loyal
16606,69,9,1141.98,4,2,2,8,Regulars
16607,151,8,1891.33,3,2,4,9,Big Spenders
16608,187,17,2820.3,3,5,5,13,Big Spenders
16609,1183,8,945.0600000000001,1,2,2,5,Hibernating
16610,452,6,874.16,2,1,2,5,Hibernating
16611,680,9,1214.98,1,2,2,5,Hibernating
16612,22,12,1736.96,5,4,4,13,Champions
16613,201,10,1804.3600000000001,3,3,4,10,Big Spenders
16614,538,11,1312.82,1,3,3,7,Regulars
16615,39,13,4065.67,5,4,5,14,Champions
16616,59,8,2010.49,5,2,4,11,Big Spenders
16617,10,11,2546.45,5,3,4,12,Loyal
16618,266,9,611.02,2,2,1,5,Hibernating
16619,145,10,1914.08,4,3,4,11,Loyal
16620,96,11,1255.96,4,3,3,10,Loyal
16621,99,14,2228.16,4,5,4,13,Champions
16622,237,9,1569.73,3,2,3,8,Regulars
16623,69,13,3891.19,4,4,5,13,Champions
16624,470,9,507.49,1,2,1,4,Hibernating
16625,25,6,3067.19,5,1,5,11,Big Spenders
16626,62,6,1049.63,5,1,2,8,Regulars
16627,443,11,653.22,2,3,1,6,Regulars
16628,290,8,669.4200000000001,2,2,1,5,Hibernating
16629,175,11,2560.46,3,3,4,10,Big Spenders
16630,1111,9,3734.1300000000006,1,2,5,8,Regulars
16631,1124,4,222.57999999999998,1,1,1,3,Hibernating
16632,104,16,2645.9500000000003,4,5,5,14,Champions
16633,521,8,1647.55,1,2,3,6,Regulars
16634,93,11,650.39,4,3,1,8,Loyal
16635,195,13,2585.34,3,4,5,12,Big Spenders
16636,36,8,284.74,5,2,1,8,Regulars
16637,282,4,461.89,2,1,1,4,Hibernating
16638,689,11,1293.85,1,3,3,7,Regulars
16639,156,6,493.14,3,1,1,5,Regulars
16640,201,12,3370.41,3,4,5,12,Big Spenders
16641,533,9,2467.2,1,2,4,7,Regulars
16642,394,8,900.21,2,2,2,6,Hibernating
16643,313,8,1505.98,2,2,3,7,Regulars
16644,143,12,1632.04,4,4,3,11,Loyal
16645,63,9,657.36,5,2,1,8,Regulars
16646,193,9,1768.3899999999999,3,2,4,9,Big Spenders
16647,36,13,1867.26,5,4,4,13,Champions
16648,363,13,1743.71,2,4,4,10,At Risk
16649,440,7,715.3199999999999,2,1,1,4,Hibernating
16650,385,12,3127.2,2,4,5,11,At Risk
16651,244,15,1403.15,3,5,3,11,Regulars
16652,182,7,435.10999999999996,3,1,1,5,Regulars
16653,151,13,3117.17,3,4,5,12,Big Spenders
16654,35,5,826.22,5,1,1,7,Regulars
16655,511,8,804.4000000000001,1,2,1,4,Hibernating
16656,46,17,3614.95,5,5,5,15,Champions
16657,0,14,912.59,5,5,2,12,Loyal
16658,23,13,2225.57,5,4,4,13,Champions
16659,23,12,1836.1,5,4,4,13,Champions
16660,393,9,1141.07,2,2,2,6,Hibernating
16661,177,9,847.48,3,2,2,7,Regulars
16662,1304,5,639.5699999999999,1,1,1,3,Hibernating
16663,97,6,1246.23,4,1,3,8,Regulars
16664,1056,5,536.85,1,1,1,3,Hibernating
16665,226,10,692.38,3,3,1,7,Regulars
16666,100,11,1028.93,4,3,2,9,Loyal
16667,783,8,522.9,1,2,1,4,Hibernating
16668,285,9,1230.65,2,2,2,6,Hibernating
16669,255,8,1438.3500000000001,2,2,3,7,Regulars
16670,25,10,1761.59,5,3,4,12,Loyal
16671,231,11,1694.32,3,3,3,9,Regulars
16672,184,11,1141.5600000000002,3,3,2,8,Regulars
16673,626,13,2847.37,1,4,5,10,At Risk
16674,85,9,595.07,4,2,1,7,Regulars
16675,87,11,1052.32,4,3,2,9,Loyal
16676,25,10,1139.8700000000001,5,3,2,10,Loyal
16677,497,13,1638.1000000000001,1,4,3,8,At Risk
16678,204,9,1310.97,3,2,3,8,Regulars
16679,151,8,1142.02,3,2,2,7,Regulars
16680,933,3,222.25999999999996,1,1,1,3,Hibernating
16681,279,11,4213.41,2,3,5,10,Regulars
16682,19,12,1887.72,5,4,4,13,Champions
16683,224,11,2263.29,3,3,4,10,Big Spenders
16684,95,15,2214.7799999999997,4,5,4,13,Champions
16685,191,12,1564.02,3,4,3,10,Regulars
16686,1132,11,1665.67,1,3,3,7,Regulars
16687,19,13,1059.52,5,4,2,11,Loyal
16688,76,10,1433.31,4,3,3,10,Loyal
16689,16,7,2639.96,5,1,5,11,Big Spenders
16690,1039,10,1022.73,1,3,2,6,Regulars
16691,0,7,437.08000000000004,5,1,1,7,Regulars
16692,88,15,2170.98,4,5,4,13,Champions
16693,330,11,1651.85,2,3,3,8,Regulars
16694,28,13,1997.06,5,4,4,13,Champions
16695,571,5,274.93,1,1,1,3,Hibernating
16696,451,7,802.46,2,1,1,4,Hibernating
16697,225,12,2912.1400000000003,3,4,5,12,Big Spenders
16698,216,13,5620.599999999999,3,4,5,12,Big Spenders
16699,94,10,1772.03,4,3,4,11,Loyal
16700,80,16,1272.13,4,5,3,12,Loyal
16701,309,12,906.79,2,4,2,8,At Risk
16702,410,5,1709.3000000000002,2,1,3,6,Regulars
16703,28,9,1110.84,5,2,2,9,Regulars
16704,38,13,2503.23,5,4,4,13,Champions
16705,53,6,2341.18,5,1,4,10,Big Spenders
16706,73,6,1018.0699999999999,4,1,2,7,Regulars
16707,118,17,1937.06,4,5,4,13,Champions
16708,1328,7,2771.7200000000003,1,1,5,7,Regulars
16709,8,10,2634.27,5,3,5,13,Loyal
16710,115,7,528.81,4,1,1,6,Regulars
16711,351,11,1862.28,2,3,4,9,Regulars
16712,371,8,1497.97,2,2,3,7,Regulars
16713,78,13,1431.6299999999999,4,4,3,11,Loyal
16714,624,7,1019.6800000000001,1,1,2,4,Hibernating
16715,113,5,585.28,4,1,1,6,Regulars
16716,144,10,731.8,4,3,1,8,Loyal
16717,611,9,2695.36,1,2,5,8,Regulars
16718,280,11,1124.64,2,3,2,7,Regulars
16719,1044,10,567.17,1,3,1,5,Regulars
16720,184,14,1244.69,3,5,3,11,Regulars
16721,71,19,1157.28,4,5,2,11,Loyal
16722,99,18,3518.16,4,5,5,14,Champions
16723,706,9,939.87,1,2,2,5,Hibernating
16724,72,8,837.66,4,2,1,7,Regulars
16725,99,10,843.83,4,3,1,8,Loyal
16726,141,7,1629.8700000000001,4,1,3,8,Regulars
16727,42,10,2225.69,5,3,4,12,Loyal
16728,285,5,787.1800000000001,2,1,1,4,Hibernating
16729,191,11,2197.18,3,3,4,10,Big Spenders
16730,884,6,491.56,1,1,1,3,Hibernating
16731,67,8,993.6399999999999,4,2,2,8,Regulars
16732,114,14,3476.0399999999995,4,5,5,14,Champions
16733,441,7,1451.54,2,1,3,6,Regulars
16734,122,10,1123.79,4,3,2,9,Loyal
16735,488,13,1525.27,1,4,3,8,At Risk
16736,480,9,5161.67,1,2,5,8,Regulars
16737,696,9,1185.72,1,2,2,5,Hibernating
16738,292,11,2075.86,2,3,4,9,Regulars
16739,454,12,3516.89,2,4,5,11,At Risk
16740,62,9,2945.89,5,2,5,12,Big Spenders
16741,55,9,1068.84,5,2,2,9,Regulars
16742,400,6,416.71000000000004,2,1,1,4,Hibernating
16743,179,7,1137.14,3,1,2,6,Regulars
16744,42,13,1447.1200000000001,5,4,3,12,Loyal
16745,642,11,1514.87,1,3,3,7,Regulars
16746,207,11,1415.6,3,3,3,9,Regulars
16747,519,9,777.91,1,2,1,4,Hibernating
16748,0,15,2004.37,5,5,4,14,Champions
16749,199,13,2226.06,3,4,4,11,Big Spenders
16750,180,12,4081.9599999999996,3,4,5,12,Big Spenders
16751,1119,5,1994.5900000000001,1,1,4,6,Regulars
16752,14,9,818.88,5,2,1,8,Regulars
16753,13,12,3598.14,5,4,5,14,Champions
16754,195,16,2782.55,3,5,5,13,Big Spenders
16755,411,14,1982.45,2,5,4,11,At Risk
16756,50,11,1517.0900000000001,5,3,3,11,Loyal
16757,237,9,988.98,3,2,2,7,Regulars
16758,170,10,895.35,3,3,2,8,Regulars
16759,188,15,964.17,3,5,2,10,Regulars
16760,17,13,2125.24,5,4,4,13,Champions
16761,861,7,668.38,1,1,1,3,Hibernating
16762,19,12,1126.57,5,4,2,11,Loyal
16763,149,12,2022.1599999999999,3,4,4,11,Big Spenders
16764,54,12,2499.9300000000003,5,4,4,13,Champions
16765,1381,6,1030.97,1,1,2,4,Hibernating
16766,145,15,4981.88,4,5,5,14,Champions
16767,584,5,848.35,1,1,2,4,Hibernating
16768,127,9,1077.51,4,2,2,8,Regulars
16769,93,13,1286.6,4,4,3,11,Loyal
16770,268,12,983.86,2,4,2,8,At Risk
16771,124,12,1717.4,4,4,3,11,Loyal
16772,66,11,1923.95,4,3,4,11,Loyal
16773,33,10,814.12,5,3,1,9,Loyal
16774,302,8,1294.36,2,2,3,7,Regulars
16775,75,14,1286.82,4,5,3,12,Loyal
16776,768,10,1249.58,1,3,3,7,Regulars
16777,269,12,1248.54,2,4,3,9,At Risk
16778,109,9,3951.1900000000005,4,2,5,11,Big Spenders
16779,354,9,1137.64,2,2,2,6,Hibernating
16780,1105,5,641.64,1,1,1,3,Hibernating
16781,220,9,1877.6000000000001,3,2,4,9,Big Spenders
16782,908,11,1011.45,1,3,2,6,Regulars
16783,542,9,781.02,1,2,1,4,Hibernating
16784,265,11,1153.52,2,3,2,7,Regulars
16785,249,16,1927.25,2,5,4,11,At Risk
16786,308,11,2972.13,2,3,5,10,Regulars
16787,383,8,1367.22,2,2,3,7,Regulars
16788,133,7,2139.96,4,1,4,9,Big Spenders
16789,283,14,2525.06,2,5,4,11,At Risk
16790,210,11,1321.27,3,3,3,9,Regulars
16791,1001,4,823.2299999999999,1,1,1,3,Hibernating
16792,108,12,1203.45,4,4,2,10,Loyal
16793,175,13,1795.59,3,4,4,11,Big Spenders
16794,5,9,2401.68,5,2,4,11,Big Spenders
16795,243,13,2810.81,3,4,5,12,Big Spenders
16796,282,11,3436.1200000000003,2,3,5,10,Regulars
16797,127,11,700.19,4,3,1,8,Loyal
16798,169,13,2231.9500000000003,3,4,4,11,Big Spenders
16799,566,3,382.76,1,1,1,3,Hibernating
16800,172,7,879.01,3,1,2,6,Regulars
16801,278,13,3242.8399999999997,2,4,5,11,At Risk
16802,64,8,1398.15,5,2,3,10,Regulars
16803,72,12,2124.23,4,4,4,12,Champions
16804,156,7,661.36,3,1,1,5,Regulars
16805,1,9,771.9300000000001,5,2,1,8,Regulars
16806,74,14,3982.28,4,5,5,14,Champions
16807,46,8,597.74,5,2,1,8,Regulars
16808,453,9,836.14,2,2,1,5,Hibernating
16809,114,13,2147.26,4,4,4,12,Champions
16810,183,9,1234.05,3,2,2,7,Regulars
16811,141,12,3741.79,4,4,5,13,Champions
16812,195,5,912.5400000000001,3,1,2,6,Regulars
16813,1018,6,796.8299999999999,1,1,1,3,Hibernating
16814,325,12,1458.94,2,4,3,9,At Risk
16815,216,15,2629.71,3,5,5,13,Big Spenders
16816,66,15,3466.4599999999996,4,5,5,14,Champions
16817,106,13,2517.92,4,4,4,12,Champions
16818,18,9,824.5,5,2,1,8,Regulars
16819,156,10,1129.34,3,3,2,8,Regulars
16820,441,6,1224.6499999999999,2,1,2,5,Hibernating
16821,131,11,2391.94,4,3,4,11,Loyal
16822,644,8,647.9,1,2,1,4,Hibernating
16823,87,7,1948.6799999999998,4,1,4,9,Big Spenders
16824,1026,7,2350.09,1,1,4,6,Regulars
16825,449,10,1801.55,2,3,4,9,Regulars
16826,302,19,2509.67,2,5,4,11,At Risk
16827,6,14,1896.8999999999999,5,5,4,14,Champions
16828,42,7,1209.8500000000001,5,1,2,8,Regulars
16829,738,11,1419.6299999999999,1,3,3,7,Regulars
16830,459,11,2462.87,2,3,4,9,Regulars
16831,119,9,1302.73,4,2,3,9,Regulars
16832,447,13,2189.84,2,4,4,10,At Risk
16833,9,13,4190.900000000001,5,4,5,14,Champions
16834,152,10,2641.39,3,3,5,11,Big Spenders
16835,162,11,1201.44,3,3,2,8,Regulars
16836,1119,5,2906.08,1,1,5,7,Regulars
16837,53,12,885.07,5,4,2,11,Loyal
16838,167,10,1327.88,3,3,3,9,Regulars
16839,214,10,1250.99,3,3,3,9,Regulars
16840,38,11,1375.18,5,3,3,11,Loyal
16841,138,6,651.9000000000001,4,1,1,6,Regulars
16842,240,13,3206.1499999999996,3,4,5,12,Big Spenders
16843,241,10,2878.6100000000006,3,3,5,11,Big Spenders
16844,51,14,1545.0,5,5,3,13,Loyal
16845,99,7,515.69,4,1,1,6,Regulars
16846,121,11,1451.6,4,3,3,10,Loyal
16847,357,7,764.36,2,1,1,4,Hibernating
16848,23,13,2344.32,5,4,4,13,Champions
16849,588,10,908.27,1,3,2,6,Regulars
16850,391,8,2556.73,2,2,4,8,Regulars
16851,263,11,1849.3200000000002,2,3,4,9,Regulars
16852,1112,11,4397.07,1,3,5,9,Regulars
16853,92,10,1102.34,4,3,2,9,Loyal
16854,210,14,1794.7,3,5,4,12,Big Spenders
16855,627,10,842.28,1,3,1,5,Regulars
16856,122,11,1582.3200000000002,4,3,3,10,Loyal
16857,50,11,937.6300000000001,5,3,2,10,Loyal
16858,163,12,1626.21,3,4,3,10,Regulars
16859,25,8,3619.89,5,2,5,12,Big Spenders
16860,40,10,2906.05,5,3,5,13,Loyal
16861,210,11,613.61,3,3,1,7,Regulars
16862,585,11,984.3199999999999,1,3,2,6,Regulars
16863,504,9,1067.99,1,2,2,5,Hibernating
16864,3,11,3423.19,5,3,5,13,Loyal
16865,460,6,1783.17,1,1,4,6,Regulars
16866,97,9,2369.82,4,2,4,10,Big Spenders
16867,479,14,3207.94,1,5,5,11,At Risk
16868,250,6,1169.74,2,1,2,5,Hibernating
16869,103,10,1789.35,4,3,4,11,Loyal
16870,101,12,765.61,4,4,1,9,Loyal
16871,172,15,3707.83,3,5,5,13,Big Spenders
16872,25,6,715.97,5,1,1,7,Regulars
16873,43,11,1779.79,5,3,4,12,Loyal
16874,91,11,1594.8000000000002,4,3,3,10,Loyal
16875,521,6,599.9200000000001,1,1,1,3,Hibernating
16876,718,5,1361.0899999999997,1,1,3,5,Regulars
16877,22,12,1355.1399999999999,5,4,3,12,Loyal
16878,161,11,1664.8600000000001,3,3,3,9,Regulars
16879,13,11,692.82,5,3,1,9,Loyal
16880,1107,6,760.72,1,1,1,3,Hibernating
16881,119,17,3777.01,4,5,5,14,Champions
16882,189,12,1441.8000000000002,3,4,3,10,Regulars
16883,44,9,849.99,5,2,2,9,Regulars
16884,223,12,1736.8999999999999,3,4,4,11,Big Spenders
16885,27,6,750.88,5,1,1,7,Regulars
16886,537,10,1246.3899999999999,1,3,3,7,Regulars
16887,157,19,1274.01,3,5,3,11,Regulars
16888,498,13,2862.0,1,4,5,10,At Risk
16889,225,7,526.51,3,1,1,5,Regulars
16890,166,9,2479.06,3,2,4,9,Big Spenders
16891,125,11,1123.8899999999999,4,3,2,9,Loyal
16892,825,13,3223.67,1,4,5,10,At Risk
16893,143,12,1426.15,4,4,3,11,Loyal
16894,274,11,2762.99,2,3,5,10,Regulars
16895,127,9,931.51,4,2,2,8,Regulars
16896,296,8,655.82,2,2,1,5,Hibernating
16897,871,7,510.28000000000003,1,1,1,3,Hibernating
16898,134,9,1354.55,4,2,3,9,Regulars
16899,189,10,1723.44,3,3,3,9,Regulars
16900,72,14,1631.29,4,5,3,12,Loyal
16901,101,11,796.49,4,3,1,8,Loyal
16902,144,8,868.73,4,2,2,8,Regulars
16903,38,10,1391.6,5,3,3,11,Loyal
16904,65,9,609.11,5,2,1,8,Regulars
16905,36,9,755.85,5,2,1,8,Regulars
16906,124,10,1072.62,4,3,2,9,Loyal
16907,61,10,1073.1100000000001,5,3,2,10,Loyal
16908,920,5,394.59,1,1,1,3,Hibernating
16909,85,11,1912.24,4,3,4,11,Loyal
16910,545,10,1977.42,1,3,4,8,Regulars
16911,964,9,1234.13,1,2,2,5,Hibernating
16912,274,12,1591.04,2,4,3,9,At Risk
16913,344,9,1175.26,2,2,2,6,Hibernating
16914,282,12,2240.58,2,4,4,10,At Risk
16915,67,7,779.62,4,1,1,6,Regulars
16916,336,8,3092.29,2,2,5,9,Regulars
16917,379,7,2134.86,2,1,4,7,Regulars
16918,101,8,745.32,4,2,1,7,Regulars
16919,169,8,1890.16,3,2,4,9,Big Spenders
16920,759,8,947.02,1,2,2,5,Hibernating
16921,127,14,1836.4199999999998,4,5,4,13,Champions
16922,167,11,1103.98,3,3,2,8,Regulars
16923,586,10,1521.73,1,3,3,7,Regulars
16924,317,9,906.42,2,2,2,6,Hibernating
16925,378,5,122.19,2,1,1,4,Hibernating
16926,172,16,1808.63,3,5,4,12,Big Spenders
16927,1035,5,553.87,1,1,1,3,Hibernating
16928,151,12,1250.16,3,4,3,10,Regulars
16929,213,5,940.31,3,1,2,6,Regulars
16930,19,11,1719.9,5,3,3,11,Loyal
16931,284,8,639.47,2,2,1,5,Hibernating
16932,527,6,532.65,1,1,1,3,Hibernating
16933,149,11,1554.52,3,3,3,9,Regulars
16934,199,11,1511.3500000000001,3,3,3,9,Regulars
16935,1091,11,1579.9599999999998,1,3,3,7,Regulars
16936,162,9,990.29,3,2,2,7,Regulars
16937,155,11,660.02,3,3,1,7,Regulars
16938,307,13,1263.16,2,4,3,9,At Risk
16939,96,11,2730.41,4,3,5,12,Loyal
16940,15,7,708.77,5,1,1,7,Regulars
16941,1066,7,450.06,1,1,1,3,Hibernating
16942,196,9,834.4300000000001,3,2,1,6,Regulars
16943,564,11,1249.84,1,3,3,7,Regulars
16944,896,8,2047.71,1,2,4,7,Regulars
16945,513,14,2577.09,1,5,5,11,At Risk
16946,10,14,2673.8300000000004,5,5,5,15,Champions
16947,223,13,1114.49,3,4,2,9,Regulars
16948,392,6,776.26,2,1,1,4,Hibernating
16949,199,10,1054.58,3,3,2,8,Regulars
16950,82,11,952.91,4,3,2,9,Loyal
16951,47,12,1667.42,5,4,3,12,Loyal
16952,156,9,1026.14,3,2,2,7,Regulars
16953,38,7,2443.5899999999997,5,1,4,10,Big Spenders
16954,629,7,2218.37,1,1,4,6,Regulars
16955,537,12,3006.43,1,4,5,10,At Risk
16956,481,9,1075.45,1,2,2,5,Hibernating
16957,443,6,397.5,2,1,1,4,Hibernating
16958,292,6,1625.32,2,1,3,6,Regulars
16959,101,11,2468.09,4,3,4,11,Loyal
16960,480,11,1394.27,1,3,3,7,Regulars
16961,218,6,579.02,3,1,1,5,Regulars
16962,258,11,1068.92,2,3,2,7,Regulars
16963,543,8,2231.88,1,2,4,7,Regulars
16964,81,5,906.3399999999999,4,1,2,7,Regulars
16965,518,9,1086.25,1,2,2,5,Hibernating
16966,119,4,245.85000000000002,4,1,1,6,Regulars
16967,800,7,822.48,1,1,1,3,Hibernating
16968,52,10,1059.14,5,3,2,10,Loyal
16969,10,20,2735.71,5,5,5,15,Champions
16970,202,11,2174.58,3,3,4,10,Big Spenders
16971,438,9,635.81,2,2,1,5,Hibernating
16972,54,9,1559.5,5,2,3,10,Regulars
16973,244,9,716.21,3,2,1,6,Regulars
16974,156,8,629.17,3,2,1,6,Regulars
16975,267,17,2920.98,2,5,5,12,At Risk
16976,5,11,1713.49,5,3,3,11,Loyal
16977,271,18,2874.1099999999997,2,5,5,12,At Risk
16978,472,12,1251.91,1,4,3,8,At Risk
16979,644,13,1226.78,1,4,2,7,At Risk
16980,21,8,1239.2,5,2,2,9,Regulars
16981,487,6,722.6,1,1,1,3,Hibernating
16982,842,7,1078.69,1,1,2,4,Hibernating
16983,83,11,4101.01,4,3,5,12,Loyal
16984,192,15,1573.1399999999999,3,5,3,11,Regulars
16985,65,14,1693.8400000000001,5,5,3,13,Loyal
16986,212,8,384.02,3,2,1,6,Regulars
16987,100,7,1764.8899999999999,4,1,4,9,Big Spenders
16988,209,8,402.01,3,2,1,6,Regulars
16989,442,5,336.35999999999996,2,1,1,4,Hibernating
16990,491,10,2885.78,1,3,5,9,Regulars
16991,33,12,1171.33,5,4,2,11,Loyal
16992,128,10,890.21,4,3,2,9,Loyal
16993,403,8,1721.7,2,2,3,7,Regulars
16994,529,10,6291.61,1,3,5,9,Regulars
16995,36,7,1153.26,5,1,2,8,Regulars
16996,431,9,2061.36,2,2,4,8,Regulars
16997,79,13,1922.67,4,4,4,12,Champions
16998,139,11,773.04,4,3,1,8,Loyal
16999,51,8,503.40999999999997,5,2,1,8,Regulars
17000,70,7,635.13,4,1,1,6,Regulars
17001,56,14,2748.98,5,5,5,15,Champions
17002,21,8,443.40000000000003,5,2,1,8,Regulars
17003,545,12,1772.51,1,4,4,9,At Risk
17004,106,11,1148.83,4,3,2,9,Loyal
17005,19,10,782.23,5,3,1,9,Loyal
17006,562,12,2147.5,1,4,4,9,At Risk
17007,586,8,1566.97,1,2,3,6,Regulars
17008,176,9,1280.76,3,2,3,8,Regulars
17009,119,14,3479.88,4,5,5,14,Champions
17010,37,8,1273.75,5,2,3,10,Regulars
17011,194,6,506.76,3,1,1,5,Regulars
17012,219,14,5233.3,3,5,5,13,Big Spenders
17013,350,7,925.3199999999999,2,1,2,5,Hibernating
17014,801,8,895.74,1,2,2,5,Hibernating
17015,380,8,1165.32,2,2,2,6,Hibernating
17016,639,8,3359.19,1,2,5,8,Regulars
17017,536,9,745.47,1,2,1,4,Hibernating
17018,328,9,871.96,2,2,2,6,Hibernating
17019,284,12,1233.6399999999999,2,4,2,8,At Risk
17020,522,11,2823.77,1,3,5,9,Regulars
17021,295,10,1656.01,2,3,3,8,Regulars
17022,197,9,1469.7,3,2,3,8,Regulars
17023,65,5,652.56,5,1,1,7,Regulars
17024,181,18,3518.82,3,5,5,13,Big Spenders
17025,182,7,509.59999999999997,3,1,1,5,Regulars
17026,259,9,758.95,2,2,1,5,Hibernating
17027,98,10,4817.11,4,3,5,12,Loyal
17028,467,9,651.99,1,2,1,4,Hibernating
17029,20,13,1420.57,5,4,3,12,Loyal
17030,500,7,909.89,1,1,2,4,Hibernating
17031,36,13,2522.13,5,4,4,13,Champions
17032,153,12,1131.04,3,4,2,9,Regulars
17033,674,10,1496.8600000000001,1,3,3,7,Regulars
17034,109,17,2450.11,4,5,4,13,Champions
17035,110,13,2044.8000000000002,4,4,4,12,Champions
17036,150,9,2337.44,3,2,4,9,Big Spenders
17037,135,7,1614.0,4,1,3,8,Regulars
17038,5,13,926.4300000000001,5,4,2,11,Loyal
17039,12,10,2230.81,5,3,4,12,Loyal
17040,272,7,676.85,2,1,1,4,Hibernating
17041,131,9,2949.58,4,2,5,11,Big Spenders
17042,119,9,1412.48,4,2,3,9,Regulars
17043,540,15,5844.31,1,5,5,11,At Risk
17044,213,13,2971.93,3,4,5,12,Big Spenders
17045,855,7,1241.1,1,1,3,5,Regulars
17046,422,7,676.19,2,1,1,4,Hibernating
17047,0,11,1085.9,5,3,2,10,Loyal
17048,391,11,1468.23,2,3,3,8,Regulars
17049,698,7,1214.6299999999999,1,1,2,4,Hibernating
17050,373,15,4103.46,2,5,5,12,At Risk
17051,160,11,1084.49,3,3,2,8,Regulars
17052,134,8,1025.17,4,2,2,8,Regulars
17053,40,11,2671.41,5,3,5,13,Loyal
17054,36,7,397.20000000000005,5,1,1,7,Regulars
17055,235,12,2828.6400000000003,3,4,5,12,Big Spenders
17056,154,9,1069.01,3,2,2,7,Regulars
17057,86,6,820.53,4,1,1,6,Regulars
17058,45,11,1089.83,5,3,2,10,Loyal
17059,28,5,573.52,5,1,1,7,Regulars
17060,168,7,1117.76,3,1,2,6,Regulars
17061,33,8,2029.95,5,2,4,11,Big Spenders
17062,356,8,751.0600000000001,2,2,1,5,Hibernating
17063,82,14,2962.49,4,5,5,14,Champions
17064,160,9,693.6700000000001,3,2,1,6,Regulars
17065,819,9,2889.96,1,2,5,8,Regulars
17066,215,10,1707.95,3,3,3,9,Regulars
17067,98,8,1377.54,4,2,3,9,Regulars
17068,79,15,5253.620000000001,4,5,5,14,Champions
17069,99,13,4054.19,4,4,5,13,Champions
17070,194,14,1600.79,3,5,3,11,Regulars
17071,221,15,1184.1499999999999,3,5,2,10,Regulars
17072,102,5,390.21,4,1,1,6,Regulars
17073,205,10,845.6700000000001,3,3,2,8,Regulars
17074,221,10,882.0699999999999,3,3,2,8,Regulars
17075,218,14,1484.81,3,5,3,11,Regulars
17076,908,7,627.3199999999999,1,1,1,3,Hibernating
17077,201,10,1287.1100000000001,3,3,3,9,Regulars
17078,16,14,4619.2300000000005,5,5,5,15,Champions
17079,416,14,2353.96,2,5,4,11,At Risk
17080,26,10,757.13,5,3,1,9,Loyal
17081,145,11,760.74,4,3,1,8,Loyal
17082,350,13,1612.98,2,4,3,9,At Risk
17083,677,10,731.99,1,3,1,5,Regulars
17084,243,7,332.76,3,1,1,5,Regulars
17085,234,12,3666.4,3,4,5,12,Big Spenders
17086,10,5,459.06,5,1,1,7,Regulars
17087,585,7,1319.28,1,1,3,5,Regulars
17088,572,11,713.1999999999999,1,3,1,5,Regulars
17089,28,13,2630.9100000000003,5,4,5,14,Champions
17090,81,13,3182.6,4,4,5,13,Champions
17091,128,11,1076.03,4,3,2,9,Loyal
17092,132,10,556.31,4,3,1,8,Loyal
17093,54,12,1512.25,5,4,3,12,Loyal
17094,85,10,3020.18,4,3,5,12,Loyal
17095,358,11,1627.93,2,3,3,8,Regulars
17096,308,4,732.7,2,1,1,4,Hibernating
17097,328,3,219.57000000000002,2,1,1,4,Hibernating
17098,313,9,968.4499999999999,2,2,2,6,Hibernating
17099,158,13,1703.7299999999998,3,4,3,10,Regulars
17100,154,14,1459.97,3,5,3,11,Regulars
17101,398,11,1426.1399999999999,2,3,3,8,Regulars
17102,283,6,926.8800000000001,2,1,2,5,Hibernating
17103,230,15,4597.63,3,5,5,13,Big Spenders
17104,266,8,1014.82,2,2,2,6,Hibernating
17105,6,13,1871.32,5,4,4,13,Champions
17106,229,11,1780.23,3,3,4,10,Big Spenders
17107,283,6,1173.53,2,1,2,5,Hibernating
17108,869,8,2621.6000000000004,1,2,5,8,Regulars
17109,515,11,1443.26,1,3,3,7,Regulars
17110,231,6,507.32,3,1,1,5,Regulars
17111,139,10,853.79,4,3,2,9,Loyal
17112,335,10,3037.2200000000003,2,3,5,10,Regulars
17113,307,9,966.8900000000001,2,2,2,6,Hibernating
17114,138,10,2086.44,4,3,4,11,Loyal
17115,630,7,827.66,1,1,1,3,Hibernating
17116,427,9,2532.91,2,2,4,8,Regulars
17117,164,10,2859.2999999999997,3,3,5,11,Big Spenders
17118,100,14,2815.58,4,5,5,14,Champions
17119,46,13,1949.34,5,4,4,13,Champions
17120,96,6,1371.73,4,1,3,8,Regulars
17121,47,10,1021.1999999999999,5,3,2,10,Loyal
17122,122,11,1777.63,4,3,4,11,Loyal
17123,433,4,944.2900000000001,2,1,2,5,Hibernating
17124,154,9,744.83,3,2,1,6,Regulars
17125,19,7,467.46,5,1,1,7,Regulars
17126,75,9,1079.38,4,2,2,8,Regulars
17127,327,9,4316.63,2,2,5,9,Regulars
17128,217,10,1515.26,3,3,3,9,Regulars
17129,421,9,3388.05,2,2,5,9,Regulars
17130,258,8,1621.88,2,2,3,7,Regulars
17131,310,8,1056.54,2,2,2,6,Hibernating
17132,108,13,1650.1100000000001,4,4,3,11,Loyal
17133,19,20,2454.09,5,5,4,14,Champions
17134,275,12,825.6999999999999,2,4,1,7,At Risk
17135,280,15,2839.64,2,5,5,12,At Risk
17136,537,10,3339.0,1,3,5,9,Regulars
17137,31,12,2438.82,5,4,4,13,Champions
17138,2,13,2631.86,5,4,5,14,Champions
17139,148,11,1439.72,3,3,3,9,Regulars
17140,574,10,568.32,1,3,1,5,Regulars
17141,69,9,627.0600000000001,4,2,1,7,Regulars
17142,90,13,1614.71,4,4,3,11,Loyal
17143,381,11,4126.360000000001,2,3,5,10,Regulars
17144,302,12,746.9,2,4,1,7,At Risk
17145,154,11,831.29,3,3,1,7,Regulars
17146,134,13,1631.94,4,4,3,11,Loyal
17147,622,7,1078.8999999999999,1,1,2,4,Hibernating
17148,158,12,3611.91,3,4,5,12,Big Spenders
17149,210,13,1894.97,3,4,4,11,Big Spenders
17150,172,14,3470.9399999999996,3,5,5,13,Big Spenders
17151,167,9,1944.09,3,2,4,9,Big Spenders
17152,281,15,3919.62,2,5,5,12,At Risk
17153,561,8,1124.51,1,2,2,5,Hibernating
17154,259,4,806.6,2,1,1,4,Hibernating
17155,232,12,1392.12,3,4,3,10,Regulars
17156,442,9,617.52,2,2,1,5,Hibernating
17157,262,14,1823.27,2,5,4,11,At Risk
17158,47,17,1819.1699999999998,5,5,4,14,Champions
17159,561,11,989.0699999999999,1,3,2,6,Regulars
17160,435,10,701.23,2,3,1,6,Regulars
17161,155,13,3846.1,3,4,5,12,Big Spenders
17162,26,10,1587.62,5,3,3,11,Loyal
17163,139,9,3015.75,4,2,5,11,Big Spenders
17164,74,10,987.59,4,3,2,9,Loyal
17165,639,9,1940.13,1,2,4,7,Regulars
17166,1152,10,3269.88,1,3,5,9,Regulars
17167,188,15,3616.02,3,5,5,13,Big Spenders
17168,43,10,1793.4199999999998,5,3,4,12,Loyal
17169,118,12,1342.77,4,4,3,11,Loyal
17170,179,4,464.09,3,1,1,5,Regulars
17171,118,12,2062.8900000000003,4,4,4,12,Champions
17172,182,11,940.6800000000001,3,3,2,8,Regulars
17173,460,15,3858.96,1,5,5,11,At Risk
17174,9,13,4818.650000000001,5,4,5,14,Champions
17175,362,7,1403.97,2,1,3,6,Regulars
17176,46,11,775.4399999999999,5,3,1,9,Loyal
17177,809,12,1067.84,1,4,2,7,At Risk
17178,78,7,692.13,4,1,1,6,Regulars
17179,230,10,2311.32,3,3,4,10,Big Spenders
17180,152,14,1070.95,3,5,2,10,Regulars
17181,142,11,2242.6,4,3,4,11,Loyal
17182,163,9,878.8199999999999,3,2,2,7,Regulars
17183,84,5,727.63,4,1,1,6,Regulars
17184,182,7,781.28,3,1,1,5,Regulars
17185,518,8,719.98,1,2,1,4,Hibernating
17186,277,13,3233.3,2,4,5,11,At Risk
17187,51,11,1577.1000000000001,5,3,3,11,Loyal
17188,124,10,766.44,4,3,1,8,Loyal
17189,193,7,1362.51,3,1,3,7,Regulars
17190,236,9,1977.79,3,2,4,9,Big Spenders
17191,9,15,3217.79,5,5,5,15,Champions
17192,233,12,4259.38,3,4,5,12,Big Spenders
17193,2,12,3094.58,5,4,5,14,Champions
17194,68,9,1331.51,4,2,3,9,Regulars
17195,447,7,1682.5800000000002,2,1,3,6,Regulars
17196,129,12,4041.5099999999998,4,4,5,13,Champions
17197,359,15,1708.58,2,5,3,10,At Risk
17198,30,11,1625.21,5,3,3,11,Loyal
17199,383,13,1860.26,2,4,4,10,At Risk
17200,580,9,4616.43,1,2,5,8,Regulars
17201,28,11,1503.67,5,3,3,11,Loyal
17202,43,8,1461.19,5,2,3,10,Regulars
17203,583,9,595.5699999999999,1,2,1,4,Hibernating
17204,85,11,1433.99,4,3,3,10,Loyal
17205,67,9,914.8000000000001,4,2,2,8,Regulars
17206,41,6,423.28,5,1,1,7,Regulars
17207,30,7,819.75,5,1,1,7,Regulars
17208,295,10,750.55,2,3,1,6,Regulars
17209,308,11,958.38,2,3,2,7,Regulars
17210,85,15,1755.73,4,5,4,13,Champions
17211,371,13,3202.8300000000004,2,4,5,11,At Risk
17212,63,10,779.71,5,3,1,9,Loyal
17213,613,5,1091.01,1,1,2,4,Hibernating
17214,165,8,679.0699999999999,3,2,1,6,Regulars
17215,513,17,3662.72,1,5,5,11,At Risk
17216,92,8,1962.47,4,2,4,10,Big Spenders
17217,93,11,1082.94,4,3,2,9,Loyal
17218,950,5,454.1,1,1,1,3,Hibernating
17219,8,11,1990.76,5,3,4,12,Loyal
17220,155,11,1685.0700000000002,3,3,3,9,Regulars
17221,167,7,606.4499999999999,3,1,1,5,Regulars
17222,150,15,3668.94,3,5,5,13,Big Spenders
17223,197,9,1904.74,3,2,4,9,Big Spenders
17224,14,10,1559.8700000000001,5,3,3,11,Loyal
17225,133,9,403.69,4,2,1,7,Regulars
17226,535,16,2355.1,1,5,4,10,At Risk
17227,152,12,1671.5,3,4,3,10,Regulars
17228,19,12,1252.6,5,4,3,12,Loyal
17229,148,11,1634.7,3,3,3,9,Regulars
17230,456,10,3969.14,2,3,5,10,Regulars
17231,50,7,1077.3000000000002,5,1,2,8,Regulars
17232,415,10,1385.01,2,3,3,8,Regulars
17233,188,8,688.12,3,2,1,6,Regulars
17234,809,11,1967.3100000000002,1,3,4,8,Regulars
17235,0,8,1224.31,5,2,2,9,Regulars
17236,469,3,76.91,1,1,1,3,Hibernating
17237,586,9,1310.8700000000001,1,2,3,6,Regulars
17238,238,10,1208.46,3,3,2,8,Regulars
17239,123,14,1382.82,4,5,3,12,Loyal
17240,59,9,2884.1899999999996,5,2,5,12,Big Spenders
17241,13,10,1145.07,5,3,2,10,Loyal
17242,577,10,739.18,1,3,1,5,Regulars
17243,188,11,1452.02,3,3,3,9,Regulars
17244,38,8,683.7800000000001,5,2,1,8,Regulars
17245,135,14,1064.12,4,5,2,11,Loyal
17246,115,9,435.41999999999996,4,2,1,7,Regulars
17247,287,11,3309.13,2,3,5,10,Regulars
17248,66,9,2008.6399999999999,4,2,4,10,Big Spenders
17249,802,7,1078.76,1,1,2,4,Hibernating
17250,281,8,753.6500000000001,2,2,1,5,Hibernating
17251,361,10,1266.73,2,3,3,8,Regulars
17252,115,9,2093.09,4,2,4,10,Big Spenders
17253,721,10,887.11,1,3,2,6,Regulars
17254,132,11,1409.01,4,3,3,10,Loyal
17255,163,8,839.61,3,2,1,6,Regulars
17256,1794,6,905.44,1,1,2,4,Hibernating
17257,270,7,1376.48,2,1,3,6,Regulars
17258,721,10,1324.7,1,3,3,7,Regulars
17259,39,8,2353.05,5,2,4,11,Big Spenders
17260,395,18,2583.85,2,5,5,12,At Risk
17261,313,13,1648.95,2,4,3,9,At Risk
17262,879,7,941.05,1,1,2,4,Hibernating
17263,64,15,4616.62,5,5,5,15,Champions
17264,94,11,1708.15,4,3,3,10,Loyal
17265,52,11,1302.24,5,3,3,11,Loyal
17266,5,10,5030.5,5,3,5,13,Loyal
17267,223,11,620.07,3,3,1,7,Regulars
17268,91,9,2617.96,4,2,5,11,Big Spenders
17269,120,6,971.88,4,1,2,7,Regulars
17270,665,8,1363.7,1,2,3,6,Regulars
17271,29,13,4206.35,5,4,5,14,Champions
17272,345,9,2059.42,2,2,4,8,Regulars
17273,302,9,3501.94,2,2,5,9,Regulars
17274,164,7,1734.73,3,1,4,8,Big Spenders
17275,312,8,962.23,2,2,2,6,Hibernating
17276,372,10,2193.37,2,3,4,9,Regulars
17277,546,9,775.11,1,2,1,4,Hibernating
17278,130,14,2710.17,4,5,5,14,Champions
17279,52,12,3642.8800000000006,5,4,5,14,Champions
17280,184,13,2406.5699999999997,3,4,4,11,Big Spenders
17281,368,10,2307.62,2,3,4,9,Regulars
17282,474,9,1571.34,1,2,3,6,Regulars
17283,186,3,1041.46,3,1,2,6,Regulars
17284,579,14,3632.23,1,5,5,11,At Risk
17285,767,7,742.8199999999999,1,1,1,3,Hibernating
17286,275,10,2840.6800000000003,2,3,5,10,Regulars
17287,197,8,1166.56,3,2,2,7,Regulars
17288,496,11,1049.04,1,3,2,6,Regulars
17289,194,8,611.3399999999999,3,2,1,6,Regulars
17290,251,8,934.07,2,2,2,6,Hibernating
17291,261,9,1648.94,2,2,3,7,Regulars
17292,266,11,1067.7,2,3,2,7,Regulars
17293,19,17,2586.19,5,5,5,15,Champions
17294,116,11,5013.6,4,3,5,12,Loyal
17295,166,7,1969.5100000000002,3,1,4,8,Big Spenders
17296,199,10,811.9200000000001,3,3,1,7,Regulars
17297,36,9,1351.93,5,2,3,10,Regulars
17298,595,7,555.8199999999999,1,1,1,3,Hibernating
17299,233,12,1233.79,3,4,2,9,Regulars
17300,101,11,2555.8599999999997,4,3,4,11,Loyal
17301,669,9,540.8000000000001,1,2,1,4,Hibernating
17302,226,9,823.52,3,2,1,6,Regulars
17303,310,7,495.27,2,1,1,4,Hibernating
17304,243,15,2031.85,3,5,4,12,Big Spenders
17305,113,9,590.28,4,2,1,7,Regulars
17306,180,11,3478.54,3,3,5,11,Big Spenders
17307,113,15,1742.42,4,5,4,13,Champions
17308,122,11,1417.17,4,3,3,10,Loyal
17309,29,9,2526.83,5,2,4,11,Big Spenders
17310,452,7,310.65999999999997,2,1,1,4,Hibernating
17311,304,11,1322.0700000000002,2,3,3,8,Regulars
17312,670,13,1406.39,1,4,3,8,At Risk
17313,594,7,630.1400000000001,1,1,1,3,Hibernating
17314,1146,8,2263.96,1,2,4,7,Regulars
17315,131,15,1630.26,4,5,3,12,Loyal
17316,83,14,1136.22,4,5,2,11,Loyal
17317,417,12,2027.36,2,4,4,10,At Risk
17318,26,9,1888.02,5,2,4,11,Big Spenders
17319,97,8,926.92,4,2,2,8,Regulars
17320,252,16,1777.04,2,5,4,11,At Risk
17321,199,7,2184.36,3,1,4,8,Big Spenders
17322,74,12,1386.56,4,4,3,11,Loyal
17323,152,6,522.4300000000001,3,1,1,5,Regulars
17324,78,15,1592.1399999999999,4,5,3,12,Loyal
17325,321,10,1305.72,2,3,3,8,Regulars
17326,666,11,1998.1,1,3,4,8,Regulars
17327,879,11,2246.35,1,3,4,8,Regulars
17328,791,5,1095.48,1,1,2,4,Hibernating
17329,343,7,1530.1200000000001,2,1,3,6,Regulars
17330,157,7,1095.8899999999999,3,1,2,6,Regulars
17331,613,8,895.0,1,2,2,5,Hibernating
17332,345,6,760.31,2,1,1,4,Hibernating
17333,144,10,1862.38,4,3,4,11,Loyal
17334,27,15,2233.59,5,5,4,14,Champions
17335,187,6,235.01,3,1,1,5,Regulars
17336,367,6,515.36,2,1,1,4,Hibernating
17337,99,15,2001.3000000000002,4,5,4,13,Champions
17338,372,7,693.75,2,1,1,4,Hibernating
17339,170,15,2128.59,3,5,4,12,Big Spenders
17340,14,5,2184.56,5,1,4,10,Big Spenders
17341,26,15,1396.18,5,5,3,13,Loyal
17342,16,13,2575.94,5,4,5,14,Champions
17343,72,6,1098.17,4,1,2,7,Regulars
17344,141,8,828.7,4,2,1,7,Regulars
17345,127,10,3475.76,4,3,5,12,Loyal
17346,38,9,1081.41,5,2,2,9,Regulars
17347,30,13,1665.19,5,4,3,12,Loyal
17348,233,10,1527.48,3,3,3,9,Regulars
17349,213,9,2024.3000000000002,3,2,4,9,Big Spenders
17350,1921,6,1076.78,1,1,2,4,Hibernating
17351,250,10,1022.16,2,3,2,7,Regulars
17352,430,7,565.02,2,1,1,4,Hibernating
17353,284,9,694.71,2,2,1,5,Hibernating
17354,265,10,561.51,2,3,1,6,Regulars
17355,28,11,4525.86,5,3,5,13,Loyal
17356,151,8,1038.96,3,2,2,7,Regulars
17357,3,11,1484.26,5,3,3,11,Loyal
17358,72,14,4866.13,4,5,5,14,Champions
17359,263,11,2575.63,2,3,5,10,Regulars
17360,602,13,3848.1499999999996,1,4,5,10,At Risk
17361,104,15,1417.25,4,5,3,12,Loyal
17362,616,12,2465.91,1,4,4,9,At Risk
17363,244,11,1974.92,3,3,4,10,Big Spenders
17364,58,16,3523.79,5,5,5,15,Champions
17365,763,8,1128.22,1,2,2,5,Hibernating
17366,6,14,2889.11,5,5,5,15,Champions
17367,79,11,996.94,4,3,2,9,Loyal
17368,269,8,2694.84,2,2,5,9,Regulars
17369,193,11,1158.58,3,3,2,8,Regulars
17370,4,19,3655.94,5,5,5,15,Champions
17371,337,13,1704.3600000000001,2,4,3,9,At Risk
17372,98,14,1841.1299999999999,4,5,4,13,Champions
17373,166,15,1014.94,3,5,2,10,Regulars
17374,272,12,821.0,2,4,1,7,At Risk
17375,40,13,879.3399999999999,5,4,2,11,Loyal
17376,672,7,2079.96,1,1,4,6,Regulars
17377,1156,5,344.71000000000004,1,1,1,3,Hibernating
17378,125,9,809.7,4,2,1,7,Regulars
17379,28,8,933.13,5,2,2,9,Regulars
17380,219,16,1402.37,3,5,3,11,Regulars
17381,294,9,846.12,2,2,2,6,Hibernating
17382,229,14,1723.44,3,5,3,11,Regulars
17383,61,16,2934.94,5,5,5,15,Champions
17384,226,9,4650.47,3,2,5,10,Big Spenders
17385,301,9,1584.17,2,2,3,7,Regulars
17386,79,9,1030.26,4,2,2,8,Regulars
17387,681,7,1307.85,1,1,3,5,Regulars
17388,280,9,1447.6499999999999,2,2,3,7,Regulars
17389,36,12,1310.56,5,4,3,12,Loyal
17390,259,10,394.24,2,3,1,6,Regulars
17391,83,8,961.56,4,2,2,8,Regulars
17392,225,14,2584.56,3,5,5,13,Big Spenders
17393,4,8,2546.55,5,2,4,11,Big Spenders
17394,10,13,2038.49,5,4,4,13,Champions
17395,183,8,1379.32,3,2,3,8,Regulars
17396,27,5,921.0799999999999,5,1,2,8,Regulars
17397,819,13,1348.86,1,4,3,8,At Risk
17398,412,4,442.89,2,1,1,4,Hibernating
17399,894,8,558.74,1,2,1,4,Hibernating
17400,21,6,1184.38,5,1,2,8,Regulars
17401,548,17,4203.47,1,5,5,11,At Risk
17402,900,8,4091.13,1,2,5,8,Regulars
17403,85,10,862.2,4,3,2,9,Loyal
17404,166,15,4416.67,3,5,5,13,Big Spenders
17405,435,7,3529.61,2,1,5,8,Regulars
17406,58,13,1583.75,5,4,3,12,Loyal
17407,259,14,1235.47,2,5,2,9,At Risk
17408,231,16,1530.16,3,5,3,11,Regulars
17409,391,4,776.38,2,1,1,4,Hibernating
17410,242,10,1469.8400000000001,3,3,3,9,Regulars
17411,82,11,1719.8899999999999,4,3,3,10,Loyal
17412,67,7,511.44000000000005,4,1,1,6,Regulars
17413,605,10,2328.38,1,3,4,8,Regulars
17414,23,11,1314.4,5,3,3,11,Loyal
17415,50,14,2267.93,5,5,4,14,Champions
17416,204,7,969.54,3,1,2,6,Regulars
17417,159,15,2046.46,3,5,4,12,Big Spenders
17418,80,10,609.4300000000001,4,3,1,8,Loyal
17419,2,9,525.4300000000001,5,2,1,8,Regulars
17420,348,7,676.33,2,1,1,4,Hibernating
17421,198,11,1935.46,3,3,4,10,Big Spenders
17422,119,11,861.1600000000001,4,3,2,9,Loyal
17423,50,17,3512.8100000000004,5,5,5,15,Champions
17424,256,10,1351.08,2,3,3,8,Regulars
17425,69,7,1131.01,4,1,2,7,Regulars
17426,140,9,2209.42,4,2,4,10,Big Spenders
17427,279,12,1446.2,2,4,3,9,At Risk
17428,774,17,4838.56,1,5,5,11,At Risk
17429,172,10,1025.9999999999998,3,3,2,8,Regulars
17430,172,15,1503.59,3,5,3,11,Regulars
17431,744,12,4134.56,1,4,5,10,At Risk
17432,83,9,1840.8999999999999,4,2,4,10,Big Spenders
17433,142,13,1413.28,4,4,3,11,Loyal
17434,48,12,3451.19,5,4,5,14,Champions
17435,117,11,5217.39,4,3,5,12,Loyal
17436,586,7,1435.79,1,1,3,5,Regulars
17437,390,12,1415.45,2,4,3,9,At Risk
17438,155,15,1690.22,3,5,3,11,Regulars
17439,212,7,422.6,3,1,1,5,Regulars
17440,30,11,1535.48,5,3,3,11,Loyal
17441,442,13,1319.65,2,4,3,9,At Risk
17442,188,9,685.3199999999999,3,2,1,6,Regulars
17443,351,14,1246.35,2,5,3,10,At Risk
17444,615,12,2798.1,1,4,5,10,At Risk
17445,393,10,2550.42,2,3,4,9,Regulars
17446,41,9,2056.59,5,2,4,11,Big Spenders
17447,216,10,1382.49,3,3,3,9,Regulars
17448,281,6,422.98,2,1,1,4,Hibernating
17449,211,16,1488.58,3,5,3,11,Regulars
17450,274,12,1661.79,2,4,3,9,At Risk
17451,492,11,963.24,1,3,2,6,Regulars
17452,902,4,626.09,1,1,1,3,Hibernating
17453,229,13,3595.71,3,4,5,12,Big Spenders
17454,453,7,738.35,2,1,1,4,Hibernating
17455,1,8,2787.3899999999994,5,2,5,12,Big Spenders
17456,300,12,3070.79,2,4,5,11,At Risk
17457,2242,3,192.64,1,1,1,3,Hibernating
17458,798,5,356.72,1,1,1,3,Hibernating
17459,146,9,2517.5800000000004,4,2,4,10,Big Spenders
17460,116,9,1781.76,4,2,4,10,Big Spenders
17461,369,9,952.2600000000001,2,2,2,6,Hibernating
17462,220,8,2969.9700000000003,3,2,5,10,Big Spenders
17463,198,10,1515.54,3,3,3,9,Regulars
17464,321,8,635.74,2,2,1,5,Hibernating
17465,31,16,2093.79,5,5,4,14,Champions
17466,192,11,3684.8,3,3,5,11,Big Spenders
17467,84,12,1469.2,4,4,3,11,Loyal
17468,65,12,1547.69,5,4,3,12,Loyal
17469,167,14,1511.08,3,5,3,11,Regulars
17470,266,11,1072.26,2,3,2,7,Regulars
17471,412,7,433.62,2,1,1,4,Hibernating
17472,237,8,1043.77,3,2,2,7,Regulars
17473,121,18,4118.2,4,5,5,14,Champions
17474,228,7,849.86,3,1,2,6,Regulars
17475,681,11,1284.05,1,3,3,7,Regulars
17476,266,10,1404.46,2,3,3,8,Regulars
17477,274,15,2936.06,2,5,5,12,At Risk
17478,586,10,4557.51,1,3,5,9,Regulars
17479,727,5,2249.28,1,1,4,6,Regulars
17480,313,15,3696.76,2,5,5,12,At Risk
17481,442,6,537.49,2,1,1,4,Hibernating
17482,297,12,1707.72,2,4,3,9,At Risk
17483,1345,7,728.64,1,1,1,3,Hibernating
17484,935,5,925.7900000000001,1,1,2,4,Hibernating
17485,217,15,2909.98,3,5,5,13,Big Spenders
17486,495,12,858.8,1,4,2,7,At Risk
17487,272,16,7604.29,2,5,5,12,At Risk
17488,312,7,1005.02,2,1,2,5,Hibernating
17489,107,12,1295.35,4,4,3,11,Loyal
17490,1027,10,834.21,1,3,1,5,Regulars
17491,292,10,1191.16,2,3,2,7,Regulars
17492,127,7,1696.9499999999998,4,1,3,8,Regulars
17493,308,5,370.15999999999997,2,1,1,4,Hibernating
17494,65,9,1674.22,5,2,3,10,Regulars
17495,311,8,3226.13,2,2,5,9,Regulars
17496,1791,2,110.78,1,1,1,3,Hibernating
17497,1239,1,88.03,1,1,1,3,Hibernating
17498,269,13,2809.13,2,4,5,11,At Risk
17499,237,18,2114.82,3,5,4,12,Big Spenders
17500,180,11,2345.2999999999997,3,3,4,10,Big Spenders
17501,209,9,3482.39,3,2,5,10,Big Spenders
17502,107,13,1822.32,4,4,4,12,Champions
17503,86,10,850.23,4,3,2,9,Loyal
17504,905,4,183.46,1,1,1,3,Hibernating
17505,54,5,1257.13,5,1,3,9,Regulars
17506,558,10,1121.59,1,3,2,6,Regulars
17507,63,14,3797.68,5,5,5,15,Champions
17508,42,9,1285.35,5,2,3,10,Regulars
17509,16,11,3052.54,5,3,5,13,Loyal
17510,35,10,2541.58,5,3,4,12,Loyal
17511,174,10,1093.15,3,3,2,8,Regulars
17512,131,8,602.14,4,2,1,7,Regulars
17513,844,8,804.25,1,2,1,4,Hibernating
17514,455,10,1061.5,2,3,2,7,Regulars
17515,240,5,463.72,3,1,1,5,Regulars
17516,295,7,456.15000000000003,2,1,1,4,Hibernating
17517,22,13,3166.31,5,4,5,14,Champions
17518,21,11,3594.5699999999997,5,3,5,13,Loyal
17519,228,5,516.12,3,1,1,5,Regulars
17520,23,8,3345.84,5,2,5,12,Big Spenders
17521,325,13,3855.8900000000003,2,4,5,11,At Risk
17522,196,16,3034.18,3,5,5,13,Big Spenders
17523,15,12,1359.93,5,4,3,12,Loyal
17524,858,15,2069.9500000000003,1,5,4,10,At Risk
17525,14,9,751.76,5,2,1,8,Regulars
17526,395,8,1373.32,2,2,3,7,Regulars
17527,72,10,1120.47,4,3,2,9,Loyal
17528,60,4,190.29,5,1,1,7,Regulars
17529,542,13,2684.59,1,4,5,10,At Risk
17530,195,10,701.25,3,3,1,7,Regulars
17531,368,11,866.25,2,3,2,7,Regulars
17532,1061,9,1591.8700000000001,1,2,3,6,Regulars
17533,451,9,2714.3500000000004,2,2,5,9,Regulars
17534,326,11,6083.28,2,3,5,10,Regulars
17535,202,11,852.15,3,3,2,8,Regulars
17536,190,9,1364.06,3,2,3,8,Regulars
17537,106,6,1356.56,4,1,3,8,Regulars
17538,139,12,4095.54,4,4,5,13,Champions
17539,167,10,2119.88,3,3,4,10,Big Spenders
17540,65,12,948.61,5,4,2,11,Loyal
17541,11,7,422.53,5,1,1,7,Regulars
17542,768,10,1496.12,1,3,3,7,Regulars
17543,50,7,1311.8600000000001,5,1,3,9,Regulars
17544,199,8,1783.75,3,2,4,9,Big Spenders
17545,921,8,1005.2,1,2,2,5,Hibernating
17546,243,12,939.9100000000001,3,4,2,9,Regulars
17547,237,10,3204.8100000000004,3,3,5,11,Big Spenders
17548,319,14,2528.85,2,5,4,11,At Risk
17549,463,13,2523.43,1,4,4,9,At Risk
17550,177,7,447.15,3,1,1,5,Regulars
17551,799,10,3143.03,1,3,5,9,Regulars
17552,73,13,1298.83,4,4,3,11,Loyal
17553,528,13,1290.1,1,4,3,8,At Risk
17554,65,11,924.09,5,3,2,10,Loyal
17555,104,12,1241.93,4,4,3,11,Loyal
17556,193,11,1007.4599999999999,3,3,2,8,Regulars
17557,9,17,4023.9,5,5,5,15,Champions
17558,566,9,2203.29,1,2,4,7,Regulars
17559,250,14,1346.77,2,5,3,10,At Risk
17560,394,9,681.9300000000001,2,2,1,5,Hibernating
17561,105,13,1703.69,4,4,3,11,Loyal
17562,112,9,1091.6000000000001,4,2,2,8,Regulars
17563,485,11,2825.1600000000003,1,3,5,9,Regulars
17564,173,12,2497.18,3,4,4,11,Big Spenders
17565,475,3,544.3499999999999,1,1,1,3,Hibernating
17566,151,13,1660.69,3,4,3,10,Regulars
17567,420,9,778.88,2,2,1,5,Hibernating
17568,747,8,1098.75,1,2,2,5,Hibernating
17569,1,19,4552.8,5,5,5,15,Champions
17570,522,13,918.0799999999999,1,4,2,7,At Risk
17571,53,9,518.83,5,2,1,8,Regulars
17572,297,10,976.67,2,3,2,7,Regulars
17573,63,11,863.67,5,3,2,10,Loyal
17574,238,6,1184.37,3,1,2,6,Regulars
17575,527,9,1567.3799999999999,1,2,3,6,Regulars
17576,651,6,1356.72,1,1,3,5,Regulars
17577,64,13,1075.25,5,4,2,11,Loyal
17578,111,12,1670.33,4,4,3,11,Loyal
17579,733,10,1358.67,1,3,3,7,Regulars
17580,314,14,4374.64,2,5,5,12,At Risk
17581,68,13,881.23,4,4,2,10,Loyal
17582,85,16,3823.65,4,5,5,14,Champions
17583,462,8,475.05999999999995,1,2,1,4,Hibernating
17584,308,8,673.81,2,2,1,5,Hibernating
17585,267,9,1935.12,2,2,4,8,Regulars
17586,578,4,3270.75,1,1,5,7,Regulars
17587,218,13,1460.53,3,4,3,10,Regulars
17588,49,9,1164.49,5,2,2,9,Regulars
17589,463,5,395.87,1,1,1,3,Hibernating
17590,540,11,1873.7,1,3,4,8,Regulars
17591,117,9,1426.22,4,2,3,9,Regulars
17592,26,12,3194.93,5,4,5,14,Champions
17593,45,13,1856.8,5,4,4,13,Champions
17594,872,10,1129.6299999999999,1,3,2,6,Regulars
17595,271,8,1458.65,2,2,3,7,Regulars
17596,298,8,890.27,2,2,2,6,Hibernating
17597,159,8,707.32,3,2,1,6,Regulars
17598,135,13,1418.49,4,4,3,11,Loyal
17599,397,8,1145.13,2,2,2,6,Hibernating
17600,310,6,585.29,2,1,1,4,Hibernating
17601,552,11,1299.48,1,3,3,7,Regulars
17602,220,9,881.92,3,2,2,7,Regulars
17603,98,8,510.41,4,2,1,7,Regulars
17604,55,10,1353.03,5,3,3,11,Loyal
17605,21,7,2174.8,5,1,4,10,Big Spenders
17606,147,12,1180.95,4,4,2,10,Loyal
17607,295,10,1104.67,2,3,2,7,Regulars
17608,577,9,1113.22,1,2,2,5,Hibernating
17609,1237,15,4447.07,1,5,5,11,At Risk
17610,209,11,1210.74,3,3,2,8,Regulars
17611,220,10,1891.0700000000002,3,3,4,10,Big Spenders
17612,271,8,1799.71,2,2,4,8,Regulars
17613,177,17,1613.78,3,5,3,11,Regulars
17614,463,6,392.8,1,1,1,3,Hibernating
17615,692,6,2339.1699999999996,1,1,4,6,Regulars
17616,132,12,1188.19,4,4,2,10,Loyal
17617,106,12,1172.82,4,4,2,10,Loyal
17618,12,14,1850.08,5,5,4,14,Champions
17619,211,11,1111.88,3,3,2,8,Regulars
17620,815,6,467.5,1,1,1,3,Hibernating
17621,474,7,739.17,1,1,1,3,Hibernating
17622,195,15,3386.11,3,5,5,13,Big Spenders
17623,58,15,4319.7,5,5,5,15,Champions
17624,135,10,918.73,4,3,2,9,Loyal
17625,264,11,3648.17,2,3,5,10,Regulars
17626,193,13,4728.55,3,4,5,12,Big Spenders
17627,1373,7,2595.12,1,1,5,7,Regulars
17628,214,7,1575.67,3,1,3,7,Regulars
17629,243,4,362.43,3,1,1,5,Regulars
17630,55,5,4579.66,5,1,5,11,Big Spenders
17631,105,9,2162.02,4,2,4,10,Big Spenders
17632,174,10,1386.34,3,3,3,9,Regulars
17633,288,6,742.9499999999999,2,1,1,4,Hibernating
17634,65,11,2274.49,5,3,4,12,Loyal
17635,34,7,492.69,5,1,1,7,Regulars
17636,538,11,1214.77,1,3,2,6,Regulars
17637,9,12,3379.93,5,4,5,14,Champions
17638,797,6,1085.43,1,1,2,4,Hibernating
17639,320,6,3157.79,2,1,5,8,Regulars
17640,133,11,2716.5299999999997,4,3,5,12,Loyal
17641,78,8,3187.23,4,2,5,11,Big Spenders
17642,218,10,3245.68,3,3,5,11,Big Spenders
17643,117,12,1492.65,4,4,3,11,Loyal
17644,253,8,616.96,2,2,1,5,Hibernating
17645,660,13,3273.3999999999996,1,4,5,10,At Risk
17646,333,15,3727.5699999999997,2,5,5,12,At Risk
17647,8,11,1114.27,5,3,2,10,Loyal
17648,158,9,3023.2799999999997,3,2,5,10,Big Spenders
17649,112,11,882.37,4,3,2,9,Loyal
17650,100,10,871.99,4,3,2,9,Loyal
17651,39,15,1274.02,5,5,3,13,Loyal
17652,914,6,880.5600000000001,1,1,2,4,Hibernating
17653,561,9,780.1700000000001,1,2,1,4,Hibernating
17654,465,12,1909.0899999999997,1,4,4,9,At Risk
17655,576,10,1234.18,1,3,2,6,Regulars
17656,133,6,855.2800000000001,4,1,2,7,Regulars
17657,167,16,1752.08,3,5,4,12,Big Spenders
17658,208,11,739.5,3,3,1,7,Regulars
17659,220,11,1373.6299999999999,3,3,3,9,Regulars
17660,123,13,3816.7,4,4,5,13,Champions
17661,504,4,363.34,1,1,1,3,Hibernating
17662,212,8,692.39,3,2,1,6,Regulars
17663,205,9,1484.79,3,2,3,8,Regulars
17664,68,11,1130.8799999999999,4,3,2,9,Loyal
17665,376,9,1087.87,2,2,2,6,Hibernating
17666,384,8,414.47,2,2,1,5,Hibernating
17667,46,8,555.88,5,2,1,8,Regulars
17668,61,10,1488.8500000000001,5,3,3,11,Loyal
17669,488,9,1213.78,1,2,2,5,Hibernating
17670,395,8,1370.15,2,2,3,7,Regulars
17671,97,9,563.33,4,2,1,7,Regulars
17672,583,9,960.22,1,2,2,5,Hibernating
17673,172,9,987.96,3,2,2,7,Regulars
17674,78,10,1193.62,4,3,2,9,Loyal
17675,284,9,1720.69,2,2,3,7,Regulars
17676,107,6,831.5899999999999,4,1,1,6,Regulars
17677,614,12,2383.5800000000004,1,4,4,9,At Risk
17678,23,4,208.7,5,1,1,7,Regulars
17679,253,10,2373.72,2,3,4,9,Regulars
17680,643,14,1505.2199999999998,1,5,3,9,At Risk
17681,55,10,589.85,5,3,1,9,Loyal
17682,360,10,959.8399999999999,2,3,2,7,Regulars
17683,107,13,2660.64,4,4,5,13,Champions
17684,498,10,2627.74,1,3,5,9,Regulars
17685,1105,11,3175.2200000000003,1,3,5,9,Regulars
17686,35,13,1789.4099999999999,5,4,4,13,Champions
17687,168,12,2213.64,3,4,4,11,Big Spenders
17688,146,7,3184.86,4,1,5,10,Big Spenders
17689,172,9,1656.28,3,2,3,8,Regulars
17690,277,9,1646.1,2,2,3,7,Regulars
17691,447,10,803.85,2,3,1,6,Regulars
17692,246,12,1474.87,3,4,3,10,Regulars
17693,81,8,4537.64,4,2,5,11,Big Spenders
17694,387,9,2309.35,2,2,4,8,Regulars
17695,23,3,270.47,5,1,1,7,Regulars
17696,134,10,947.8000000000001,4,3,2,9,Loyal
17697,779,8,4195.42,1,2,5,8,Regulars
17698,24,9,1315.35,5,2,3,10,Regulars
17699,97,6,750.04,4,1,1,6,Regulars
17700,388,10,3099.17,2,3,5,10,Regulars
17701,117,13,3067.5399999999995,4,4,5,13,Champions
17702,122,7,1896.5300000000002,4,1,4,9,Big Spenders
17703,253,11,1098.6100000000001,2,3,2,7,Regulars
17704,427,11,2667.9,2,3,5,10,Regulars
17705,199,6,240.04,3,1,1,5,Regulars
17706,59,7,699.84,5,1,1,7,Regulars
17707,237,4,1967.25,3,1,4,8,Big Spenders
17708,6,15,1771.64,5,5,4,14,Champions
17709,122,6,754.1800000000001,4,1,1,6,Regulars
17710,59,9,962.79,5,2,2,9,Regulars
17711,705,7,423.34000000000003,1,1,1,3,Hibernating
17712,265,9,1383.21,2,2,3,7,Regulars
17713,47,13,1361.21,5,4,3,12,Loyal
17714,134,13,1653.0900000000001,4,4,3,11,Loyal
17715,215,5,490.12,3,1,1,5,Regulars
17716,30,7,1765.9,5,1,4,10,Big Spenders
17717,315,12,1311.75,2,4,3,9,At Risk
17718,360,12,1214.2,2,4,2,8,At Risk
17719,74,13,3203.52,4,4,5,13,Champions
17720,263,10,796.6899999999999,2,3,1,6,Regulars
17721,811,7,1169.8,1,1,2,4,Hibernating
17722,157,8,1120.21,3,2,2,7,Regulars
17723,144,10,1271.54,4,3,3,10,Loyal
17724,211,11,1550.45,3,3,3,9,Regulars
17725,419,11,2182.76,2,3,4,9,Regulars
17726,39,10,1984.1100000000001,5,3,4,12,Loyal
17727,75,7,2162.09,4,1,4,9,Big Spenders
17728,409,5,2279.12,2,1,4,7,Regulars
17729,394,13,2218.6800000000003,2,4,4,10,At Risk
17730,92,12,1451.25,4,4,3,11,Loyal
17731,4,9,1726.75,5,2,4,11,Big Spenders
17732,562,10,1557.85,1,3,3,7,Regulars
17733,123,12,1361.01,4,4,3,11,Loyal
17734,218,14,1362.56,3,5,3,11,Regulars
17735,35,11,1052.81,5,3,2,10,Loyal
17736,603,8,1068.6599999999999,1,2,2,5,Hibernating
17737,214,7,699.89,3,1,1,5,Regulars
17738,44,12,1316.46,5,4,3,12,Loyal
17739,254,5,588.61,2,1,1,4,Hibernating
17740,127,11,1312.32,4,3,3,10,Loyal
17741,517,9,1530.57,1,2,3,6,Regulars
17742,127,10,3798.57,4,3,5,12,Loyal
17743,149,13,1845.53,3,4,4,11,Big Spenders
17744,1720,4,2001.3199999999997,1,1,4,6,Regulars
17745,136,11,1260.75,4,3,3,10,Loyal
17746,15,8,1358.29,5,2,3,10,Regulars
17747,162,9,866.44,3,2,2,7,Regulars
17748,284,9,810.9,2,2,1,5,Hibernating
17749,87,12,2280.31,4,4,4,12,Champions
17750,108,10,1085.59,4,3,2,9,Loyal
17751,111,14,3772.54,4,5,5,14,Champions
17752,578,8,2126.63,1,2,4,7,Regulars
17753,14,9,1505.3700000000001,5,2,3,10,Regulars
17754,28,11,2910.8799999999997,5,3,5,13,Loyal
17755,474,5,625.35,1,1,1,3,Hibernating
17756,262,17,2107.05,2,5,4,11,At Risk
17757,543,6,143.71,1,1,1,3,Hibernating
17758,43,12,1758.48,5,4,4,13,Champions
17759,95,8,909.88,4,2,2,8,Regulars
17760,402,10,1081.75,2,3,2,7,Regulars
17761,630,7,1131.04,1,1,2,4,Hibernating
17762,169,13,1851.97,3,4,4,11,Big Spenders
17763,187,8,2725.61,3,2,5,10,Big Spenders
17764,303,7,507.99,2,1,1,4,Hibernating
17765,143,11,1905.89,4,3,4,11,Loyal
17766,111,15,1145.28,4,5,2,11,Loyal
17767,77,10,3618.73,4,3,5,12,Loyal
17768,27,11,4285.89,5,3,5,13,Loyal
17769,250,14,1885.16,2,5,4,11,At Risk
17770,37,16,4392.0599999999995,5,5,5,15,Champions
17771,180,6,1017.3100000000001,3,1,2,6,Regulars
17772,185,11,1455.3500000000001,3,3,3,9,Regulars
17773,117,13,2008.74,4,4,4,12,Champions
17774,553,8,2582.46,1,2,5,8,Regulars
17775,81,7,930.78,4,1,2,7,Regulars
17776,2,7,1594.33,5,1,3,9,Regulars
17777,553,7,1465.25,1,1,3,5,Regulars
17778,105,10,2071.9,4,3,4,11,Loyal
17779,122,12,1338.19,4,4,3,11,Loyal
17780,68,8,1494.06,4,2,3,9,Regulars
17781,351,6,925.97,2,1,2,5,Hibernating
17782,480,6,316.24,1,1,1,3,Hibernating
17783,97,9,1557.6100000000001,4,2,3,9,Regulars
17784,148,5,548.29,3,1,1,5,Regulars
17785,74,12,1924.38,4,4,4,12,Champions
17786,179,7,1381.3899999999999,3,1,3,7,Regulars
17787,279,10,783.9399999999999,2,3,1,6,Regulars
17788,21,13,1243.51,5,4,3,12,Loyal
17789,300,9,946.9399999999999,2,2,2,6,Hibernating
17790,284,5,1030.48,2,1,2,5,Hibernating
17791,412,8,774.42,2,2,1,5,Hibernating
17792,107,14,3284.65,4,5,5,14,Champions
17793,384,14,1737.96,2,5,4,11,At Risk
17794,76,11,1442.3600000000001,4,3,3,10,Loyal
17795,75,10,1171.44,4,3,2,9,Loyal
17796,356,9,1853.16,2,2,4,8,Regulars
17797,108,7,1034.17,4,1,2,7,Regulars
17798,627,11,1440.5,1,3,3,7,Regulars
17799,233,8,2372.9900000000002,3,2,4,9,Big Spenders
17800,242,15,4210.880000000001,3,5,5,13,Big Spenders
17801,70,6,918.38,4,1,2,7,Regulars
17802,647,4,418.92,1,1,1,3,Hibernating
17803,6,10,1853.36,5,3,4,12,Loyal
17804,195,12,2460.2,3,4,4,11,Big Spenders
17805,0,4,231.54000000000002,5,1,1,7,Regulars
17806,840,5,638.84,1,1,1,3,Hibernating
17807,33,12,1181.6899999999998,5,4,2,11,Loyal
17808,3,12,1549.44,5,4,3,12,Loyal
17809,688,10,1094.42,1,3,2,6,Regulars
17810,418,15,4028.3499999999995,2,5,5,12,At Risk
17811,35,11,1405.5,5,3,3,11,Loyal
17812,21,11,964.6,5,3,2,10,Loyal
17813,308,14,2490.34,2,5,4,11,At Risk
17814,912,4,568.39,1,1,1,3,Hibernating
17815,50,7,1428.8100000000002,5,1,3,9,Regulars
17816,1235,8,560.9200000000001,1,2,1,4,Hibernating
17817,253,16,2352.21,2,5,4,11,At Risk
17818,186,13,1478.8899999999999,3,4,3,10,Regulars
17819,274,15,4134.12,2,5,5,12,At Risk
17820,584,9,625.57,1,2,1,4,Hibernating
17821,204,15,1576.51,3,5,3,11,Regulars
17822,400,16,1232.58,2,5,2,9,At Risk
17823,350,19,2293.46,2,5,4,11,At Risk
17824,531,15,2051.16,1,5,4,10,At Risk
17825,230,13,2792.37,3,4,5,12,Big Spenders
17826,215,17,3543.4900000000002,3,5,5,13,Big Spenders
17827,253,10,1185.94,2,3,2,7,Regulars
17828,100,11,1222.6399999999999,4,3,2,9,Loyal
17829,195,10,1099.26,3,3,2,8,Regulars
17830,604,7,2892.7999999999997,1,1,5,7,Regulars
17831,52,7,971.38,5,1,2,8,Regulars
17832,519,9,4360.43,1,2,5,8,Regulars
17833,682,6,320.1,1,1,1,3,Hibernating
17834,298,10,1163.57,2,3,2,7,Regulars
17835,132,13,1054.23,4,4,2,10,Loyal
17836,116,10,684.82,4,3,1,8,Loyal
17837,169,15,2424.1,3,5,4,12,Big Spenders
17838,260,10,833.02,2,3,1,6,Regulars
17839,509,9,1119.78,1,2,2,5,Hibernating
17840,165,15,3053.22,3,5,5,13,Big Spenders
17841,1565,9,722.46,1,2,1,4,Hibernating
17842,24,7,1677.0,5,1,3,9,Regulars
17843,46,13,4326.09,5,4,5,14,Champions
17844,45,13,2004.09,5,4,4,13,Champions
17845,275,11,1229.85,2,3,2,7,Regulars
17846,21,11,1311.77,5,3,3,11,Loyal
17847,147,13,1510.35,4,4,3,11,Loyal
17848,349,9,1615.02,2,2,3,7,Regulars
17849,577,10,1011.0,1,3,2,6,Regulars
17850,246,9,888.78,3,2,2,7,Regulars
17851,293,11,1941.74,2,3,4,9,Regulars
17852,413,8,1072.29,2,2,2,6,Hibernating
17853,230,10,2661.15,3,3,5,11,Big Spenders
17854,678,6,313.59999999999997,1,1,1,3,Hibernating
17855,24,15,4934.9400000000005,5,5,5,15,Champions
17856,653,7,2878.02,1,1,5,7,Regulars
17857,326,9,1198.74,2,2,2,6,Hibernating
17858,560,7,624.92,1,1,1,3,Hibernating
17859,497,7,981.01,1,1,2,4,Hibernating
17860,99,12,2530.18,4,4,4,12,Champions
17861,180,10,1473.9,3,3,3,9,Regulars
17862,710,3,456.39,1,1,1,3,Hibernating
17863,295,7,845.54,2,1,2,5,Hibernating
17864,421,10,791.82,2,3,1,6,Regulars
17865,61,10,2416.15,5,3,4,12,Loyal
17866,706,6,3149.6200000000003,1,1,5,7,Regulars
17867,145,7,4502.74,4,1,5,10,Big Spenders
17868,155,15,1869.6,3,5,4,12,Big Spenders
17869,216,9,1674.3,3,2,3,8,Regulars
17870,368,12,1730.27,2,4,4,10,At Risk
17871,368,8,1138.71,2,2,2,6,Hibernating
17872,150,12,566.49,3,4,1,8,Regulars
17873,647,9,1884.27,1,2,4,7,Regulars
17874,748,4,674.8299999999999,1,1,1,3,Hibernating
17875,245,12,2017.5800000000002,3,4,4,11,Big Spenders
17876,5,8,1059.52,5,2,2,9,Regulars
17877,206,5,693.02,3,1,1,5,Regulars
17878,127,14,1796.7,4,5,4,13,Champions
17879,22,12,2998.6600000000003,5,4,5,14,Champions
17880,236,13,3281.43,3,4,5,12,Big Spenders
17881,113,9,1105.61,4,2,2,8,Regulars
17882,848,7,824.22,1,1,1,3,Hibernating
17883,142,10,1094.79,4,3,2,9,Loyal
17884,201,10,1758.9,3,3,4,10,Big Spenders
17885,433,6,505.84000000000003,2,1,1,4,Hibernating
17886,301,7,513.72,2,1,1,4,Hibernating
17887,124,16,5653.37,4,5,5,14,Champions
17888,472,4,179.26999999999998,1,1,1,3,Hibernating
17889,174,11,1444.74,3,3,3,9,Regulars
17890,18,10,1379.8400000000001,5,3,3,11,Loyal
17891,279,13,926.64,2,4,2,8,At Risk
17892,93,10,800.62,4,3,1,8,Loyal
17893,339,11,1147.24,2,3,2,7,Regulars
17894,642,5,793.6800000000001,1,1,1,3,Hibernating
17895,1021,9,3196.4700000000003,1,2,5,8,Regulars
17896,149,11,2235.96,3,3,4,10,Big Spenders
17897,46,8,973.42,5,2,2,9,Regulars
17898,61,9,930.85,5,2,2,9,Regulars
17899,121,20,1723.48,4,5,3,12,Loyal
17900,438,9,739.73,2,2,1,5,Hibernating
17901,549,11,2557.9,1,3,4,8,Regulars
17902,38,5,134.93,5,1,1,7,Regulars
17903,80,12,783.0,4,4,1,9,Loyal
17904,63,12,3332.32,5,4,5,14,Champions
17905,418,12,2421.0,2,4,4,10,At Risk
17906,27,12,1681.27,5,4,3,12,Loyal
17907,352,9,492.37,2,2,1,5,Hibernating
17908,199,11,1296.45,3,3,3,9,Regulars
17909,225,12,1647.46,3,4,3,10,Regulars
17910,265,8,1979.66,2,2,4,8,Regulars
17911,49,8,1155.47,5,2,2,9,Regulars
17912,67,8,971.67,4,2,2,8,Regulars
17913,208,10,1815.29,3,3,4,10,Big Spenders
17914,319,7,2710.1499999999996,2,1,5,8,Regulars
17915,1564,8,1071.42,1,2,2,5,Hibernating
17916,368,11,948.21,2,3,2,7,Regulars
17917,491,5,210.66,1,1,1,3,Hibernating
17918,152,10,1525.67,3,3,3,9,Regulars
17919,442,6,1024.44,2,1,2,5,Hibernating
17920,50,16,3266.31,5,5,5,15,Champions
17921,221,8,1291.96,3,2,3,8,Regulars
17922,109,10,1832.0,4,3,4,11,Loyal
17923,23,11,767.93,5,3,1,9,Loyal
17924,73,10,1566.8,4,3,3,10,Loyal
17925,350,9,858.9399999999999,2,2,2,6,Hibernating
17926,279,9,2320.19,2,2,4,8,Regulars
17927,117,11,1225.25,4,3,2,9,Loyal
17928,531,5,588.58,1,1,1,3,Hibernating
17929,78,7,300.65999999999997,4,1,1,6,Regulars
17930,453,4,552.8199999999999,2,1,1,4,Hibernating
17931,136,9,3048.88,4,2,5,11,Big Spenders
17932,79,12,2671.26,4,4,5,13,Champions
17933,209,5,913.4899999999999,3,1,2,6,Regulars
17934,202,11,3819.4399999999996,3,3,5,11,Big Spenders
17935,186,9,5020.160000000001,3,2,5,10,Big Spenders
17936,18,11,1708.6100000000001,5,3,3,11,Loyal
17937,1328,5,708.09,1,1,1,3,Hibernating
17938,117,8,1401.63,4,2,3,9,Regulars
17939,145,13,5281.219999999999,4,4,5,13,Champions
17940,590,12,2053.17,1,4,4,9,At Risk
17941,346,7,576.75,2,1,1,4,Hibernating
17942,133,10,630.27,4,3,1,8,Loyal
17943,544,6,679.9200000000001,1,1,1,3,Hibernating
17944,1013,10,1732.41,1,3,4,8,Regulars
17945,389,12,4413.790000000001,2,4,5,11,At Risk
17946,296,9,755.1099999999999,2,2,1,5,Hibernating
17947,335,10,912.05,2,3,2,7,Regulars
17948,297,12,1492.8700000000001,2,4,3,9,At Risk
17949,112,14,2506.16,4,5,4,13,Champions
17950,82,9,632.74,4,2,1,7,Regulars
17951,320,16,4120.110000000001,2,5,5,12,At Risk
17952,404,10,793.4000000000001,2,3,1,6,Regulars
17953,293,10,1126.29,2,3,2,7,Regulars
17954,52,11,2300.1,5,3,4,12,Loyal
17955,449,8,1033.32,2,2,2,6,Hibernating
17956,268,7,953.19,2,1,2,5,Hibernating
17957,487,6,612.7800000000001,1,1,1,3,Hibernating
17958,952,10,1943.8,1,3,4,8,Regulars
17959,509,13,3185.44,1,4,5,10,At Risk
17960,75,9,2325.08,4,2,4,10,Big Spenders
17961,1337,4,569.54,1,1,1,3,Hibernating
17962,133,9,2658.43,4,2,5,11,Big Spenders
17963,37,14,2293.41,5,5,4,14,Champions
17964,508,16,2259.48,1,5,4,10,At Risk
17965,18,10,878.15,5,3,2,10,Loyal
17966,235,11,2093.33,3,3,4,10,Big Spenders
17967,330,7,2055.63,2,1,4,7,Regulars
17968,705,11,1186.8899999999999,1,3,2,6,Regulars
17969,167,5,703.2,3,1,1,5,Regulars
17970,126,9,1392.7800000000002,4,2,3,9,Regulars
17971,10,10,1549.96,5,3,3,11,Loyal
17972,602,6,2151.87,1,1,4,6,Regulars
17973,26,11,3909.01,5,3,5,13,Loyal
17974,330,10,1011.74,2,3,2,7,Regulars
17975,83,16,3835.79,4,5,5,14,Champions
17976,52,14,1592.79,5,5,3,13,Loyal
17977,84,11,2952.07,4,3,5,12,Loyal
17978,52,8,1604.33,5,2,3,10,Regulars
17979,315,12,964.98,2,4,2,8,At Risk
17980,338,11,2542.61,2,3,4,9,Regulars
17981,103,11,2812.0899999999997,4,3,5,12,Loyal
17982,362,11,1648.6399999999999,2,3,3,8,Regulars
17983,263,15,3082.48,2,5,5,12,At Risk
17984,364,7,788.6800000000001,2,1,1,4,Hibernating
17985,531,13,2347.69,1,4,4,9,At Risk
17986,475,10,1266.57,1,3,3,7,Regulars
17987,697,4,344.3,1,1,1,3,Hibernating
17988,791,10,720.26,1,3,1,5,Regulars
17989,195,9,683.26,3,2,1,6,Regulars
17990,132,9,2025.93,4,2,4,10,Big Spenders
17991,529,14,2624.55,1,5,5,11,At Risk
17992,39,7,2227.6400000000003,5,1,4,10,Big Spenders
17993,448,12,781.34,2,4,1,7,At Risk
17994,395,9,611.25,2,2,1,5,Hibernating
17995,238,11,1276.82,3,3,3,9,Regulars
17996,25,13,3841.45,5,4,5,14,Champions
17997,603,6,1260.76,1,1,3,5,Regulars
17998,32,13,1537.8,5,4,3,12,Loyal
17999,65,7,391.84000000000003,5,1,1,7,Regulars
18000,152,10,2701.5,3,3,5,11,Big Spenders
18001,140,10,1886.0300000000002,4,3,4,11,Loyal
18002,16,10,501.25,5,3,1,9,Loyal
18003,90,10,955.49,4,3,2,9,Loyal
18004,755,7,1560.5700000000002,1,1,3,5,Regulars
18005,346,15,1362.54,2,5,3,10,At Risk
18006,22,13,2025.92,5,4,4,13,Champions
18007,206,11,929.46,3,3,2,8,Regulars
18008,45,9,917.33,5,2,2,9,Regulars
18009,583,9,4144.74,1,2,5,8,Regulars
18010,22,8,2883.92,5,2,5,12,Big Spenders
18011,124,12,1493.59,4,4,3,11,Loyal
18012,531,7,3812.46,1,1,5,7,Regulars
18013,844,4,412.65,1,1,1,3,Hibernating
18014,658,8,2213.22,1,2,4,7,Regulars
18015,14,13,1242.67,5,4,3,12,Loyal
18016,535,8,730.1,1,2,1,4,Hibernating
18017,65,9,2438.63,5,2,4,11,Big Spenders
18018,486,6,1189.92,1,1,2,4,Hibernating
18019,59,11,4531.69,5,3,5,13,Loyal
18020,211,11,1031.64,3,3,2,8,Regulars
18021,107,11,1470.79,4,3,3,10,Loyal
18022,111,10,827.66,4,3,1,8,Loyal
18023,211,9,1051.58,3,2,2,7,Regulars
18024,479,7,1498.13,1,1,3,5,Regulars
18025,303,5,343.27,2,1,1,4,Hibernating
18026,185,10,592.35,3,3,1,7,Regulars
18027,253,15,1594.22,2,5,3,10,At Risk
18028,93,6,842.62,4,1,1,6,Regulars
18029,434,11,1449.56,2,3,3,8,Regulars
18030,132,10,4570.09,4,3,5,12,Loyal
18031,901,9,2152.8799999999997,1,2,4,7,Regulars
18032,1099,11,2660.1899999999996,1,3,5,9,Regulars
18033,250,9,1486.25,2,2,3,7,Regulars
18034,469,6,600.26,1,1,1,3,Hibernating
18035,0,14,4519.37,5,5,5,15,Champions
18036,26,10,1347.58,5,3,3,11,Loyal
18037,310,8,718.39,2,2,1,5,Hibernating
18038,134,6,816.03,4,1,1,6,Regulars
18039,984,5,448.03,1,1,1,3,Hibernating
18040,332,12,2759.92,2,4,5,11,At Risk
18041,7,13,1587.71,5,4,3,12,Loyal
18042,512,16,2449.51,1,5,4,10,At Risk
18043,42,12,1755.96,5,4,4,13,Champions
18044,2,14,2105.27,5,5,4,14,Champions
18045,7,15,3676.19,5,5,5,15,Champions
18046,83,14,3401.68,4,5,5,14,Champions
18047,279,13,1280.3,2,4,3,9,At Risk
18048,138,9,1896.6100000000001,4,2,4,10,Big Spenders
18049,91,7,740.51,4,1,1,6,Regulars
18050,71,16,2001.06,4,5,4,13,Champions
18051,113,12,1831.71,4,4,4,12,Champions
18052,397,4,609.82,2,1,1,4,Hibernating
18053,538,10,1333.24,1,3,3,7,Regulars
18054,241,7,910.02,3,1,2,6,Regulars
18055,27,9,2416.0199999999995,5,2,4,11,Big Spenders
18056,149,12,1002.64,3,4,2,9,Regulars
18057,183,10,4798.09,3,3,5,11,Big Spenders
18058,16,9,1797.6799999999998,5,2,4,11,Big Spenders
18059,260,7,538.43,2,1,1,4,Hibernating
18060,368,15,3141.72,2,5,5,12,At Risk
18061,161,11,1104.64,3,3,2,8,Regulars
18062,420,11,2024.15,2,3,4,9,Regulars
18063,160,5,253.57,3,1,1,5,Regulars
18064,89,10,1983.94,4,3,4,11,Loyal
18065,332,8,1237.99,2,2,2,6,Hibernating
18066,41,13,1321.69,5,4,3,12,Loyal
18067,64,10,1047.22,5,3,2,10,Loyal
18068,167,10,727.84,3,3,1,7,Regulars
18069,766,16,6340.87,1,5,5,11,At Risk
18070,50,9,972.39,5,2,2,9,Regulars
18071,105,13,1264.52,4,4,3,11,Loyal
18072,153,7,610.9499999999999,3,1,1,5,Regulars
18073,285,5,748.48,2,1,1,4,Hibernating
18074,15,10,2419.38,5,3,4,12,Loyal
18075,73,11,951.72,4,3,2,9,Loyal
18076,492,11,1331.82,1,3,3,7,Regulars
18077,102,10,1063.38,4,3,2,9,Loyal
18078,44,10,2368.14,5,3,4,12,Loyal
18079,1714,6,2556.86,1,1,4,6,Regulars
18080,258,9,1733.4,2,2,4,8,Regulars
18081,82,9,2941.81,4,2,5,11,Big Spenders
18082,488,13,2079.9900000000002,1,4,4,9,At Risk
18083,347,10,2985.59,2,3,5,10,Regulars
18084,281,16,2661.96,2,5,5,12,At Risk
18085,105,14,3707.43,4,5,5,14,Champions
18086,404,9,1253.33,2,2,3,7,Regulars
18087,210,14,832.9200000000001,3,5,1,9,Regulars
18088,83,6,1650.27,4,1,3,8,Regulars
18089,953,6,326.33,1,1,1,3,Hibernating
18090,750,13,1381.89,1,4,3,8,At Risk
18091,263,7,768.13,2,1,1,4,Hibernating
18092,422,8,2208.67,2,2,4,8,Regulars
18093,237,11,3232.6,3,3,5,11,Big Spenders
18094,27,10,2422.66,5,3,4,12,Loyal
18095,225,15,1779.55,3,5,4,12,Big Spenders
18096,272,4,2820.17,2,1,5,8,Regulars
18097,650,5,1220.73,1,1,2,4,Hibernating
18098,110,11,1839.47,4,3,4,11,Loyal
18099,85,11,954.97,4,3,2,9,Loyal
18100,119,8,1482.99,4,2,3,9,Regulars
18101,92,9,2093.8599999999997,4,2,4,10,Big Spenders
18102,489,9,1420.21,1,2,3,6,Regulars
18103,98,14,2433.0699999999997,4,5,4,13,Champions
18104,648,7,553.98,1,1,1,3,Hibernating
18105,26,11,2232.2799999999997,5,3,4,12,Loyal
18106,187,6,1774.94,3,1,4,8,Big Spenders
18107,171,15,3201.32,3,5,5,13,Big Spenders
18108,6,12,2457.71,5,4,4,13,Champions
18109,604,6,975.81,1,1,2,4,Hibernating
18110,385,10,1906.73,2,3,4,9,Regulars
18111,192,10,1192.22,3,3,2,8,Regulars
18112,138,11,3503.78,4,3,5,12,Loyal
18113,104,9,863.4,4,2,2,8,Regulars
18114,635,12,568.96,1,4,1,6,At Risk
18115,724,9,895.5,1,2,2,5,Hibernating
18116,212,12,2052.12,3,4,4,11,Big Spenders
18117,822,6,684.82,1,1,1,3,Hibernating
18118,75,8,1076.22,4,2,2,8,Regulars
18119,52,11,1519.04,5,3,3,11,Loyal
18120,5,12,1594.6000000000001,5,4,3,12,Loyal
18121,161,9,1280.41,3,2,3,8,Regulars
18122,127,6,751.22,4,1,1,6,Regulars
18123,81,15,1044.25,4,5,2,11,Loyal
18124,165,10,898.64,3,3,2,8,Regulars
18125,162,10,1847.13,3,3,4,10,Big Spenders
18126,73,8,479.72999999999996,4,2,1,7,Regulars
18127,168,17,4997.04,3,5,5,13,Big Spenders
18128,117,11,1829.76,4,3,4,11,Loyal
18129,37,10,1224.6399999999999,5,3,2,10,Loyal
18130,6,7,1816.03,5,1,4,10,Big Spenders
18131,285,11,2143.53,2,3,4,9,Regulars
18132,20,8,598.82,5,2,1,8,Regulars
18133,768,6,1071.8200000000002,1,1,2,4,Hibernating
18134,156,8,485.03999999999996,3,2,1,6,Regulars
18135,338,13,4569.19,2,4,5,11,At Risk
18136,49,11,1879.29,5,3,4,12,Loyal
18137,318,12,3040.1800000000003,2,4,5,11,At Risk
18138,326,6,1293.52,2,1,3,6,Regulars
18139,261,5,2607.33,2,1,5,8,Regulars
18140,110,13,4510.96,4,4,5,13,Champions
18141,237,13,3053.64,3,4,5,12,Big Spenders
18142,488,9,2759.65,1,2,5,8,Regulars
18143,288,9,1026.46,2,2,2,6,Hibernating
18144,253,8,927.27,2,2,2,6,Hibernating
18145,777,7,1798.1799999999998,1,1,4,6,Regulars
18146,76,4,2268.7999999999997,4,1,4,9,Big Spenders
18147,239,15,2393.9500000000003,3,5,4,12,Big Spenders
18148,278,8,593.46,2,2,1,5,Hibernating
18149,173,18,4309.53,3,5,5,13,Big Spenders
18150,358,13,952.33,2,4,2,8,At Risk
18151,949,13,1628.95,1,4,3,8,At Risk
18152,178,13,2865.52,3,4,5,12,Big Spenders
18153,142,7,1126.1799999999998,4,1,2,7,Regulars
18154,118,5,1694.4699999999998,4,1,3,8,Regulars
18155,118,12,1587.84,4,4,3,11,Loyal
18156,493,7,774.95,1,1,1,3,Hibernating
18157,252,12,2423.0,2,4,4,10,At Risk
18158,135,13,2210.49,4,4,4,12,Champions
18159,32,11,846.3800000000001,5,3,2,10,Loyal
18160,966,7,1008.3100000000001,1,1,2,4,Hibernating
18161,1348,7,748.81,1,1,1,3,Hibernating
18162,31,16,3056.92,5,5,5,15,Champions
18163,74,13,2094.44,4,4,4,12,Champions
18164,497,14,2932.19,1,5,5,11,At Risk
18165,9,13,2299.4399999999996,5,4,4,13,Champions
18166,698,5,2010.69,1,1,4,6,Regulars
18167,418,11,2202.2200000000003,2,3,4,9,Regulars
18168,128,10,2091.13,4,3,4,11,Loyal
18169,336,11,3163.69,2,3,5,10,Regulars
18170,161,11,780.92,3,3,1,7,Regulars
18171,596,6,995.4,1,1,2,4,Hibernating
18172,318,15,2275.42,2,5,4,11,At Risk
18173,25,11,1418.4,5,3,3,11,Loyal
18174,165,13,3704.11,3,4,5,12,Big Spenders
18175,674,6,476.66999999999996,1,1,1,3,Hibernating
18176,202,8,534.91,3,2,1,6,Regulars
18177,68,13,3664.49,4,4,5,13,Champions
18178,668,12,2766.46,1,4,5,10,At Risk
18179,146,9,4784.63,4,2,5,11,Big Spenders
18180,204,7,683.6700000000001,3,1,1,5,Regulars
18181,60,14,1974.85,5,5,4,14,Champions
18182,430,8,891.4399999999999,2,2,2,6,Hibernating
18183,375,9,1180.87,2,2,2,6,Hibernating
18184,65,15,1974.39,5,5,4,14,Champions
18185,606,14,4750.99,1,5,5,11,At Risk
18186,268,4,848.46,2,1,2,5,Hibernating
18187,400,12,3400.8900000000003,2,4,5,11,At Risk
18188,217,13,3859.18,3,4,5,12,Big Spenders
18189,309,11,1239.6,2,3,2,7,Regulars
18190,21,10,1119.73,5,3,2,10,Loyal
18191,7,11,1358.98,5,3,3,11,Loyal
18192,96,12,4125.26,4,4,5,13,Champions
18193,207,7,2372.41,3,1,4,8,Big Spenders
18194,2,14,1029.04,5,5,2,12,Loyal
18195,1218,4,452.76,1,1,1,3,Hibernating
18196,348,6,2382.96,2,1,4,7,Regulars
18197,162,13,1090.46,3,4,2,9,Regulars
18198,169,13,1302.53,3,4,3,10,Regulars
18199,436,3,624.73,2,1,1,4,Hibernating
18200,5,5,313.51,5,1,1,7,Regulars
18201,307,12,1621.33,2,4,3,9,At Risk
18202,74,8,1057.3700000000001,4,2,2,8,Regulars
18203,169,14,2445.61,3,5,4,12,Big Spenders
18204,38,7,625.08,5,1,1,7,Regulars
18205,239,13,2214.9,3,4,4,11,Big Spenders
18206,461,10,1428.96,1,3,3,7,Regulars
18207,73,16,2903.71,4,5,5,14,Champions
18208,458,4,350.9,2,1,1,4,Hibernating
18209,412,13,2075.0499999999997,2,4,4,10,At Risk
18210,503,9,2434.1400000000003,1,2,4,7,Regulars
18211,556,10,1080.17,1,3,2,6,Regulars
18212,646,8,1069.65,1,2,2,5,Hibernating
18213,298,8,1627.4199999999998,2,2,3,7,Regulars
18214,82,9,2538.2,4,2,4,10,Big Spenders
18215,752,8,2841.6,1,2,5,8,Regulars
18216,135,7,1728.3400000000001,4,1,4,9,Big Spenders
18217,101,9,1152.4,4,2,2,8,Regulars
18218,75,9,2277.66,4,2,4,10,Big Spenders
18219,124,13,2420.65,4,4,4,12,Champions
18220,201,9,947.76,3,2,2,7,Regulars
18221,333,16,2383.99,2,5,4,11,At Risk
18222,314,12,953.2199999999999,2,4,2,8,At Risk
18223,51,10,1053.3899999999999,5,3,2,10,Loyal
18224,120,9,769.05,4,2,1,7,Regulars
18225,232,10,2011.99,3,3,4,10,Big Spenders
18226,34,8,1019.42,5,2,2,9,Regulars
18227,120,9,1485.86,4,2,3,9,Regulars
18228,567,8,1054.91,1,2,2,5,Hibernating
18229,110,7,999.67,4,1,2,7,Regulars
18230,20,6,367.56,5,1,1,7,Regulars
18231,513,8,3285.34,1,2,5,8,Regulars
18232,196,12,5013.7,3,4,5,12,Big Spenders
18233,117,5,267.03999999999996,4,1,1,6,Regulars
18234,589,11,2369.56,1,3,4,8,Regulars
18235,229,13,1062.2,3,4,2,9,Regulars
18236,18,13,902.43,5,4,2,11,Loyal
18237,199,10,689.98,3,3,1,7,Regulars
18238,166,7,913.43,3,1,2,6,Regulars
18239,185,15,4927.31,3,5,5,13,Big Spenders
18240,192,12,628.8100000000001,3,4,1,8,Regulars
18241,125,13,2174.45,4,4,4,12,Champions
18242,764,8,802.59,1,2,1,4,Hibernating
18243,564,6,744.78,1,1,1,3,Hibernating
18244,740,12,1593.05,1,4,3,8,At Risk
18245,402,14,2963.34,2,5,5,12,At Risk
18246,340,10,1150.28,2,3,2,7,Regulars
18247,241,12,3419.37,3,4,5,12,Big Spenders
18248,730,6,524.88,1,1,1,3,Hibernating
18249,391,6,1189.4899999999998,2,1,2,5,Hibernating
18250,1303,8,834.05,1,2,1,4,Hibernating
18251,16,11,1012.27,5,3,2,10,Loyal
18252,96,17,5138.41,4,5,5,14,Champions
18253,872,8,808.5,1,2,1,4,Hibernating
18254,619,8,1485.12,1,2,3,6,Regulars
18255,298,11,849.42,2,3,2,7,Regulars
18256,194,15,5420.7,3,5,5,13,Big Spenders
18257,75,11,1222.17,4,3,2,9,Loyal
18258,223,10,2778.6800000000003,3,3,5,11,Big Spenders
18259,254,5,1012.04,2,1,2,5,Hibernating
18260,226,11,1744.27,3,3,4,10,Big Spenders
18261,133,13,1318.76,4,4,3,11,Loyal
18262,33,6,1648.6899999999998,5,1,3,9,Regulars
18263,1682,7,858.32,1,1,2,4,Hibernating
18264,182,13,4601.7,3,4,5,12,Big Spenders
18265,140,13,2520.54,4,4,4,12,Champions
18266,752,9,1614.96,1,2,3,6,Regulars
18267,58,6,946.83,5,1,2,8,Regulars
18268,14,12,3650.9100000000003,5,4,5,14,Champions
18269,551,10,1509.78,1,3,3,7,Regulars
18270,0,9,2253.42,5,2,4,11,Big Spenders
18271,711,15,1705.21,1,5,3,9,At Risk
18272,160,11,1363.23,3,3,3,9,Regulars
18273,160,10,1109.68,3,3,2,8,Regulars
18274,197,6,658.3299999999999,3,1,1,5,Regulars
18275,35,8,672.9200000000001,5,2,1,8,Regulars
18276,441,13,1808.7199999999998,2,4,4,10,At Risk
18277,1,9,1555.88,5,2,3,10,Regulars
18278,48,7,488.01,5,1,1,7,Regulars
18279,55,8,298.59,5,2,1,8,Regulars
18280,560,8,1039.95,1,2,2,5,Hibernating
18281,275,12,1786.4,2,4,4,10,At Risk
18282,886,11,2004.77,1,3,4,8,Regulars
18283,186,11,2178.0,3,3,4,10,Big Spenders
18284,5,9,3713.12,5,2,5,12,Big Spenders
18285,88,10,950.9,4,3,2,9,Loyal
18286,166,10,2114.15,3,3,4,10,Big Spenders
18287,702,11,2023.8999999999999,1,3,4,8,Regulars
18288,114,9,1675.94,4,2,3,9,Regulars
18289,153,8,995.57,3,2,2,7,Regulars
18290,23,9,3021.7099999999996,5,2,5,12,Big Spenders
18291,238,9,1070.51,3,2,2,7,Regulars
18292,709,6,811.95,1,1,1,3,Hibernating
18293,18,15,2813.54,5,5,5,15,Champions
18294,244,13,2396.12,3,4,4,11,Big Spenders
18295,264,14,1653.91,2,5,3,10,At Risk
18296,11,7,452.73,5,1,1,7,Regulars
18297,191,9,603.95,3,2,1,6,Regulars
18298,132,11,1478.17,4,3,3,10,Loyal
18299,98,11,970.92,4,3,2,9,Loyal
18300,280,7,803.64,2,1,1,4,Hibernating
18301,440,11,2279.93,2,3,4,9,Regulars
18302,322,10,3230.5399999999995,2,3,5,10,Regulars
18303,439,13,3341.4400000000005,2,4,5,11,At Risk
18304,21,10,1217.85,5,3,2,10,Loyal
18305,214,8,1505.78,3,2,3,8,Regulars
18306,219,12,1481.0,3,4,3,10,Regulars
18307,13,10,1148.58,5,3,2,10,Loyal
18308,219,8,651.52,3,2,1,6,Regulars
18309,380,11,2095.0,2,3,4,9,Regulars
18310,224,8,558.4300000000001,3,2,1,6,Regulars
18311,830,9,609.47,1,2,1,4,Hibernating
18312,95,11,747.89,4,3,1,8,Loyal
18313,982,6,621.0500000000001,1,1,1,3,Hibernating
18314,124,13,2173.35,4,4,4,12,Champions
18315,84,10,1917.28,4,3,4,11,Loyal
18316,47,8,1507.63,5,2,3,10,Regulars
18317,19,10,3019.2799999999997,5,3,5,13,Loyal
18318,438,7,517.5899999999999,2,1,1,4,Hibernating
18319,69,11,1255.75,4,3,3,10,Loyal
18320,465,6,697.43,1,1,1,3,Hibernating
18321,82,16,3725.21,4,5,5,14,Champions
18322,305,11,1253.8,2,3,3,8,Regulars
18323,282,9,1493.52,2,2,3,7,Regulars
18324,23,10,1293.82,5,3,3,11,Loyal
18325,108,15,1641.09,4,5,3,12,Loyal
18326,159,7,734.99,3,1,1,5,Regulars
18327,46,13,2454.46,5,4,4,13,Champions
18328,82,12,1747.6000000000001,4,4,4,12,Champions
18329,659,13,1479.46,1,4,3,8,At Risk
18330,363,12,3303.2999999999997,2,4,5,11,At Risk
18331,351,13,1421.31,2,4,3,9,At Risk
18332,943,12,3273.4500000000003,1,4,5,10,At Risk
18333,307,9,1034.07,2,2,2,6,Hibernating
18334,164,9,527.58,3,2,1,6,Regulars
18335,16,13,1097.79,5,4,2,11,Loyal
18336,85,13,1052.24,4,4,2,10,Loyal
18337,474,11,3471.32,1,3,5,9,Regulars
18338,19,10,1148.4099999999999,5,3,2,10,Loyal
18339,252,8,556.4,2,2,1,5,Hibernating
18340,493,6,640.93,1,1,1,3,Hibernating
18341,34,11,2159.69,5,3,4,12,Loyal
18342,31,12,1196.06,5,4,2,11,Loyal
18343,132,8,2691.04,4,2,5,11,Big Spenders
18344,204,7,549.2399999999999,3,1,1,5,Regulars
18345,209,16,5070.38,3,5,5,13,Big Spenders
18346,275,8,1034.8999999999999,2,2,2,6,Hibernating
18347,17,11,1517.81,5,3,3,11,Loyal
18348,950,10,1380.81,1,3,3,7,Regulars
18349,85,8,1676.97,4,2,3,9,Regulars
18350,104,7,3220.0499999999997,4,1,5,10,Big Spenders
18351,135,11,2090.81,4,3,4,11,Loyal
18352,182,11,1524.65,3,3,3,9,Regulars
18353,534,5,2269.41,1,1,4,6,Regulars
18354,640,10,1011.86,1,3,2,6,Regulars
18355,3,6,433.21999999999997,5,1,1,7,Regulars
18356,314,13,1667.89,2,4,3,9,At Risk
18357,427,6,2011.6999999999998,2,1,4,7,Regulars
18358,165,18,3923.03,3,5,5,13,Big Spenders
18359,97,10,1222.07,4,3,2,9,Loyal
18360,65,7,861.82,5,1,2,8,Regulars
18361,147,11,3810.86,4,3,5,12,Loyal
18362,178,10,796.95,3,3,1,7,Regulars
18363,44,11,2440.48,5,3,4,12,Loyal
18364,251,7,746.89,2,1,1,4,Hibernating
18365,70,9,1322.1,4,2,3,9,Regulars
18366,816,10,951.7,1,3,2,6,Regulars
18367,74,12,1187.8899999999999,4,4,2,10,Loyal
18368,6,15,1721.02,5,5,3,13,Loyal
18369,427,14,2134.7400000000002,2,5,4,11,At Risk
18370,208,13,1512.98,3,4,3,10,Regulars
18371,248,8,2490.6,2,2,4,8,Regulars
18372,213,11,1420.51,3,3,3,9,Regulars
18373,127,14,1368.72,4,5,3,12,Loyal
18374,86,9,562.4,4,2,1,7,Regulars
18375,226,12,1294.65,3,4,3,10,Regulars
18376,40,13,3461.55,5,4,5,14,Champions
18377,211,8,1455.47,3,2,3,8,Regulars
18378,298,15,1601.76,2,5,3,10,At Risk
18379,12,10,1434.72,5,3,3,11,Loyal
18380,121,12,1318.5600000000002,4,4,3,11,Loyal
18381,123,10,1559.17,4,3,3,10,Loyal
18382,124,12,671.38,4,4,1,9,Loyal
18383,259,16,1572.81,2,5,3,10,At Risk
18384,69,12,1091.24,4,4,2,10,Loyal
18385,203,6,642.15,3,1,1,5,Regulars
18386,157,12,2823.09,3,4,5,12,Big Spenders
18387,17,13,1001.47,5,4,2,11,Loyal
18388,157,10,611.69,3,3,1,7,Regulars
18389,220,7,567.49,3,1,1,5,Regulars
18390,274,9,1153.97,2,2,2,6,Hibernating
18391,20,8,861.65,5,2,2,9,Regulars
18392,0,14,2135.01,5,5,4,14,Champions
18393,204,10,1306.21,3,3,3,9,Regulars
18394,200,10,1557.29,3,3,3,9,Regulars
18395,164,13,2129.09,3,4,4,11,Big Spenders
18396,144,14,2932.01,4,5,5,14,Champions
18397,185,10,907.11,3,3,2,8,Regulars
18398,159,18,4041.7200000000003,3,5,5,13,Big Spenders
18399,155,20,2582.79,3,5,5,13,Big Spenders
18400,68,9,613.73,4,2,1,7,Regulars
18401,1,15,2869.88,5,5,5,15,Champions
18402,23,13,2231.72,5,4,4,13,Champions
18403,855,8,2155.7599999999998,1,2,4,7,Regulars
18404,287,6,490.15999999999997,2,1,1,4,Hibernating
18405,174,8,594.26,3,2,1,6,Regulars
18406,71,10,1519.48,4,3,3,10,Loyal
18407,2,9,1926.82,5,2,4,11,Big Spenders
18408,10,10,654.46,5,3,1,9,Loyal
18409,75,5,711.39,4,1,1,6,Regulars
18410,602,9,1352.44,1,2,3,6,Regulars
18411,251,16,1315.24,2,5,3,10,At Risk
18412,464,5,608.3399999999999,1,1,1,3,Hibernating
18413,360,9,1521.1,2,2,3,7,Regulars
18414,81,11,1333.76,4,3,3,10,Loyal
18415,130,7,3256.7400000000002,4,1,5,10,Big Spenders
18416,90,8,576.9499999999999,4,2,1,7,Regulars
18417,38,13,4486.42,5,4,5,14,Champions
18418,86,5,758.31,4,1,1,6,Regulars
18419,80,18,1844.04,4,5,4,13,Champions
18420,83,10,3226.1299999999997,4,3,5,12,Loyal
18421,244,9,1268.1999999999998,3,2,3,8,Regulars
18422,109,4,213.35,4,1,1,6,Regulars
18423,160,11,1329.1399999999999,3,3,3,9,Regulars
18424,126,12,1331.7299999999998,4,4,3,11,Loyal
18425,296,10,3301.26,2,3,5,10,Regulars
18426,529,7,1027.32,1,1,2,4,Hibernating
18427,300,13,4121.09,2,4,5,11,At Risk
18428,19,12,2485.71,5,4,4,13,Champions
18429,237,9,2331.9,3,2,4,9,Big Spenders
18430,154,15,4560.6900000000005,3,5,5,13,Big Spenders
18431,400,15,2297.76,2,5,4,11,At Risk
18432,55,12,2582.17,5,4,5,14,Champions
18433,58,10,1959.0400000000002,5,3,4,12,Loyal
18434,1189,7,3511.86,1,1,5,7,Regulars
18435,105,10,980.91,4,3,2,9,Loyal
18436,185,15,1766.61,3,5,4,12,Big Spenders
18437,498,11,2125.65,1,3,4,8,Regulars
18438,66,9,1833.0500000000002,4,2,4,10,Big Spenders
18439,688,8,458.91999999999996,1,2,1,4,Hibernating
18440,398,14,2362.47,2,5,4,11,At Risk
18441,445,10,3262.9900000000002,2,3,5,10,Regulars
18442,520,5,728.51,1,1,1,3,Hibernating
18443,488,15,4676.05,1,5,5,11,At Risk
18444,269,14,1909.16,2,5,4,11,At Risk
18445,17,15,1246.66,5,5,3,13,Loyal
18446,8,8,1458.07,5,2,3,10,Regulars
18447,118,9,1443.28,4,2,3,9,Regulars
18448,472,15,3635.64,1,5,5,11,At Risk
18449,111,7,707.14,4,1,1,6,Regulars
18450,617,8,757.2,1,2,1,4,Hibernating
18451,350,11,1424.1599999999999,2,3,3,8,Regulars
18452,628,4,233.56,1,1,1,3,Hibernating
18453,277,13,1249.04,2,4,3,9,At Risk
18454,109,10,909.5300000000001,4,3,2,9,Loyal
18455,1368,3,797.8,1,1,1,3,Hibernating
18456,110,10,910.13,4,3,2,9,Loyal
18457,50,14,3902.08,5,5,5,15,Champions
18458,51,14,2911.04,5,5,5,15,Champions
18459,134,12,1860.5,4,4,4,12,Champions
18460,209,15,1030.72,3,5,2,10,Regulars
18461,298,11,1350.05,2,3,3,8,Regulars
18462,19,7,343.2,5,1,1,7,Regulars
18463,55,13,1526.83,5,4,3,12,Loyal
18464,41,13,955.3399999999999,5,4,2,11,Loyal
18465,362,6,606.16,2,1,1,4,Hibernating
18466,600,10,1199.7,1,3,2,6,Regulars
18467,152,15,2951.66,3,5,5,13,Big Spenders
18468,292,6,334.83,2,1,1,4,Hibernating
18469,599,8,2063.59,1,2,4,7,Regulars
18470,176,13,1712.96,3,4,3,10,Regulars
18471,228,14,7242.65,3,5,5,13,Big Spenders
18472,381,10,1229.3000000000002,2,3,2,7,Regulars
18473,21,11,2672.7,5,3,5,13,Loyal
18474,26,16,2668.4900000000002,5,5,5,15,Champions
18475,833,9,808.69,1,2,1,4,Hibernating
18476,302,8,1987.04,2,2,4,8,Regulars
18477,108,13,4025.06,4,4,5,13,Champions
18478,306,10,2884.17,2,3,5,10,Regulars
18479,273,13,2221.25,2,4,4,10,At Risk
18480,67,10,1135.41,4,3,2,9,Loyal
18481,20,11,2190.63,5,3,4,12,Loyal
18482,27,12,3243.33,5,4,5,14,Champions
18483,174,12,2320.5,3,4,4,11,Big Spenders
18484,0,11,1156.34,5,3,2,10,Loyal
18485,196,13,2074.4900000000002,3,4,4,11,Big Spenders
18486,10,14,1456.6399999999999,5,5,3,13,Loyal
18487,8,12,2347.79,5,4,4,13,Champions
18488,413,8,1526.5800000000002,2,2,3,7,Regulars
18489,291,11,862.88,2,3,2,7,Regulars
18490,53,10,1326.56,5,3,3,11,Loyal
18491,147,10,1229.44,4,3,2,9,Loyal
18492,137,10,2186.5699999999997,4,3,4,11,Loyal
18493,268,9,806.11,2,2,1,5,Hibernating
18494,329,11,1973.46,2,3,4,9,Regulars
18495,151,5,446.47,3,1,1,5,Regulars
18496,122,7,1220.89,4,1,2,7,Regulars
18497,168,14,4392.64,3,5,5,13,Big Spenders
18498,645,7,505.61,1,1,1,3,Hibernating
18499,29,12,1287.38,5,4,3,12,Loyal
18500,156,11,1747.3400000000001,3,3,4,10,Big Spenders
18501,59,13,1894.61,5,4,4,13,Champions
18502,987,7,1088.55,1,1,2,4,Hibernating
18503,15,20,3507.0299999999997,5,5,5,15,Champions
18504,74,18,5827.65,4,5,5,14,Champions
18505,310,4,460.27,2,1,1,4,Hibernating
18506,284,13,1697.24,2,4,3,9,At Risk
18507,351,10,2539.64,2,3,4,9,Regulars
18508,793,7,1466.73,1,1,3,5,Regulars
18509,251,11,1084.23,2,3,2,7,Regulars
18510,99,14,4185.63,4,5,5,14,Champions
18511,64,13,2074.0099999999998,5,4,4,13,Champions
18512,147,14,1221.13,4,5,2,11,Loyal
18513,566,9,617.25,1,2,1,4,Hibernating
18514,48,13,3597.96,5,4,5,14,Champions
18515,125,8,1367.0400000000002,4,2,3,9,Regulars
18516,2,11,1067.08,5,3,2,10,Loyal
18517,345,8,1282.1999999999998,2,2,3,7,Regulars
18518,598,5,744.6,1,1,1,3,Hibernating
18519,201,10,1248.28,3,3,3,9,Regulars
18520,141,8,817.23,4,2,1,7,Regulars
18521,199,13,1365.0700000000002,3,4,3,10,Regulars
18522,267,9,1830.25,2,2,4,8,Regulars
18523,21,13,3868.69,5,4,5,14,Champions
18524,330,8,923.43,2,2,2,6,Hibernating
18525,123,12,2411.63,4,4,4,12,Champions
18526,53,11,1447.9499999999998,5,3,3,11,Loyal
18527,84,11,1296.48,4,3,3,10,Loyal
18528,309,6,390.33,2,1,1,4,Hibernating
18529,441,6,561.44,2,1,1,4,Hibernating
18530,431,12,2685.5,2,4,5,11,At Risk
18531,1621,6,1037.09,1,1,2,4,Hibernating
18532,187,9,1825.87,3,2,4,9,Big Spenders
18533,186,12,533.24,3,4,1,8,Regulars
18534,41,16,2740.84,5,5,5,15,Champions
18535,5,10,2820.79,5,3,5,13,Loyal
18536,501,12,2444.0,1,4,4,9,At Risk
18537,411,7,873.9200000000001,2,1,2,5,Hibernating
18538,108,8,563.0999999999999,4,2,1,7,Regulars
18539,238,9,2161.41,3,2,4,9,Big Spenders
18540,42,16,2022.92,5,5,4,14,Champions
18541,184,15,975.05,3,5,2,10,Regulars
18542,227,10,1054.68,3,3,2,8,Regulars
18543,39,12,1693.16,5,4,3,12,Loyal
18544,96,16,2800.25,4,5,5,14,Champions
18545,455,9,1550.94,2,2,3,7,Regulars
18546,34,9,1399.8700000000001,5,2,3,10,Regulars
18547,67,12,4233.369999999999,4,4,5,13,Champions
18548,80,8,1195.08,4,2,2,8,Regulars
18549,36,12,2752.41,5,4,5,14,Champions
18550,145,9,1079.6,4,2,2,8,Regulars
18551,93,6,2152.12,4,1,4,9,Big Spenders
18552,27,6,1203.58,5,1,2,8,Regulars
18553,433,8,674.21,2,2,1,5,Hibernating
18554,223,13,1871.48,3,4,4,11,Big Spenders
18555,437,8,1120.96,2,2,2,6,Hibernating
18556,43,10,1375.77,5,3,3,11,Loyal
18557,602,10,1830.77,1,3,4,8,Regulars
18558,245,10,1811.39,3,3,4,10,Big Spenders
18559,1011,5,474.94,1,1,1,3,Hibernating
18560,529,16,2167.1800000000003,1,5,4,10,At Risk
18561,1474,6,2205.92,1,1,4,6,Regulars
18562,130,13,991.11,4,4,2,10,Loyal
18563,4,11,1124.09,5,3,2,10,Loyal
18564,244,10,895.1400000000001,3,3,2,8,Regulars
18565,194,13,3166.79,3,4,5,12,Big Spenders
18566,253,9,1595.07,2,2,3,7,Regulars
18567,119,15,3148.34,4,5,5,14,Champions
18568,152,11,1381.29,3,3,3,9,Regulars
18569,286,6,1204.2000000000003,2,1,2,5,Hibernating
18570,815,12,3190.89,1,4,5,10,At Risk
18571,104,8,518.7,4,2,1,7,Regulars
18572,65,15,2584.34,5,5,5,15,Champions
18573,360,8,1294.52,2,2,3,7,Regulars
18574,60,11,2127.38,5,3,4,12,Loyal
18575,182,16,3651.9100000000003,3,5,5,13,Big Spenders
18576,527,5,700.54,1,1,1,3,Hibernating
18577,89,8,949.89,4,2,2,8,Regulars
18578,333,14,3056.87,2,5,5,12,At Risk
18579,89,14,3123.27,4,5,5,14,Champions
18580,7,10,2307.82,5,3,4,12,Loyal
18581,111,7,1320.57,4,1,3,8,Regulars
18582,187,14,1064.83,3,5,2,10,Regulars
18583,415,14,1918.8,2,5,4,11,At Risk
18584,267,10,4532.8099999999995,2,3,5,10,Regulars
18585,175,9,2802.89,3,2,5,10,Big Spenders
18586,35,6,1417.8799999999997,5,1,3,9,Regulars
18587,297,9,760.52,2,2,1,5,Hibernating
18588,12,12,1597.9099999999999,5,4,3,12,Loyal
18589,125,11,1030.15,4,3,2,9,Loyal
18590,184,10,1798.1,3,3,4,10,Big Spenders
18591,238,15,1957.63,3,5,4,12,Big Spenders
18592,204,10,773.35,3,3,1,7,Regulars
18593,75,10,671.4300000000001,4,3,1,8,Loyal
18594,80,15,1691.5,4,5,3,12,Loyal
18595,346,14,1144.48,2,5,2,9,At Risk
18596,142,10,897.61,4,3,2,9,Loyal
18597,317,8,615.61,2,2,1,5,Hibernating
18598,57,9,1777.21,5,2,4,11,Big Spenders
18599,88,8,800.8900000000001,4,2,1,7,Regulars
18600,548,10,853.89,1,3,2,6,Regulars
18601,118,12,4348.74,4,4,5,13,Champions
18602,449,6,434.11,2,1,1,4,Hibernating
18603,263,9,2542.96,2,2,4,8,Regulars
18604,560,8,2270.34,1,2,4,7,Regulars
18605,318,11,1863.97,2,3,4,9,Regulars
18606,554,9,641.18,1,2,1,4,Hibernating
18607,898,10,1438.13,1,3,3,7,Regulars
18608,406,6,3040.86,2,1,5,8,Regulars
18609,0,13,1574.74,5,4,3,12,Loyal
18610,88,8,1008.19,4,2,2,8,Regulars
18611,23,6,1061.75,5,1,2,8,Regulars
18612,27,4,816.5099999999999,5,1,1,7,Regulars
18613,135,13,2436.86,4,4,4,12,Champions
18614,420,14,3579.94,2,5,5,12,At Risk
18615,101,12,2260.9,4,4,4,12,Champions
18616,187,5,415.64,3,1,1,5,Regulars
18617,136,11,2067.9700000000003,4,3,4,11,Loyal
18618,591,7,1751.8000000000002,1,1,4,6,Regulars
18619,176,8,1054.64,3,2,2,7,Regulars
18620,354,13,1079.6,2,4,2,8,At Risk
18621,56,12,3236.5200000000004,5,4,5,14,Champions
18622,33,17,6704.849999999999,5,5,5,15,Champions
18623,128,12,1638.8400000000001,4,4,3,11,Loyal
18624,9,13,1201.04,5,4,2,11,Loyal
18625,281,8,3986.16,2,2,5,9,Regulars
18626,123,9,2384.65,4,2,4,10,Big Spenders
18627,356,11,777.83,2,3,1,6,Regulars
18628,139,9,869.76,4,2,2,8,Regulars
18629,1010,9,1721.4399999999998,1,2,3,6,Regulars
18630,881,12,1330.02,1,4,3,8,At Risk
18631,746,6,1885.54,1,1,4,6,Regulars
18632,99,12,2621.02,4,4,5,13,Champions
18633,212,7,1139.02,3,1,2,6,Regulars
18634,44,11,766.8900000000001,5,3,1,9,Loyal
18635,139,12,1544.59,4,4,3,11,Loyal
18636,266,12,3306.63,2,4,5,11,At Risk
18637,92,13,958.46,4,4,2,10,Loyal
18638,55,9,807.67,5,2,1,8,Regulars
18639,256,9,892.3000000000001,2,2,2,6,Hibernating
18640,58,10,1456.34,5,3,3,11,Loyal
18641,258,13,2724.69,2,4,5,11,At Risk
18642,260,7,1102.83,2,1,2,5,Hibernating
18643,204,14,6903.24,3,5,5,13,Big Spenders
18644,144,12,1548.47,4,4,3,11,Loyal
18645,148,13,1792.04,3,4,4,11,Big Spenders
18646,246,12,3094.23,3,4,5,12,Big Spenders
18647,349,11,3505.87,2,3,5,10,Regulars
18648,906,9,1978.1,1,2,4,7,Regulars
18649,196,7,1371.8799999999999,3,1,3,7,Regulars
18650,388,11,1638.91,2,3,3,8,Regulars
18651,26,11,7048.0199999999995,5,3,5,13,Loyal
18652,233,13,1125.8799999999999,3,4,2,9,Regulars
18653,323,12,801.8199999999999,2,4,1,7,At Risk
18654,201,9,1004.05,3,2,2,7,Regulars
18655,44,6,670.3,5,1,1,7,Regulars
18656,642,6,992.67,1,1,2,4,Hibernating
18657,69,14,2238.42,4,5,4,13,Champions
18658,99,13,978.73,4,4,2,10,Loyal
18659,126,17,1631.78,4,5,3,12,Loyal
18660,1843,5,536.11,1,1,1,3,Hibernating
18661,283,12,1661.57,2,4,3,9,At Risk
18662,205,7,412.81,3,1,1,5,Regulars
18663,17,10,773.58,5,3,1,9,Loyal
18664,213,21,2573.11,3,5,4,12,Big Spenders
18665,17,12,1570.04,5,4,3,12,Loyal
18666,336,9,1045.45,2,2,2,6,Hibernating
18667,41,12,2039.73,5,4,4,13,Champions
18668,50,15,2985.73,5,5,5,15,Champions
18669,133,5,577.98,4,1,1,6,Regulars
18670,102,12,1000.88,4,4,2,10,Loyal
18671,372,8,971.92,2,2,2,6,Hibernating
18672,436,8,2729.43,2,2,5,9,Regulars
18673,178,15,3799.02,3,5,5,13,Big Spenders
18674,804,12,3721.7,1,4,5,10,At Risk
18675,435,13,3673.5,2,4,5,11,At Risk
18676,343,11,3254.33,2,3,5,10,Regulars
18677,175,13,1228.29,3,4,2,9,Regulars
18678,124,9,817.66,4,2,1,7,Regulars
18679,388,7,1411.39,2,1,3,6,Regulars
18680,351,9,833.41,2,2,1,5,Hibernating
18681,132,8,1699.9899999999998,4,2,3,9,Regulars
18682,1615,3,345.71000000000004,1,1,1,3,Hibernating
18683,111,8,1483.26,4,2,3,9,Regulars
18684,187,11,2317.52,3,3,4,10,Big Spenders
18685,119,13,1208.56,4,4,2,10,Loyal
18686,674,12,910.3100000000001,1,4,2,7,At Risk
18687,839,10,1229.51,1,3,2,6,Regulars
18688,90,6,2794.15,4,1,5,10,Big Spenders
18689,398,8,975.01,2,2,2,6,Hibernating
18690,187,10,997.3199999999999,3,3,2,8,Regulars
18691,448,10,1163.24,2,3,2,7,Regulars
18692,718,7,602.11,1,1,1,3,Hibernating
18693,1308,8,766.6,1,2,1,4,Hibernating
18694,145,13,1307.68,4,4,3,11,Loyal
18695,441,6,402.23,2,1,1,4,Hibernating
18696,141,8,471.73,4,2,1,7,Regulars
18697,388,12,4378.23,2,4,5,11,At Risk
18698,685,10,1517.19,1,3,3,7,Regulars
18699,299,9,1799.1399999999999,2,2,4,8,Regulars
18700,5,12,1712.3600000000001,5,4,3,12,Loyal
18701,64,16,1721.14,5,5,3,13,Loyal
18702,554,12,1181.44,1,4,2,7,At Risk
18703,262,13,818.23,2,4,1,7,At Risk
18704,147,11,4971.46,4,3,5,12,Loyal
18705,22,13,1970.3,5,4,4,13,Champions
18706,1166,7,891.72,1,1,2,4,Hibernating
18707,428,9,799.66,2,2,1,5,Hibernating
18708,52,9,2440.38,5,2,4,11,Big Spenders
18709,12,11,1113.82,5,3,2,10,Loyal
18710,55,13,2615.0200000000004,5,4,5,14,Champions
18711,222,13,1709.63,3,4,3,10,Regulars
18712,90,12,1956.54,4,4,4,12,Champions
18713,68,8,1752.7199999999998,4,2,4,10,Big Spenders
18714,104,9,2913.23,4,2,5,11,Big Spenders
18715,440,14,3063.6099999999997,2,5,5,12,At Risk
18716,584,9,609.8199999999999,1,2,1,4,Hibernating
18717,119,8,2847.92,4,2,5,11,Big Spenders
18718,24,8,824.8100000000001,5,2,1,8,Regulars
18719,516,13,1596.4,1,4,3,8,At Risk
18720,795,14,2348.55,1,5,4,10,At Risk
18721,299,10,1455.16,2,3,3,8,Regulars
18722,480,6,473.69,1,1,1,3,Hibernating
18723,26,19,5467.320000000001,5,5,5,15,Champions
18724,60,11,1068.04,5,3,2,10,Loyal
18725,415,6,1673.2300000000002,2,1,3,6,Regulars
18726,103,9,3131.08,4,2,5,11,Big Spenders
18727,207,10,1644.24,3,3,3,9,Regulars
18728,404,11,4607.96,2,3,5,10,Regulars
18729,574,6,323.97,1,1,1,3,Hibernating
18730,74,11,664.0699999999999,4,3,1,8,Loyal
18731,221,7,1983.94,3,1,4,8,Big Spenders
18732,405,7,825.47,2,1,1,4,Hibernating
18733,543,6,965.72,1,1,2,4,Hibernating
18734,307,14,4192.89,2,5,5,12,At Risk
18735,107,13,7407.21,4,4,5,13,Champions
18736,78,11,2131.04,4,3,4,11,Loyal
18737,1008,5,1195.37,1,1,2,4,Hibernating
18738,18,9,615.24,5,2,1,8,Regulars
18739,99,9,2132.29,4,2,4,10,Big Spenders
18740,45,11,1834.52,5,3,4,12,Loyal
18741,346,10,829.27,2,3,1,6,Regulars
18742,7,10,4254.33,5,3,5,13,Loyal
18743,526,5,284.26,1,1,1,3,Hibernating
18744,166,9,1025.28,3,2,2,7,Regulars
18745,764,8,622.63,1,2,1,4,Hibernating
18746,162,12,3151.14,3,4,5,12,Big Spenders
18747,235,12,1560.56,3,4,3,10,Regulars
18748,70,11,4366.26,4,3,5,12,Loyal
18749,292,11,3784.5799999999995,2,3,5,10,Regulars
18750,53,8,1121.8,5,2,2,9,Regulars
18751,203,12,2485.68,3,4,4,11,Big Spenders
18752,22,13,1208.03,5,4,2,11,Loyal
18753,167,11,1115.52,3,3,2,8,Regulars
18754,186,8,1847.15,3,2,4,9,Big Spenders
18755,213,7,824.51,3,1,1,5,Regulars
18756,5,11,1003.5,5,3,2,10,Loyal
18757,89,9,1670.48,4,2,3,9,Regulars
18758,163,12,2453.21,3,4,4,11,Big Spenders
18759,753,8,1143.6499999999999,1,2,2,5,Hibernating
18760,45,15,2069.4,5,5,4,14,Champions
18761,2,17,2195.49,5,5,4,14,Champions
18762,108,9,889.01,4,2,2,8,Regulars
18763,20,10,2972.95,5,3,5,13,Loyal
18764,1169,4,2301.75,1,1,4,6,Regulars
18765,289,9,999.3000000000001,2,2,2,6,Hibernating
18766,172,8,872.5,3,2,2,7,Regulars
18767,200,13,2512.11,3,4,4,11,Big Spenders
18768,128,4,600.87,4,1,1,6,Regulars
18769,129,9,2786.9500000000003,4,2,5,11,Big Spenders
18770,556,15,1860.64,1,5,4,10,At Risk
18771,7,16,2336.48,5,5,4,14,Champions
18772,12,11,2189.2200000000003,5,3,4,12,Loyal
18773,582,10,1086.93,1,3,2,6,Regulars
18774,199,14,3199.8800000000006,3,5,5,13,Big Spenders
18775,397,5,583.37,2,1,1,4,Hibernating
18776,381,9,1082.99,2,2,2,6,Hibernating
18777,396,8,2163.36,2,2,4,8,Regulars
18778,440,8,2180.8899999999994,2,2,4,8,Regulars
18779,85,14,1916.78,4,5,4,13,Champions
18780,327,14,1901.9099999999999,2,5,4,11,At Risk
18781,657,13,1461.07,1,4,3,8,At Risk
18782,625,9,730.5799999999999,1,2,1,4,Hibernating
18783,419,10,1329.66,2,3,3,8,Regulars
18784,118,20,1783.97,4,5,4,13,Champions
18785,63,4,397.32,5,1,1,7,Regulars
18786,102,10,1295.66,4,3,3,10,Loyal
18787,62,17,1484.58,5,5,3,13,Loyal
18788,297,8,698.78,2,2,1,5,Hibernating
18789,33,10,1913.3400000000001,5,3,4,12,Loyal
18790,56,15,3449.2599999999998,5,5,5,15,Champions
18791,187,12,1416.43,3,4,3,10,Regulars
18792,7,9,2085.7999999999997,5,2,4,11,Big Spenders
18793,190,12,1666.19,3,4,3,10,Regulars
18794,130,5,681.2,4,1,1,6,Regulars
18795,187,12,761.21,3,4,1,8,Regulars
18796,176,12,1224.04,3,4,2,9,Regulars
18797,114,12,1718.3,4,4,3,11,Loyal
18798,60,9,514.0999999999999,5,2,1,8,Regulars
18799,785,8,786.66,1,2,1,4,Hibernating
18800,895,11,1611.52,1,3,3,7,Regulars
18801,79,18,3782.38,4,5,5,14,Champions
18802,213,7,506.43999999999994,3,1,1,5,Regulars
18803,207,10,692.46,3,3,1,7,Regulars
18804,850,6,1127.75,1,1,2,4,Hibernating
18805,147,19,2658.11,4,5,5,14,Champions
18806,259,8,712.96,2,2,1,5,Hibernating
18807,567,11,1247.03,1,3,3,7,Regulars
18808,2,6,635.11,5,1,1,7,Regulars
18809,351,10,1088.18,2,3,2,7,Regulars
18810,45,11,2453.5,5,3,4,12,Loyal
18811,52,8,1032.3600000000001,5,2,2,9,Regulars
18812,514,13,1016.48,1,4,2,7,At Risk
18813,1044,6,310.86,1,1,1,3,Hibernating
18814,1298,8,1647.1000000000001,1,2,3,6,Regulars
18815,108,13,2674.9800000000005,4,4,5,13,Champions
18816,374,12,939.0400000000001,2,4,2,8,At Risk
18817,48,8,1426.0,5,2,3,10,Regulars
18818,48,12,951.26,5,4,2,11,Loyal
18819,506,8,1189.92,1,2,2,5,Hibernating
18820,373,10,1484.79,2,3,3,8,Regulars
18821,2,8,573.9499999999999,5,2,1,8,Regulars
18822,151,9,590.6800000000001,3,2,1,6,Regulars
18823,184,9,3035.53,3,2,5,10,Big Spenders
18824,330,10,3768.2599999999998,2,3,5,10,Regulars
18825,21,12,1212.65,5,4,2,11,Loyal
18826,11,6,306.70000000000005,5,1,1,7,Regulars
18827,195,8,1582.3500000000001,3,2,3,8,Regulars
18828,9,8,2266.46,5,2,4,11,Big Spenders
18829,328,10,1146.74,2,3,2,7,Regulars
18830,247,8,1827.12,3,2,4,9,Big Spenders
18831,452,10,994.28,2,3,2,7,Regulars
18832,239,7,393.75,3,1,1,5,Regulars
18833,290,19,5167.790000000001,2,5,5,12,At Risk
18834,88,11,1980.8099999999997,4,3,4,11,Loyal
18835,686,9,979.77,1,2,2,5,Hibernating
18836,742,10,1475.57,1,3,3,7,Regulars
18837,95,8,547.65,4,2,1,7,Regulars
18838,738,4,1023.45,1,1,2,4,Hibernating
18839,152,12,752.32,3,4,1,8,Regulars
18840,31,11,792.48,5,3,1,9,Loyal
18841,149,12,1783.06,3,4,4,11,Big Spenders
18842,100,9,1180.9099999999999,4,2,2,8,Regulars
18843,156,10,1106.49,3,3,2,8,Regulars
18844,68,5,339.61999999999995,4,1,1,6,Regulars
18845,19,13,2435.61,5,4,4,13,Champions
18846,253,5,926.06,2,1,2,5,Hibernating
18847,678,5,686.75,1,1,1,3,Hibernating
18848,70,12,1525.34,4,4,3,11,Loyal
18849,274,7,685.87,2,1,1,4,Hibernating
18850,465,10,1605.74,1,3,3,7,Regulars
18851,265,10,846.49,2,3,2,7,Regulars
18852,307,9,828.07,2,2,1,5,Hibernating
18853,486,7,477.64,1,1,1,3,Hibernating
18854,105,6,1358.69,4,1,3,8,Regulars
18855,63,11,1746.6200000000001,5,3,4,12,Loyal
18856,556,6,615.98,1,1,1,3,Hibernating
18857,9,12,3017.5,5,4,5,14,Champions
18858,154,13,3185.19,3,4,5,12,Big Spenders
18859,824,9,601.9200000000002,1,2,1,4,Hibernating
18860,132,9,1560.77,4,2,3,9,Regulars
18861,246,9,1002.9399999999999,3,2,2,7,Regulars
18862,325,14,3577.36,2,5,5,12,At Risk
18863,55,12,1277.1899999999998,5,4,3,12,Loyal
18864,2,12,2678.17,5,4,5,14,Champions
18865,726,14,2707.23,1,5,5,11,At Risk
18866,53,9,744.72,5,2,1,8,Regulars
18867,747,10,582.15,1,3,1,5,Regulars
18868,425,10,976.16,2,3,2,7,Regulars
18869,1,16,1310.68,5,5,3,13,Loyal
18870,416,5,1610.56,2,1,3,6,Regulars
18871,87,10,1561.9799999999998,4,3,3,10,Loyal
18872,327,10,809.33,2,3,1,6,Regulars
18873,441,6,316.38,2,1,1,4,Hibernating
18874,140,15,2441.31,4,5,4,13,Champions
18875,1321,5,231.57999999999998,1,1,1,3,Hibernating
18876,395,11,1393.85,2,3,3,8,Regulars
18877,496,7,3831.5999999999995,1,1,5,7,Regulars
18878,350,9,1338.5,2,2,3,7,Regulars
18879,8,8,684.91,5,2,1,8,Regulars
18880,240,4,167.73000000000002,3,1,1,5,Regulars
18881,202,17,3317.74,3,5,5,13,Big Spenders
18882,152,16,1466.2,3,5,3,11,Regulars
18883,871,6,1247.08,1,1,3,5,Regulars
18884,424,11,2970.58,2,3,5,10,Regulars
18885,90,17,1917.32,4,5,4,13,Champions
18886,1077,8,539.8,1,2,1,4,Hibernating
18887,356,9,2888.3599999999997,2,2,5,9,Regulars
18888,56,7,1356.67,5,1,3,9,Regulars
18889,194,7,1287.48,3,1,3,7,Regulars
18890,561,10,1165.26,1,3,2,6,Regulars
18891,63,13,3399.52,5,4,5,14,Champions
18892,552,8,4175.86,1,2,5,8,Regulars
18893,267,9,1595.33,2,2,3,7,Regulars
18894,45,13,2372.66,5,4,4,13,Champions
18895,5,6,425.39000000000004,5,1,1,7,Regulars
18896,110,12,2369.9900000000002,4,4,4,12,Champions
18897,199,11,1326.58,3,3,3,9,Regulars
18898,192,13,1032.14,3,4,2,9,Regulars
18899,57,11,2128.02,5,3,4,12,Loyal
18900,550,16,3035.1,1,5,5,11,At Risk
18901,42,9,1491.84,5,2,3,10,Regulars
18902,922,11,1231.8600000000001,1,3,2,6,Regulars
18903,577,12,1326.3,1,4,3,8,At Risk
18904,53,11,666.27,5,3,1,9,Loyal
18905,63,11,1413.45,5,3,3,11,Loyal
18906,1040,6,373.63,1,1,1,3,Hibernating
18907,86,16,1947.02,4,5,4,13,Champions
18908,41,8,1780.97,5,2,4,11,Big Spenders
18909,623,10,1045.92,1,3,2,6,Regulars
18910,1,12,2134.39,5,4,4,13,Champions
18911,143,9,1298.07,4,2,3,9,Regulars
18912,212,11,2097.35,3,3,4,10,Big Spenders
18913,41,8,511.41,5,2,1,8,Regulars
18914,157,7,3961.2599999999998,3,1,5,9,Big Spenders
18915,93,18,3232.48,4,5,5,14,Champions
18916,100,10,1217.7,4,3,2,9,Loyal
18917,39,17,977.43,5,5,2,12,Loyal
18918,295,10,1494.5900000000001,2,3,3,8,Regulars
18919,37,18,1568.05,5,5,3,13,Loyal
18920,285,9,1252.04,2,2,3,7,Regulars
18921,524,9,854.48,1,2,2,5,Hibernating
18922,39,9,1307.06,5,2,3,10,Regulars
18923,142,7,1212.13,4,1,2,7,Regulars
18924,82,14,1762.58,4,5,4,13,Champions
18925,383,10,1757.49,2,3,4,9,Regulars
18926,284,9,1193.2,2,2,2,6,Hibernating
18927,56,14,4780.99,5,5,5,15,Champions
18928,546,6,778.4599999999999,1,1,1,3,Hibernating
18929,511,12,1993.09,1,4,4,9,At Risk
18930,378,10,2021.34,2,3,4,9,Regulars
18931,352,8,639.06,2,2,1,5,Hibernating
18932,322,10,1339.99,2,3,3,8,Regulars
18933,248,8,332.78999999999996,2,2,1,5,Hibernating
18934,9,16,3951.7000000000003,5,5,5,15,Champions
18935,248,10,1486.6699999999998,2,3,3,8,Regulars
18936,267,5,1294.9499999999998,2,1,3,6,Regulars
18937,55,10,2319.78,5,3,4,12,Loyal
18938,182,9,738.0699999999999,3,2,1,6,Regulars
18939,84,12,1346.89,4,4,3,11,Loyal
18940,352,6,503.14,2,1,1,4,Hibernating
18941,440,9,608.36,2,2,1,5,Hibernating
18942,69,5,223.5,4,1,1,6,Regulars
18943,250,10,945.51,2,3,2,7,Regulars
18944,444,15,1579.88,2,5,3,10,At Risk
18945,480,12,1037.24,1,4,2,7,At Risk
18946,44,7,2485.46,5,1,4,10,Big Spenders
18947,535,10,1761.0900000000001,1,3,4,8,Regulars
18948,90,12,1922.77,4,4,4,12,Champions
18949,25,10,1316.1599999999999,5,3,3,11,Loyal
18950,651,11,2375.25,1,3,4,8,Regulars
18951,193,20,5565.63,3,5,5,13,Big Spenders
18952,162,14,3116.33,3,5,5,13,Big Spenders
18953,305,15,3377.9800000000005,2,5,5,12,At Risk
18954,288,11,3209.0699999999997,2,3,5,10,Regulars
18955,438,16,2657.25,2,5,5,12,At Risk
18956,387,9,902.5500000000001,2,2,2,6,Hibernating
18957,40,15,1654.27,5,5,3,13,Loyal
18958,622,10,1139.55,1,3,2,6,Regulars
18959,238,11,1368.24,3,3,3,9,Regulars
18960,104,7,909.78,4,1,2,7,Regulars
18961,178,8,3620.24,3,2,5,10,Big Spenders
18962,60,12,1000.58,5,4,2,11,Loyal
18963,378,13,3676.45,2,4,5,11,At Risk
18964,881,9,1548.6,1,2,3,6,Regulars
18965,583,10,748.28,1,3,1,5,Regulars
18966,502,11,1031.34,1,3,2,6,Regulars
18967,57,8,777.06,5,2,1,8,Regulars
18968,81,8,2914.87,4,2,5,11,Big Spenders
18969,99,12,2066.99,4,4,4,12,Champions
18970,29,12,1759.2,5,4,4,13,Champions
18971,546,7,1040.67,1,1,2,4,Hibernating
18972,311,7,2267.0099999999998,2,1,4,7,Regulars
18973,286,11,1453.68,2,3,3,8,Regulars
18974,250,9,1144.63,2,2,2,6,Hibernating
18975,53,14,3538.8599999999997,5,5,5,15,Champions
18976,259,10,1015.42,2,3,2,7,Regulars
18977,729,9,568.83,1,2,1,4,Hibernating
18978,216,11,1413.5,3,3,3,9,Regulars
18979,2,7,839.76,5,1,1,7,Regulars
18980,375,8,1041.45,2,2,2,6,Hibernating
18981,9,14,1865.3600000000001,5,5,4,14,Champions
18982,36,17,4175.83,5,5,5,15,Champions
18983,587,12,1326.1100000000001,1,4,3,8,At Risk
18984,335,8,714.37,2,2,1,5,Hibernating
18985,713,11,2615.83,1,3,5,9,Regulars
18986,150,9,1966.99,3,2,4,9,Big Spenders
18987,33,15,1701.33,5,5,3,13,Loyal
18988,240,10,985.78,3,3,2,8,Regulars
18989,436,5,1747.4099999999999,2,1,4,7,Regulars
18990,123,8,740.37,4,2,1,7,Regulars
18991,533,5,390.70000000000005,1,1,1,3,Hibernating
18992,106,10,875.3199999999999,4,3,2,9,Loyal
18993,153,11,1140.6100000000001,3,3,2,8,Regulars
18994,37,8,671.79,5,2,1,8,Regulars
18995,428,15,1413.17,2,5,3,10,At Risk
18996,74,11,1381.73,4,3,3,10,Loyal
18997,74,13,1701.12,4,4,3,11,Loyal
18998,461,7,575.61,1,1,1,3,Hibernating
18999,79,9,302.8,4,2,1,7,Regulars
19000,220,13,1733.8,3,4,4,11,Big Spenders
19001,116,9,704.45,4,2,1,7,Regulars
19002,154,6,877.6300000000001,3,1,2,6,Regulars
19003,22,15,1790.79,5,5,4,14,Champions
19004,239,8,431.01,3,2,1,6,Regulars
19005,129,12,1131.55,4,4,2,10,Loyal
19006,242,11,1654.95,3,3,3,9,Regulars
19007,503,11,1154.45,1,3,2,6,Regulars
19008,28,10,2535.46,5,3,4,12,Loyal
19009,37,12,3581.27,5,4,5,14,Champions
19010,531,7,563.09,1,1,1,3,Hibernating
19011,131,11,822.57,4,3,1,8,Loyal
19012,591,10,1776.25,1,3,4,8,Regulars
19013,48,15,2338.71,5,5,4,14,Champions
19014,507,10,1540.09,1,3,3,7,Regulars
19015,423,9,2201.36,2,2,4,8,Regulars
19016,780,4,483.71999999999997,1,1,1,3,Hibernating
19017,182,10,1045.9499999999998,3,3,2,8,Regulars
19018,383,8,797.5,2,2,1,5,Hibernating
19019,146,12,3300.1400000000003,4,4,5,13,Champions
19020,138,9,1485.58,4,2,3,9,Regulars
19021,195,14,3176.44,3,5,5,13,Big Spenders
19022,460,10,1590.32,1,3,3,7,Regulars
19023,179,8,2867.2400000000002,3,2,5,10,Big Spenders
19024,503,7,1026.22,1,1,2,4,Hibernating
19025,527,7,408.83,1,1,1,3,Hibernating
19026,490,13,2094.63,1,4,4,9,At Risk
19027,571,11,1438.61,1,3,3,7,Regulars
19028,153,12,5394.05,3,4,5,12,Big Spenders
19029,498,8,1809.07,1,2,4,7,Regulars
19030,303,7,645.01,2,1,1,4,Hibernating
19031,208,17,2249.19,3,5,4,12,Big Spenders
19032,707,7,2413.6099999999997,1,1,4,6,Regulars
19033,650,6,482.71,1,1,1,3,Hibernating
19034,21,8,730.78,5,2,1,8,Regulars
19035,170,7,678.67,3,1,1,5,Regulars
19036,404,9,1519.9,2,2,3,7,Regulars
19037,780,10,1177.1200000000001,1,3,2,6,Regulars
19038,248,8,537.85,2,2,1,5,Hibernating
19039,203,11,5464.58,3,3,5,11,Big Spenders
19040,131,10,944.27,4,3,2,9,Loyal
19041,320,14,2931.3999999999996,2,5,5,12,At Risk
19042,302,20,2319.0299999999997,2,5,4,11,At Risk
19043,40,13,2133.11,5,4,4,13,Champions
19044,84,11,1524.92,4,3,3,10,Loyal
19045,344,18,1267.54,2,5,3,10,At Risk
19046,85,5,579.49,4,1,1,6,Regulars
19047,6,12,1942.34,5,4,4,13,Champions
19048,35,13,3212.3199999999997,5,4,5,14,Champions
19049,816,10,1726.4099999999999,1,3,4,8,Regulars
19050,480,7,3657.54,1,1,5,7,Regulars
19051,72,9,1369.31,4,2,3,9,Regulars
19052,235,16,939.14,3,5,2,10,Regulars
19053,58,11,1658.3899999999999,5,3,3,11,Loyal
19054,103,10,1006.99,4,3,2,9,Loyal
19055,759,10,832.76,1,3,1,5,Regulars
19056,883,4,1173.48,1,1,2,4,Hibernating
19057,286,10,979.48,2,3,2,7,Regulars
19058,45,22,2310.67,5,5,4,14,Champions
19059,129,8,711.53,4,2,1,7,Regulars
19060,339,8,2267.76,2,2,4,8,Regulars
19061,23,12,1865.5700000000002,5,4,4,13,Champions
19062,826,3,192.01,1,1,1,3,Hibernating
19063,1071,6,606.4300000000001,1,1,1,3,Hibernating
19064,250,12,732.2,2,4,1,7,At Risk
19065,6,11,785.49,5,3,1,9,Loyal
19066,119,9,2049.26,4,2,4,10,Big Spenders
19067,95,8,2821.47,4,2,5,11,Big Spenders
19068,531,10,2055.9,1,3,4,8,Regulars
19069,183,19,5552.67,3,5,5,13,Big Spenders
19070,643,9,1019.13,1,2,2,5,Hibernating
19071,410,11,1555.97,2,3,3,8,Regulars
19072,636,9,1291.27,1,2,3,6,Regulars
19073,453,9,773.51,2,2,1,5,Hibernating
19074,60,9,2565.83,5,2,4,11,Big Spenders
19075,531,13,4508.89,1,4,5,10,At Risk
19076,161,11,1293.47,3,3,3,9,Regulars
19077,392,11,1531.8799999999999,2,3,3,8,Regulars
19078,1084,8,1540.2199999999998,1,2,3,6,Regulars
19079,106,9,648.5,4,2,1,7,Regulars
19080,82,16,2584.81,4,5,5,14,Champions
19081,224,12,2375.43,3,4,4,11,Big Spenders
19082,6,12,2546.55,5,4,4,13,Champions
19083,472,13,1857.58,1,4,4,9,At Risk
19084,613,7,2097.59,1,1,4,6,Regulars
19085,714,9,432.15999999999997,1,2,1,4,Hibernating
19086,273,10,2831.65,2,3,5,10,Regulars
19087,266,10,853.51,2,3,2,7,Regulars
19088,45,11,1791.12,5,3,4,12,Loyal
19089,641,10,1504.1599999999999,1,3,3,7,Regulars
19090,69,17,3052.6800000000003,4,5,5,14,Champions
19091,404,10,1703.68,2,3,3,8,Regulars
19092,203,5,214.54,3,1,1,5,Regulars
19093,1536,5,858.15,1,1,2,4,Hibernating
19094,154,6,874.79,3,1,2,6,Regulars
19095,261,5,568.37,2,1,1,4,Hibernating
19096,386,11,1113.99,2,3,2,7,Regulars
19097,239,4,190.64,3,1,1,5,Regulars
19098,248,14,1794.4099999999999,2,5,4,11,At Risk
19099,50,7,1917.4399999999998,5,1,4,10,Big Spenders
19100,276,13,2075.33,2,4,4,10,At Risk
19101,375,8,1237.4,2,2,2,6,Hibernating
19102,209,9,2513.41,3,2,4,9,Big Spenders
19103,950,5,1022.3700000000001,1,1,2,4,Hibernating
19104,428,14,690.1,2,5,1,8,At Risk
19105,619,10,740.7099999999999,1,3,1,5,Regulars
19106,174,8,1524.6299999999999,3,2,3,8,Regulars
19107,0,15,2810.92,5,5,5,15,Champions
19108,127,9,1162.69,4,2,2,8,Regulars
19109,175,17,2789.5299999999997,3,5,5,13,Big Spenders
19110,797,5,630.4100000000001,1,1,1,3,Hibernating
19111,305,9,853.9300000000001,2,2,2,6,Hibernating
19112,14,11,4496.22,5,3,5,13,Loyal
19113,32,10,519.18,5,3,1,9,Loyal
19114,364,15,1456.79,2,5,3,10,At Risk
19115,153,16,1496.54,3,5,3,11,Regulars
19116,393,9,1474.4399999999998,2,2,3,7,Regulars
19117,93,9,2245.58,4,2,4,10,Big Spenders
19118,67,6,2767.18,4,1,5,10,Big Spenders
19119,405,7,2563.8,2,1,4,7,Regulars
19120,755,10,638.82,1,3,1,5,Regulars
19121,488,8,1552.45,1,2,3,6,Regulars
19122,419,11,2949.48,2,3,5,10,Regulars
19123,195,7,1930.91,3,1,4,8,Big Spenders
19124,167,8,1572.07,3,2,3,8,Regulars
19125,614,7,886.06,1,1,2,4,Hibernating
19126,60,11,1496.8000000000002,5,3,3,11,Loyal
19127,211,10,3770.5200000000004,3,3,5,11,Big Spenders
19128,238,12,1048.71,3,4,2,9,Regulars
19129,88,15,1437.1399999999999,4,5,3,12,Loyal
19130,450,6,712.5699999999999,2,1,1,4,Hibernating
19131,95,9,1065.68,4,2,2,8,Regulars
19132,1029,7,585.52,1,1,1,3,Hibernating
19133,108,5,658.9,4,1,1,6,Regulars
19134,113,11,2781.4399999999996,4,3,5,12,Loyal
19135,154,13,1576.69,3,4,3,10,Regulars
19136,26,8,651.73,5,2,1,8,Regulars
19137,10,7,428.51,5,1,1,7,Regulars
19138,355,7,449.41,2,1,1,4,Hibernating
19139,172,13,2543.19,3,4,4,11,Big Spenders
19140,71,9,1398.83,4,2,3,9,Regulars
19141,386,11,841.2,2,3,1,6,Regulars
19142,626,6,714.58,1,1,1,3,Hibernating
19143,218,14,1283.51,3,5,3,11,Regulars
19144,222,7,931.49,3,1,2,6,Regulars
19145,129,8,558.36,4,2,1,7,Regulars
19146,308,12,1156.06,2,4,2,8,At Risk
19147,284,6,1175.9099999999999,2,1,2,5,Hibernating
19148,183,14,2414.36,3,5,4,12,Big Spenders
19149,107,11,4153.3,4,3,5,12,Loyal
19150,293,12,900.6,2,4,2,8,At Risk
19151,924,6,1233.5900000000001,1,1,2,4,Hibernating
19152,274,14,3060.79,2,5,5,12,At Risk
19153,92,11,700.63,4,3,1,8,Loyal
19154,212,12,1190.02,3,4,2,9,Regulars
19155,107,8,1258.96,4,2,3,9,Regulars
19156,885,6,310.5,1,1,1,3,Hibernating
19157,117,14,2668.96,4,5,5,14,Champions
19158,157,6,2485.39,3,1,4,8,Big Spenders
19159,197,10,844.66,3,3,1,7,Regulars
19160,207,9,1692.79,3,2,3,8,Regulars
19161,296,10,1005.02,2,3,2,7,Regulars
19162,460,9,1018.5500000000001,1,2,2,5,Hibernating
19163,164,9,960.51,3,2,2,7,Regulars
19164,66,10,3792.0699999999997,4,3,5,12,Loyal
19165,84,9,1438.5900000000001,4,2,3,9,Regulars
19166,148,9,2216.62,3,2,4,9,Big Spenders
19167,1020,9,3302.81,1,2,5,8,Regulars
19168,114,12,2415.05,4,4,4,12,Champions
19169,868,8,1535.91,1,2,3,6,Regulars
19170,104,13,3661.3799999999997,4,4,5,13,Champions
19171,104,6,616.64,4,1,1,6,Regulars
19172,145,10,1481.46,4,3,3,10,Loyal
19173,229,14,4208.9800000000005,3,5,5,13,Big Spenders
19174,112,15,1045.56,4,5,2,11,Loyal
19175,441,11,1570.3899999999999,2,3,3,8,Regulars
19176,408,9,643.45,2,2,1,5,Hibernating
19177,378,14,1804.3799999999999,2,5,4,11,At Risk
19178,478,10,1115.75,1,3,2,6,Regulars
19179,22,13,1274.31,5,4,3,12,Loyal
19180,85,10,2723.12,4,3,5,12,Loyal
19181,21,9,826.5899999999999,5,2,1,8,Regulars
19182,132,8,600.41,4,2,1,7,Regulars
19183,198,10,3328.0099999999998,3,3,5,11,Big Spenders
19184,881,6,427.56,1,1,1,3,Hibernating
19185,104,15,3174.3,4,5,5,14,Champions
19186,224,9,1235.32,3,2,2,7,Regulars
19187,17,11,1269.65,5,3,3,11,Loyal
19188,515,13,1069.94,1,4,2,7,At Risk
19189,312,11,1430.97,2,3,3,8,Regulars
19190,195,9,1367.1000000000001,3,2,3,8,Regulars
19191,64,5,538.8399999999999,5,1,1,7,Regulars
19192,6,9,3744.26,5,2,5,12,Big Spenders
19193,147,15,1534.02,4,5,3,12,Loyal
19194,556,5,1104.15,1,1,2,4,Hibernating
19195,307,6,626.36,2,1,1,4,Hibernating
19196,131,14,2332.24,4,5,4,13,Champions
19197,31,15,3307.64,5,5,5,15,Champions
19198,302,8,2478.86,2,2,4,8,Regulars
19199,75,20,2778.02,4,5,5,14,Champions
19200,3,9,1100.9099999999999,5,2,2,9,Regulars
19201,78,9,1136.91,4,2,2,8,Regulars
19202,118,9,2430.52,4,2,4,10,Big Spenders
19203,129,13,1661.47,4,4,3,11,Loyal
19204,52,11,1100.14,5,3,2,10,Loyal
19205,67,11,1410.5,4,3,3,10,Loyal
19206,403,11,1035.8400000000001,2,3,2,7,Regulars
19207,55,15,1944.24,5,5,4,14,Champions
19208,1213,6,496.33,1,1,1,3,Hibernating
19209,52,13,2390.7,5,4,4,13,Champions
19210,681,8,1001.9200000000001,1,2,2,5,Hibernating
19211,87,10,2444.77,4,3,4,11,Loyal
19212,554,6,608.63,1,1,1,3,Hibernating
19213,1297,3,582.11,1,1,1,3,Hibernating
19214,560,9,781.87,1,2,1,4,Hibernating
19215,227,19,2400.71,3,5,4,12,Big Spenders
19216,145,11,1490.1200000000001,4,3,3,10,Loyal
19217,504,10,1315.62,1,3,3,7,Regulars
19218,321,13,1525.44,2,4,3,9,At Risk
19219,828,8,1073.81,1,2,2,5,Hibernating
19220,108,7,827.0,4,1,1,6,Regulars
19221,519,11,1114.65,1,3,2,6,Regulars
19222,231,13,1412.16,3,4,3,10,Regulars
19223,25,9,2002.1100000000001,5,2,4,11,Big Spenders
19224,1298,14,3385.55,1,5,5,11,At Risk
19225,145,11,1290.08,4,3,3,10,Loyal
19226,67,10,1408.72,4,3,3,10,Loyal
19227,356,12,3071.5499999999997,2,4,5,11,At Risk
19228,701,10,4935.77,1,3,5,9,Regulars
19229,242,7,1739.2800000000002,3,1,4,8,Big Spenders
19230,493,7,3020.14,1,1,5,7,Regulars
19231,107,15,2330.02,4,5,4,13,Champions
19232,53,16,4775.97,5,5,5,15,Champions
19233,294,9,1231.3899999999999,2,2,2,6,Hibernating
19234,48,13,1240.1200000000001,5,4,2,11,Loyal
19235,81,9,1540.21,4,2,3,9,Regulars
19236,251,8,601.85,2,2,1,5,Hibernating
19237,186,6,406.15,3,1,1,5,Regulars
19238,155,11,2413.6000000000004,3,3,4,10,Big Spenders
19239,91,10,1034.75,4,3,2,9,Loyal
19240,198,9,1831.49,3,2,4,9,Big Spenders
19241,48,17,3790.24,5,5,5,15,Champions
19242,193,11,1224.04,3,3,2,8,Regulars
19243,329,8,749.85,2,2,1,5,Hibernating
19244,263,11,888.07,2,3,2,7,Regulars
19245,77,16,2757.5099999999998,4,5,5,14,Champions
19246,408,6,1371.34,2,1,3,6,Regulars
19247,180,12,1342.15,3,4,3,10,Regulars
19248,154,11,2876.47,3,3,5,11,Big Spenders
19249,274,9,2244.91,2,2,4,8,Regulars
19250,118,19,3601.89,4,5,5,14,Champions
19251,97,16,793.85,4,5,1,10,Loyal
19252,398,6,2953.87,2,1,5,8,Regulars
19253,54,13,4976.650000000001,5,4,5,14,Champions
19254,736,7,696.0,1,1,1,3,Hibernating
19255,335,9,852.17,2,2,2,6,Hibernating
19256,56,11,1147.5,5,3,2,10,Loyal
19257,44,15,2343.4,5,5,4,14,Champions
19258,515,6,1221.73,1,1,2,4,Hibernating
19259,28,10,987.8299999999999,5,3,2,10,Loyal
19260,441,8,1216.99,2,2,2,6,Hibernating
19261,143,9,2481.97,4,2,4,10,Big Spenders
19262,47,16,3702.2,5,5,5,15,Champions
19263,527,9,809.28,1,2,1,4,Hibernating
19264,87,13,2047.4,4,4,4,12,Champions
19265,214,8,708.81,3,2,1,6,Regulars
19266,170,7,2766.2999999999997,3,1,5,9,Big Spenders
19267,231,12,1942.6399999999999,3,4,4,11,Big Spenders
19268,226,14,1888.3899999999999,3,5,4,12,Big Spenders
19269,122,3,163.5,4,1,1,6,Regulars
19270,720,9,2062.29,1,2,4,7,Regulars
19271,105,8,929.0300000000001,4,2,2,8,Regulars
19272,90,7,518.04,4,1,1,6,Regulars
19273,518,8,2400.91,1,2,4,7,Regulars
19274,539,9,794.5799999999999,1,2,1,4,Hibernating
19275,674,12,3446.8199999999997,1,4,5,10,At Risk
19276,28,10,2216.15,5,3,4,12,Loyal
19277,435,10,1942.83,2,3,4,9,Regulars
19278,573,12,1584.54,1,4,3,8,At Risk
19279,166,8,1386.54,3,2,3,8,Regulars
19280,449,9,2039.8899999999999,2,2,4,8,Regulars
19281,505,11,1912.54,1,3,4,8,Regulars
19282,31,9,2062.25,5,2,4,11,Big Spenders
19283,853,8,3355.09,1,2,5,8,Regulars
19284,33,12,1520.74,5,4,3,12,Loyal
19285,252,9,694.33,2,2,1,5,Hibernating
19286,241,16,3065.72,3,5,5,13,Big Spenders
19287,631,9,1707.47,1,2,3,6,Regulars
19288,161,11,2566.4700000000003,3,3,4,10,Big Spenders
19289,629,8,1185.0,1,2,2,5,Hibernating
19290,448,8,627.9,2,2,1,5,Hibernating
19291,337,11,1634.2700000000002,2,3,3,8,Regulars
19292,374,13,819.78,2,4,1,7,At Risk
19293,635,9,590.54,1,2,1,4,Hibernating
19294,760,4,731.9100000000001,1,1,1,3,Hibernating
19295,977,7,558.97,1,1,1,3,Hibernating
19296,551,10,1103.63,1,3,2,6,Regulars
19297,620,10,2896.66,1,3,5,9,Regulars
19298,22,16,1403.58,5,5,3,13,Loyal
19299,441,9,1787.23,2,2,4,8,Regulars
19300,172,11,3644.43,3,3,5,11,Big Spenders
19301,530,16,2792.62,1,5,5,11,At Risk
19302,97,10,993.69,4,3,2,9,Loyal
19303,21,13,2518.09,5,4,4,13,Champions
19304,121,12,5510.280000000001,4,4,5,13,Champions
19305,412,12,1158.25,2,4,2,8,At Risk
19306,38,12,1317.72,5,4,3,12,Loyal
19307,181,10,1400.44,3,3,3,9,Regulars
19308,21,9,1210.1100000000001,5,2,2,9,Regulars
19309,500,6,1371.03,1,1,3,5,Regulars
19310,128,9,1072.21,4,2,2,8,Regulars
19311,44,7,337.07,5,1,1,7,Regulars
19312,422,14,2878.61,2,5,5,12,At Risk
19313,175,10,3945.47,3,3,5,11,Big Spenders
19314,889,8,509.26,1,2,1,4,Hibernating
19315,573,5,1036.48,1,1,2,4,Hibernating
19316,245,16,1955.93,3,5,4,12,Big Spenders
19317,964,6,1114.72,1,1,2,4,Hibernating
19318,193,14,5884.23,3,5,5,13,Big Spenders
19319,116,12,772.36,4,4,1,9,Loyal
19320,596,7,2676.5200000000004,1,1,5,7,Regulars
19321,142,10,410.33,4,3,1,8,Loyal
19322,591,14,1489.39,1,5,3,9,At Risk
19323,622,9,787.05,1,2,1,4,Hibernating
19324,135,15,2264.27,4,5,4,13,Champions
19325,963,17,1829.92,1,5,4,10,At Risk
19326,651,9,1585.43,1,2,3,6,Regulars
19327,18,9,1214.3899999999999,5,2,2,9,Regulars
19328,376,6,407.49,2,1,1,4,Hibernating
19329,262,12,2853.85,2,4,5,11,At Risk
19330,278,6,356.36,2,1,1,4,Hibernating
19331,425,9,1064.1100000000001,2,2,2,6,Hibernating
19332,193,8,2657.14,3,2,5,10,Big Spenders
19333,174,13,2212.24,3,4,4,11,Big Spenders
19334,438,8,926.51,2,2,2,6,Hibernating
19335,172,16,2591.44,3,5,5,13,Big Spenders
19336,260,8,1045.9900000000002,2,2,2,6,Hibernating
19337,428,6,479.65,2,1,1,4,Hibernating
19338,11,14,4987.82,5,5,5,15,Champions
19339,253,12,2151.2599999999998,2,4,4,10,At Risk
19340,237,11,2025.3200000000002,3,3,4,10,Big Spenders
19341,457,9,1313.27,2,2,3,7,Regulars
19342,138,5,401.53999999999996,4,1,1,6,Regulars
19343,303,8,2472.7400000000002,2,2,4,8,Regulars
19344,218,11,743.38,3,3,1,7,Regulars
19345,546,6,3666.88,1,1,5,7,Regulars
19346,288,14,1882.65,2,5,4,11,At Risk
19347,542,12,1864.27,1,4,4,9,At Risk
19348,110,14,2731.4599999999996,4,5,5,14,Champions
19349,183,13,1707.51,3,4,3,10,Regulars
19350,534,9,3687.2400000000002,1,2,5,8,Regulars
19351,468,8,553.54,1,2,1,4,Hibernating
19352,666,10,3486.5599999999995,1,3,5,9,Regulars
19353,52,9,1181.87,5,2,2,9,Regulars
19354,686,8,979.14,1,2,2,5,Hibernating
19355,37,10,1093.8799999999999,5,3,2,10,Loyal
19356,2,9,2354.51,5,2,4,11,Big Spenders
19357,67,10,2027.8,4,3,4,11,Loyal
19358,426,15,2184.12,2,5,4,11,At Risk
19359,46,11,1186.69,5,3,2,10,Loyal
19360,48,9,1066.85,5,2,2,9,Regulars
19361,412,13,3784.0599999999995,2,4,5,11,At Risk
19362,471,11,1785.78,1,3,4,8,Regulars
19363,101,9,2275.39,4,2,4,10,Big Spenders
19364,544,5,452.74,1,1,1,3,Hibernating
19365,364,11,510.09000000000003,2,3,1,6,Regulars
19366,49,15,1260.47,5,5,3,13,Loyal
19367,93,8,640.15,4,2,1,7,Regulars
19368,692,7,424.09999999999997,1,1,1,3,Hibernating
19369,553,7,1528.42,1,1,3,5,Regulars
19370,47,7,790.17,5,1,1,7,Regulars
19371,116,14,1339.8,4,5,3,12,Loyal
19372,253,9,4382.72,2,2,5,9,Regulars
19373,78,6,2611.2400000000002,4,1,5,10,Big Spenders
19374,243,11,628.53,3,3,1,7,Regulars
19375,295,9,1575.44,2,2,3,7,Regulars
19376,382,9,3709.35,2,2,5,9,Regulars
19377,280,12,954.65,2,4,2,8,At Risk
19378,49,15,1799.04,5,5,4,14,Champions
19379,684,9,1134.33,1,2,2,5,Hibernating
19380,293,9,1364.16,2,2,3,7,Regulars
19381,1128,10,1556.6000000000001,1,3,3,7,Regulars
19382,75,9,3897.4900000000002,4,2,5,11,Big Spenders
19383,497,10,1097.6100000000001,1,3,2,6,Regulars
19384,256,10,6722.43,2,3,5,10,Regulars
19385,8,7,2004.15,5,1,4,10,Big Spenders
19386,155,10,798.3299999999999,3,3,1,7,Regulars
19387,87,7,1503.26,4,1,3,8,Regulars
19388,907,6,355.48,1,1,1,3,Hibernating
19389,266,11,3633.2599999999998,2,3,5,10,Regulars
19390,571,8,1112.3600000000001,1,2,2,5,Hibernating
19391,497,9,1443.37,1,2,3,6,Regulars
19392,197,8,1750.81,3,2,4,9,Big Spenders
19393,180,12,3214.0,3,4,5,12,Big Spenders
19394,149,8,915.08,3,2,2,7,Regulars
19395,656,8,981.79,1,2,2,5,Hibernating
19396,6,17,1644.98,5,5,3,13,Loyal
19397,80,5,372.21,4,1,1,6,Regulars
19398,275,7,1223.54,2,1,2,5,Hibernating
19399,137,18,1831.22,4,5,4,13,Champions
19400,313,8,417.5,2,2,1,5,Hibernating
19401,184,11,1092.3899999999999,3,3,2,8,Regulars
19402,89,11,1089.47,4,3,2,9,Loyal
19403,175,6,3251.71,3,1,5,9,Big Spenders
19404,327,8,621.05,2,2,1,5,Hibernating
19405,420,8,3174.48,2,2,5,9,Regulars
19406,30,12,3549.88,5,4,5,14,Champions
19407,8,13,6208.879999999999,5,4,5,14,Champions
19408,15,14,2401.01,5,5,4,14,Champions
19409,664,8,1452.96,1,2,3,6,Regulars
19410,300,12,1399.29,2,4,3,9,At Risk
19411,875,13,2950.27,1,4,5,10,At Risk
19412,857,9,844.39,1,2,1,4,Hibernating
19413,26,10,3549.9,5,3,5,13,Loyal
19414,136,9,839.99,4,2,1,7,Regulars
19415,965,8,834.6800000000001,1,2,1,4,Hibernating
19416,400,10,2367.81,2,3,4,9,Regulars
19417,78,8,837.41,4,2,1,7,Regulars
19418,180,17,2420.9700000000003,3,5,4,12,Big Spenders
19419,123,14,1536.74,4,5,3,12,Loyal
19420,202,4,1120.06,3,1,2,6,Regulars
19421,950,3,607.24,1,1,1,3,Hibernating
19422,194,14,858.3199999999999,3,5,2,10,Regulars
19423,358,11,3320.79,2,3,5,10,Regulars
19424,796,9,2329.66,1,2,4,7,Regulars
19425,322,9,1767.63,2,2,4,8,Regulars
19426,599,10,1259.1,1,3,3,7,Regulars
19427,32,13,1980.3899999999999,5,4,4,13,Champions
19428,177,8,1508.8,3,2,3,8,Regulars
19429,312,13,3646.7000000000003,2,4,5,11,At Risk
19430,283,10,1081.89,2,3,2,7,Regulars
19431,129,13,3291.9700000000003,4,4,5,13,Champions
19432,10,19,2028.69,5,5,4,14,Champions
19433,187,10,1628.79,3,3,3,9,Regulars
19434,851,8,1092.33,1,2,2,5,Hibernating
19435,35,8,932.22,5,2,2,9,Regulars
19436,480,13,2461.21,1,4,4,9,At Risk
19437,0,17,4029.59,5,5,5,15,Champions
19438,754,6,527.64,1,1,1,3,Hibernating
19439,176,9,1584.88,3,2,3,8,Regulars
19440,166,12,1499.35,3,4,3,10,Regulars
19441,76,18,1723.71,4,5,3,12,Loyal
19442,27,15,2530.79,5,5,4,14,Champions
19443,271,8,1161.6299999999999,2,2,2,6,Hibernating
19444,135,10,2225.7799999999997,4,3,4,11,Loyal
19445,220,13,787.11,3,4,1,8,Regulars
19446,229,8,640.38,3,2,1,6,Regulars
19447,94,15,2264.91,4,5,4,13,Champions
19448,391,13,1945.18,2,4,4,10,At Risk
19449,513,9,1031.91,1,2,2,5,Hibernating
19450,248,12,1569.45,2,4,3,9,At Risk
19451,391,8,1334.47,2,2,3,7,Regulars
19452,925,9,1846.9499999999998,1,2,4,7,Regulars
19453,570,11,2806.9700000000003,1,3,5,9,Regulars
19454,187,12,779.25,3,4,1,8,Regulars
19455,605,8,938.28,1,2,2,5,Hibernating
19456,143,9,1288.84,4,2,3,9,Regulars
19457,805,5,260.68,1,1,1,3,Hibernating
19458,370,7,1167.41,2,1,2,5,Hibernating
19459,386,9,2602.99,2,2,5,9,Regulars
19460,128,9,1199.98,4,2,2,8,Regulars
19461,34,9,1271.21,5,2,3,10,Regulars
19462,28,12,968.0,5,4,2,11,Loyal
19463,110,14,2221.73,4,5,4,13,Champions
19464,41,17,3683.44,5,5,5,15,Champions
19465,511,7,308.85,1,1,1,3,Hibernating
19466,34,10,831.4300000000001,5,3,1,9,Loyal
19467,120,6,2034.6599999999999,4,1,4,9,Big Spenders
19468,249,15,1618.8000000000002,2,5,3,10,At Risk
19469,142,10,1594.3700000000001,4,3,3,10,Loyal
19470,30,10,1034.78,5,3,2,10,Loyal
19471,708,9,820.36,1,2,1,4,Hibernating
19472,956,7,1063.62,1,1,2,4,Hibernating
19473,587,9,2142.99,1,2,4,7,Regulars
19474,177,3,161.9,3,1,1,5,Regulars
19475,19,15,6612.44,5,5,5,15,Champions
19476,28,16,1483.33,5,5,3,13,Loyal
19477,708,10,1106.3899999999999,1,3,2,6,Regulars
19478,306,9,3279.76,2,2,5,9,Regulars
19479,43,10,1566.71,5,3,3,11,Loyal
19480,369,8,1523.75,2,2,3,7,Regulars
19481,578,5,259.85,1,1,1,3,Hibernating
19482,75,10,1164.15,4,3,2,9,Loyal
19483,96,12,1459.43,4,4,3,11,Loyal
19484,88,11,779.68,4,3,1,8,Loyal
19485,243,3,867.1600000000001,3,1,2,6,Regulars
19486,341,12,2534.24,2,4,4,10,At Risk
19487,27,7,1113.18,5,1,2,8,Regulars
19488,983,10,3399.9700000000003,1,3,5,9,Regulars
19489,99,10,1100.71,4,3,2,9,Loyal
19490,206,13,1703.5900000000001,3,4,3,10,Regulars
19491,65,8,2163.37,5,2,4,11,Big Spenders
19492,160,12,1070.84,3,4,2,9,Regulars
19493,165,13,2775.43,3,4,5,12,Big Spenders
19494,45,8,1341.43,5,2,3,10,Regulars
19495,0,14,3098.5,5,5,5,15,Champions
19496,213,7,1109.36,3,1,2,6,Regulars
19497,125,10,2134.5,4,3,4,11,Loyal
19498,30,13,5300.41,5,4,5,14,Champions
19499,191,12,2503.12,3,4,4,11,Big Spenders
19500,315,15,1916.14,2,5,4,11,At Risk
19501,7,11,2041.76,5,3,4,12,Loyal
19502,243,10,635.01,3,3,1,7,Regulars
19503,25,18,4412.49,5,5,5,15,Champions
19504,435,8,1213.44,2,2,2,6,Hibernating
19505,1041,12,1223.46,1,4,2,7,At Risk
19506,497,14,5406.16,1,5,5,11,At Risk
19507,129,5,1762.8899999999999,4,1,4,9,Big Spenders
19508,348,9,1225.33,2,2,2,6,Hibernating
19509,255,12,1175.42,2,4,2,8,At Risk
19510,147,9,969.6399999999999,4,2,2,8,Regulars
19511,721,10,2833.1,1,3,5,9,Regulars
19512,7,9,3570.44,5,2,5,12,Big Spenders
19513,106,15,2567.34,4,5,4,13,Champions
19514,427,10,1417.32,2,3,3,8,Regulars
19515,323,16,4727.11,2,5,5,12,At Risk
19516,256,11,3279.23,2,3,5,10,Regulars
19517,5,11,6347.349999999999,5,3,5,13,Loyal
19518,152,10,1715.42,3,3,3,9,Regulars
19519,272,9,1819.83,2,2,4,8,Regulars
19520,558,9,2350.57,1,2,4,7,Regulars
19521,214,11,1131.67,3,3,2,8,Regulars
19522,21,8,738.0,5,2,1,8,Regulars
19523,561,12,1452.5,1,4,3,8,At Risk
19524,71,11,1130.52,4,3,2,9,Loyal
19525,180,13,2565.96,3,4,4,11,Big Spenders
19526,12,14,2458.1000000000004,5,5,4,14,Champions
19527,272,8,1356.72,2,2,3,7,Regulars
19528,427,15,2863.51,2,5,5,12,At Risk
19529,31,12,1005.6700000000001,5,4,2,11,Loyal
19530,539,7,680.67,1,1,1,3,Hibernating
19531,106,11,2973.86,4,3,5,12,Loyal
19532,70,6,533.56,4,1,1,6,Regulars
19533,940,5,964.79,1,1,2,4,Hibernating
19534,27,11,997.0799999999999,5,3,2,10,Loyal
19535,114,12,2164.5899999999997,4,4,4,12,Champions
19536,66,12,1598.38,4,4,3,11,Loyal
19537,45,9,1321.67,5,2,3,10,Regulars
19538,186,10,895.0600000000001,3,3,2,8,Regulars
19539,34,7,1523.1999999999998,5,1,3,9,Regulars
19540,34,5,303.05,5,1,1,7,Regulars
19541,6,7,533.8199999999999,5,1,1,7,Regulars
19542,133,7,1265.56,4,1,3,8,Regulars
19543,70,16,2066.46,4,5,4,13,Champions
19544,1144,4,909.6400000000001,1,1,2,4,Hibernating
19545,1500,7,832.7,1,1,1,3,Hibernating
19546,155,6,2718.54,3,1,5,9,Big Spenders
19547,179,9,1802.7700000000002,3,2,4,9,Big Spenders
19548,72,11,1180.73,4,3,2,9,Loyal
19549,38,12,2731.54,5,4,5,14,Champions
19550,726,6,542.44,1,1,1,3,Hibernating
19551,93,10,2176.96,4,3,4,11,Loyal
19552,818,13,2114.06,1,4,4,9,At Risk
19553,3,7,1000.69,5,1,2,8,Regulars
19554,229,9,2212.5,3,2,4,9,Big Spenders
19555,484,6,789.04,1,1,1,3,Hibernating
19556,199,10,558.5,3,3,1,7,Regulars
19557,380,11,3669.85,2,3,5,10,Regulars
19558,117,19,7285.14,4,5,5,14,Champions
19559,279,8,648.39,2,2,1,5,Hibernating
19560,77,10,638.59,4,3,1,8,Loyal
19561,1,12,1314.3300000000002,5,4,3,12,Loyal
19562,380,5,685.92,2,1,1,4,Hibernating
19563,69,9,1545.18,4,2,3,9,Regulars
19564,266,15,3340.21,2,5,5,12,At Risk
19565,147,16,4967.37,4,5,5,14,Champions
19566,312,11,916.48,2,3,2,7,Regulars
19567,163,7,868.05,3,1,2,6,Regulars
19568,63,6,485.39,5,1,1,7,Regulars
19569,107,9,1044.01,4,2,2,8,Regulars
19570,1172,4,281.25,1,1,1,3,Hibernating
19571,76,12,4494.72,4,4,5,13,Champions
19572,45,11,2665.3,5,3,5,13,Loyal
19573,210,12,1632.59,3,4,3,10,Regulars
19574,499,13,3269.8199999999997,1,4,5,10,At Risk
19575,164,5,539.58,3,1,1,5,Regulars
19576,680,11,3447.6,1,3,5,9,Regulars
19577,204,9,1547.2,3,2,3,8,Regulars
19578,419,10,997.96,2,3,2,7,Regulars
19579,7,11,2407.6,5,3,4,12,Loyal
19580,24,11,2087.4,5,3,4,12,Loyal
19581,321,5,758.8100000000001,2,1,1,4,Hibernating
19582,44,8,2173.69,5,2,4,11,Big Spenders
19583,416,8,859.3399999999999,2,2,2,6,Hibernating
19584,63,5,304.82,5,1,1,7,Regulars
19585,21,16,3460.4,5,5,5,15,Champions
19586,145,12,1177.08,4,4,2,10,Loyal
19587,14,6,617.42,5,1,1,7,Regulars
19588,1110,6,386.61,1,1,1,3,Hibernating
19589,164,10,1668.9499999999998,3,3,3,9,Regulars
19590,210,10,1154.6100000000001,3,3,2,8,Regulars
19591,408,10,929.98,2,3,2,7,Regulars
19592,684,7,2914.9800000000005,1,1,5,7,Regulars
19593,625,10,781.3199999999999,1,3,1,5,Regulars
19594,188,7,618.04,3,1,1,5,Regulars
19595,88,9,2452.04,4,2,4,10,Big Spenders
19596,93,12,2159.15,4,4,4,12,Champions
19597,230,9,988.3,3,2,2,7,Regulars
19598,105,15,1418.6499999999999,4,5,3,12,Loyal
19599,116,10,1080.46,4,3,2,9,Loyal
19600,0,9,789.07,5,2,1,8,Regulars
19601,207,6,1113.64,3,1,2,6,Regulars
19602,176,11,769.4,3,3,1,7,Regulars
19603,74,7,1010.51,4,1,2,7,Regulars
19604,1241,13,1729.01,1,4,4,9,At Risk
19605,131,7,969.19,4,1,2,7,Regulars
19606,171,9,999.15,3,2,2,7,Regulars
19607,308,12,2065.0699999999997,2,4,4,10,At Risk
19608,20,13,1373.66,5,4,3,12,Loyal
19609,162,10,4321.07,3,3,5,11,Big Spenders
19610,2,9,904.24,5,2,2,9,Regulars
19611,45,16,2931.7,5,5,5,15,Champions
19612,165,5,567.24,3,1,1,5,Regulars
19613,238,9,1184.86,3,2,2,7,Regulars
19614,223,6,826.25,3,1,1,5,Regulars
19615,22,10,2088.24,5,3,4,12,Loyal
19616,561,11,3414.29,1,3,5,9,Regulars
19617,48,13,2250.21,5,4,4,13,Champions
19618,234,5,631.29,3,1,1,5,Regulars
19619,760,3,86.86,1,1,1,3,Hibernating
19620,648,10,1483.61,1,3,3,7,Regulars
19621,277,13,853.2,2,4,2,8,At Risk
19622,266,5,235.74,2,1,1,4,Hibernating
19623,612,6,523.35,1,1,1,3,Hibernating
19624,297,12,4373.89,2,4,5,11,At Risk
19625,166,8,1409.89,3,2,3,8,Regulars
19626,787,6,943.02,1,1,2,4,Hibernating
19627,74,15,1969.97,4,5,4,13,Champions
19628,747,7,1140.32,1,1,2,4,Hibernating
19629,125,8,695.6800000000001,4,2,1,7,Regulars
19630,16,15,4894.17,5,5,5,15,Champions
19631,36,10,2454.9700000000003,5,3,4,12,Loyal
19632,391,21,2915.7400000000002,2,5,5,12,At Risk
19633,70,11,3729.35,4,3,5,12,Loyal
19634,429,9,973.0699999999999,2,2,2,6,Hibernating
19635,66,17,1478.23,4,5,3,12,Loyal
19636,85,11,4078.14,4,3,5,12,Loyal
19637,727,9,612.88,1,2,1,4,Hibernating
19638,33,13,2952.05,5,4,5,14,Champions
19639,165,10,1562.51,3,3,3,9,Regulars
19640,635,12,869.55,1,4,2,7,At Risk
19641,294,10,1221.5700000000002,2,3,2,7,Regulars
19642,777,8,1790.21,1,2,4,7,Regulars
19643,221,11,678.66,3,3,1,7,Regulars
19644,160,10,2928.68,3,3,5,11,Big Spenders
19645,124,14,1030.28,4,5,2,11,Loyal
19646,120,12,985.58,4,4,2,10,Loyal
19647,42,7,434.12,5,1,1,7,Regulars
19648,1294,3,337.98,1,1,1,3,Hibernating
19649,120,13,1427.74,4,4,3,11,Loyal
19650,51,7,1920.3999999999999,5,1,4,10,Big Spenders
19651,467,8,509.1,1,2,1,4,Hibernating
19652,415,14,2978.11,2,5,5,12,At Risk
19653,183,16,1266.55,3,5,3,11,Regulars
19654,447,14,1753.09,2,5,4,11,At Risk
19655,56,16,1748.64,5,5,4,14,Champions
19656,81,10,1161.94,4,3,2,9,Loyal
19657,215,16,1409.36,3,5,3,11,Regulars
19658,29,15,6884.75,5,5,5,15,Champions
19659,365,10,2197.81,2,3,4,9,Regulars
19660,224,10,2915.3300000000004,3,3,5,11,Big Spenders
19661,148,8,1290.08,3,2,3,8,Regulars
19662,557,8,628.6700000000001,1,2,1,4,Hibernating
19663,68,9,553.48,4,2,1,7,Regulars
19664,731,6,605.7,1,1,1,3,Hibernating
19665,288,6,1879.84,2,1,4,7,Regulars
19666,225,9,847.5,3,2,2,7,Regulars
19667,22,12,3887.45,5,4,5,14,Champions
19668,750,9,4654.01,1,2,5,8,Regulars
19669,93,10,1058.25,4,3,2,9,Loyal
19670,230,7,794.95,3,1,1,5,Regulars
19671,126,14,3272.6,4,5,5,14,Champions
19672,72,13,2616.83,4,4,5,13,Champions
19673,74,15,1746.8499999999997,4,5,4,13,Champions
19674,358,10,907.0,2,3,2,7,Regulars
19675,210,12,2951.3599999999997,3,4,5,12,Big Spenders
19676,181,11,1308.6499999999999,3,3,3,9,Regulars
19677,302,5,1647.42,2,1,3,6,Regulars
19678,38,14,2453.55,5,5,4,14,Champions
19679,192,13,3071.12,3,4,5,12,Big Spenders
19680,397,10,1277.74,2,3,3,8,Regulars
19681,764,14,2677.71,1,5,5,11,At Risk
19682,332,7,1571.09,2,1,3,6,Regulars
19683,278,19,4649.17,2,5,5,12,At Risk
19684,259,8,2456.9700000000003,2,2,4,8,Regulars
19685,488,10,4463.43,1,3,5,9,Regulars
19686,250,12,3407.94,2,4,5,11,At Risk
19687,136,16,6241.4,4,5,5,14,Champions
19688,137,10,1178.99,4,3,2,9,Loyal
19689,29,14,4514.870000000001,5,5,5,15,Champions
19690,553,12,1427.13,1,4,3,8,At Risk
19691,91,11,4538.01,4,3,5,12,Loyal
19692,89,12,1330.0900000000001,4,4,3,11,Loyal
19693,591,14,1549.54,1,5,3,9,At Risk
19694,473,7,2136.2799999999997,1,1,4,6,Regulars
19695,397,6,412.61,2,1,1,4,Hibernating
19696,112,11,1345.8000000000002,4,3,3,10,Loyal
19697,346,14,2230.62,2,5,4,11,At Risk
19698,896,12,616.36,1,4,1,6,At Risk
19699,672,6,1537.67,1,1,3,5,Regulars
19700,68,13,2667.86,4,4,5,13,Champions
19701,446,10,2654.62,2,3,5,10,Regulars
19702,584,12,2676.04,1,4,5,10,At Risk
19703,8,9,1068.82,5,2,2,9,Regulars
19704,345,7,711.24,2,1,1,4,Hibernating
19705,125,14,3389.28,4,5,5,14,Champions
19706,546,7,5176.44,1,1,5,7,Regulars
19707,58,8,916.2,5,2,2,9,Regulars
19708,34,9,1213.93,5,2,2,9,Regulars
19709,115,18,2563.4900000000002,4,5,4,13,Champions
19710,201,12,3526.75,3,4,5,12,Big Spenders
19711,149,10,1977.6,3,3,4,10,Big Spenders
19712,1,12,1361.75,5,4,3,12,Loyal
19713,452,12,1464.08,2,4,3,9,At Risk
19714,372,12,2067.0099999999998,2,4,4,10,At Risk
19715,135,10,610.76,4,3,1,8,Loyal
19716,415,10,694.48,2,3,1,6,Regulars
19717,203,10,1359.29,3,3,3,9,Regulars
19718,88,10,1299.87,4,3,3,10,Loyal
19719,896,9,1133.55,1,2,2,5,Hibernating
19720,151,10,994.9200000000001,3,3,2,8,Regulars
19721,665,5,2081.68,1,1,4,6,Regulars
19722,0,7,4346.64,5,1,5,11,Big Spenders
19723,66,4,395.57,4,1,1,6,Regulars
19724,615,9,2505.19,1,2,4,7,Regulars
19725,402,10,1452.05,2,3,3,8,Regulars
19726,221,8,2961.9,3,2,5,10,Big Spenders
19727,192,8,881.91,3,2,2,7,Regulars
19728,58,14,4187.43,5,5,5,15,Champions
19729,247,8,615.29,3,2,1,6,Regulars
19730,43,12,4108.31,5,4,5,14,Champions
19731,137,12,862.79,4,4,2,10,Loyal
19732,39,8,1135.79,5,2,2,9,Regulars
19733,17,10,1287.6599999999999,5,3,3,11,Loyal
19734,13,17,1638.19,5,5,3,13,Loyal
19735,357,6,2745.7799999999997,2,1,5,8,Regulars
19736,57,14,2133.39,5,5,4,14,Champions
19737,200,10,1181.87,3,3,2,8,Regulars
19738,33,9,653.46,5,2,1,8,Regulars
19739,173,11,1063.57,3,3,2,8,Regulars
19740,31,10,1113.73,5,3,2,10,Loyal
19741,25,14,2733.55,5,5,5,15,Champions
19742,7,9,1201.89,5,2,2,9,Regulars
19743,82,13,1549.46,4,4,3,11,Loyal
19744,268,12,1703.29,2,4,3,9,At Risk
19745,180,10,2180.42,3,3,4,10,Big Spenders
19746,266,10,673.2099999999999,2,3,1,6,Regulars
19747,354,5,617.12,2,1,1,4,Hibernating
19748,615,11,1658.87,1,3,3,7,Regulars
19749,99,10,1727.27,4,3,4,11,Loyal
19750,26,10,2576.0699999999997,5,3,5,13,Loyal
19751,156,11,3161.8999999999996,3,3,5,11,Big Spenders
19752,245,11,881.26,3,3,2,8,Regulars
19753,11,10,3010.6,5,3,5,13,Loyal
19754,601,8,589.11,1,2,1,4,Hibernating
19755,430,5,376.51,2,1,1,4,Hibernating
19756,757,9,1314.06,1,2,3,6,Regulars
19757,395,10,826.5,2,3,1,6,Regulars
19758,144,7,711.96,4,1,1,6,Regulars
19759,744,13,3442.2,1,4,5,10,At Risk
19760,7,11,4395.95,5,3,5,13,Loyal
19761,192,11,2743.43,3,3,5,11,Big Spenders
19762,492,6,989.57,1,1,2,4,Hibernating
19763,100,6,827.19,4,1,1,6,Regulars
19764,138,7,751.84,4,1,1,6,Regulars
19765,192,11,3953.29,3,3,5,11,Big Spenders
19766,418,10,3886.2599999999998,2,3,5,10,Regulars
19767,120,10,989.41,4,3,2,9,Loyal
19768,29,10,686.83,5,3,1,9,Loyal
19769,524,15,4989.370000000001,1,5,5,11,At Risk
19770,369,6,1283.56,2,1,3,6,Regulars
19771,175,9,1659.2399999999998,3,2,3,8,Regulars
19772,31,11,716.34,5,3,1,9,Loyal
19773,153,15,1504.29,3,5,3,11,Regulars
19774,368,7,562.9399999999999,2,1,1,4,Hibernating
19775,165,10,2228.39,3,3,4,10,Big Spenders
19776,195,12,1430.83,3,4,3,10,Regulars
19777,162,9,905.4200000000001,3,2,2,7,Regulars
19778,76,12,3134.43,4,4,5,13,Champions
19779,133,11,674.61,4,3,1,8,Loyal
19780,442,10,2388.2,2,3,4,9,Regulars
19781,243,17,2139.61,3,5,4,12,Big Spenders
19782,173,13,1248.44,3,4,3,10,Regulars
19783,440,12,3093.61,2,4,5,11,At Risk
19784,470,8,2020.57,1,2,4,7,Regulars
19785,145,7,644.24,4,1,1,6,Regulars
19786,139,15,2464.3,4,5,4,13,Champions
19787,134,12,1127.24,4,4,2,10,Loyal
19788,112,9,796.74,4,2,1,7,Regulars
19789,274,13,1516.9199999999998,2,4,3,9,At Risk
19790,132,12,1720.4499999999998,4,4,3,11,Loyal
19791,431,5,765.3299999999999,2,1,1,4,Hibernating
19792,694,8,2813.5499999999997,1,2,5,8,Regulars
19793,217,9,2323.13,3,2,4,9,Big Spenders
19794,95,10,3064.0499999999997,4,3,5,12,Loyal
19795,44,12,1623.5900000000001,5,4,3,12,Loyal
19796,643,13,3525.4400000000005,1,4,5,10,At Risk
19797,212,7,1874.8400000000001,3,1,4,8,Big Spenders
19798,201,6,142.54000000000002,3,1,1,5,Regulars
19799,15,8,639.47,5,2,1,8,Regulars
19800,499,7,2040.3600000000001,1,1,4,6,Regulars
19801,43,6,911.22,5,1,2,8,Regulars
19802,146,11,1473.88,4,3,3,10,Loyal
19803,535,7,1414.95,1,1,3,5,Regulars
19804,174,7,1677.92,3,1,3,7,Regulars
19805,45,11,1488.68,5,3,3,11,Loyal
19806,90,11,1296.1599999999999,4,3,3,10,Loyal
19807,113,7,889.59,4,1,2,7,Regulars
19808,143,9,637.55,4,2,1,7,Regulars
19809,431,15,1411.4899999999998,2,5,3,10,At Risk
19810,117,21,2173.95,4,5,4,13,Champions
19811,69,13,1198.32,4,4,2,10,Loyal
19812,92,15,3924.29,4,5,5,14,Champions
19813,620,9,2193.5699999999997,1,2,4,7,Regulars
19814,53,13,2643.11,5,4,5,14,Champions
19815,1462,5,1305.25,1,1,3,5,Regulars
19816,854,11,2710.05,1,3,5,9,Regulars
19817,194,11,3345.03,3,3,5,11,Big Spenders
19818,48,12,3600.26,5,4,5,14,Champions
19819,203,10,2029.21,3,3,4,10,Big Spenders
19820,1683,10,1989.6100000000001,1,3,4,8,Regulars
19821,223,7,1200.01,3,1,2,6,Regulars
19822,48,13,2303.64,5,4,4,13,Champions
19823,899,8,546.16,1,2,1,4,Hibernating
19824,316,6,1287.43,2,1,3,6,Regulars
19825,41,12,2862.9900000000002,5,4,5,14,Champions
19826,279,12,1369.7,2,4,3,9,At Risk
19827,243,8,800.55,3,2,1,6,Regulars
19828,398,13,1307.59,2,4,3,9,At Risk
19829,177,6,2201.22,3,1,4,8,Big Spenders
19830,504,10,1823.01,1,3,4,8,Regulars
19831,64,13,1745.66,5,4,4,13,Champions
19832,25,8,1809.63,5,2,4,11,Big Spenders
19833,126,10,2191.29,4,3,4,11,Loyal
19834,185,11,2790.0499999999997,3,3,5,11,Big Spenders
19835,719,6,2627.6600000000003,1,1,5,7,Regulars
19836,9,10,1182.99,5,3,2,10,Loyal
19837,51,6,1885.87,5,1,4,10,Big Spenders
19838,68,10,827.17,4,3,1,8,Loyal
19839,149,7,825.1400000000001,3,1,1,5,Regulars
19840,43,11,884.61,5,3,2,10,Loyal
19841,107,9,920.35,4,2,2,8,Regulars
19842,274,7,740.27,2,1,1,4,Hibernating
19843,51,18,4932.47,5,5,5,15,Champions
19844,342,8,1047.01,2,2,2,6,Hibernating
19845,256,8,2759.69,2,2,5,9,Regulars
19846,132,10,1687.74,4,3,3,10,Loyal
19847,28,9,1979.5100000000002,5,2,4,11,Big Spenders
19848,926,10,2169.11,1,3,4,8,Regulars
19849,95,12,1800.1000000000001,4,4,4,12,Champions
19850,852,14,1060.09,1,5,2,8,At Risk
19851,251,7,570.37,2,1,1,4,Hibernating
19852,724,7,954.5799999999999,1,1,2,4,Hibernating
19853,245,7,543.0,3,1,1,5,Regulars
19854,273,15,2130.32,2,5,4,11,At Risk
19855,601,8,676.11,1,2,1,4,Hibernating
19856,109,16,2948.92,4,5,5,14,Champions
19857,101,11,1698.3700000000001,4,3,3,10,Loyal
19858,303,13,1724.1299999999999,2,4,3,9,At Risk
19859,327,11,2641.43,2,3,5,10,Regulars
19860,67,11,2038.77,4,3,4,11,Loyal
19861,200,11,1042.98,3,3,2,8,Regulars
19862,301,8,1407.6100000000001,2,2,3,7,Regulars
19863,492,11,2110.95,1,3,4,8,Regulars
19864,340,5,1283.2,2,1,3,6,Regulars
19865,826,9,3322.5299999999997,1,2,5,8,Regulars
19866,473,8,1049.02,1,2,2,5,Hibernating
19867,779,9,989.97,1,2,2,5,Hibernating
19868,31,8,2210.31,5,2,4,11,Big Spenders
19869,444,8,3295.6400000000003,2,2,5,9,Regulars
19870,596,8,766.34,1,2,1,4,Hibernating
19871,115,11,1000.8100000000001,4,3,2,9,Loyal
19872,42,14,1618.75,5,5,3,13,Loyal
19873,293,9,1335.51,2,2,3,7,Regulars
19874,66,12,1422.95,4,4,3,11,Loyal
19875,34,12,2134.4500000000003,5,4,4,13,Champions
19876,245,12,1462.6100000000001,3,4,3,10,Regulars
19877,1267,7,1944.28,1,1,4,6,Regulars
19878,699,7,755.98,1,1,1,3,Hibernating
19879,199,13,1110.17,3,4,2,9,Regulars
19880,298,9,1450.19,2,2,3,7,Regulars
19881,6,15,3145.2599999999998,5,5,5,15,Champions
19882,433,8,606.89,2,2,1,5,Hibernating
19883,231,11,1511.0900000000001,3,3,3,9,Regulars
19884,538,6,283.5,1,1,1,3,Hibernating
19885,1317,3,264.88,1,1,1,3,Hibernating
19886,342,18,1807.99,2,5,4,11,At Risk
19887,127,13,4094.0199999999995,4,4,5,13,Champions
19888,6,16,3001.73,5,5,5,15,Champions
19889,25,7,1431.96,5,1,3,9,Regulars
19890,774,7,928.94,1,1,2,4,Hibernating
19891,126,14,2978.5,4,5,5,14,Champions
19892,78,18,5408.4800000000005,4,5,5,14,Champions
19893,161,15,1074.96,3,5,2,10,Regulars
19894,189,9,1224.48,3,2,2,7,Regulars
19895,1904,2,185.70999999999998,1,1,1,3,Hibernating
19896,602,9,1691.04,1,2,3,6,Regulars
19897,128,11,1816.9099999999999,4,3,4,11,Loyal
19898,203,11,1449.2800000000002,3,3,3,9,Regulars
19899,275,12,5441.219999999999,2,4,5,11,At Risk
19900,327,9,1127.96,2,2,2,6,Hibernating
19901,1038,7,816.3100000000001,1,1,1,3,Hibernating
19902,438,10,2731.2599999999998,2,3,5,10,Regulars
19903,1876,7,509.53,1,1,1,3,Hibernating
19904,189,9,2636.7200000000003,3,2,5,10,Big Spenders
19905,350,11,682.28,2,3,1,6,Regulars
19906,289,13,1329.74,2,4,3,9,At Risk
19907,129,10,706.17,4,3,1,8,Loyal
19908,435,7,653.04,2,1,1,4,Hibernating
19909,16,9,1195.27,5,2,2,9,Regulars
19910,153,7,490.51,3,1,1,5,Regulars
19911,243,9,2545.33,3,2,4,9,Big Spenders
19912,63,14,2728.19,5,5,5,15,Champions
19913,591,10,1671.98,1,3,3,7,Regulars
19914,26,14,1704.74,5,5,3,13,Loyal
19915,138,11,1038.5,4,3,2,9,Loyal
19916,92,8,1020.6700000000001,4,2,2,8,Regulars
19917,259,14,2241.33,2,5,4,11,At Risk
19918,245,10,539.44,3,3,1,7,Regulars
19919,411,10,1008.58,2,3,2,7,Regulars
19920,3,8,1744.54,5,2,4,11,Big Spenders
19921,546,8,1519.2,1,2,3,6,Regulars
19922,40,14,1634.34,5,5,3,13,Loyal
19923,198,7,629.92,3,1,1,5,Regulars
19924,560,7,544.89,1,1,1,3,Hibernating
19925,81,5,701.1,4,1,1,6,Regulars
19926,815,3,703.54,1,1,1,3,Hibernating
19927,330,8,1217.3799999999999,2,2,2,6,Hibernating
19928,25,11,761.92,5,3,1,9,Loyal
19929,64,9,964.72,5,2,2,9,Regulars
19930,299,14,3401.36,2,5,5,12,At Risk
19931,722,5,790.4100000000001,1,1,1,3,Hibernating
19932,197,15,4705.47,3,5,5,13,Big Spenders
19933,252,6,569.4200000000001,2,1,1,4,Hibernating
19934,227,11,1610.77,3,3,3,9,Regulars
19935,174,8,640.3499999999999,3,2,1,6,Regulars
19936,326,13,2154.04,2,4,4,10,At Risk
19937,116,12,1448.76,4,4,3,11,Loyal
19938,104,10,1356.5900000000001,4,3,3,10,Loyal
19939,129,5,450.91999999999996,4,1,1,6,Regulars
19940,142,12,2103.5,4,4,4,12,Champions
19941,101,14,1828.79,4,5,4,13,Champions
19942,4,10,2233.9500000000003,5,3,4,12,Loyal
19943,343,10,3116.0899999999997,2,3,5,10,Regulars
19944,285,9,1513.3799999999999,2,2,3,7,Regulars
19945,144,11,1281.77,4,3,3,10,Loyal
19946,157,7,682.6099999999999,3,1,1,5,Regulars
19947,499,12,4297.82,1,4,5,10,At Risk
19948,556,11,2135.2999999999997,1,3,4,8,Regulars
19949,36,12,3481.2200000000003,5,4,5,14,Champions
19950,28,9,3794.6899999999996,5,2,5,12,Big Spenders
19951,158,6,420.17,3,1,1,5,Regulars
19952,163,16,2287.32,3,5,4,12,Big Spenders
19953,1075,5,393.18000000000006,1,1,1,3,Hibernating
19954,166,8,1172.6399999999999,3,2,2,7,Regulars
19955,843,12,922.1,1,4,2,7,At Risk
19956,93,13,4378.9,4,4,5,13,Champions
19957,6,15,1253.6,5,5,3,13,Loyal
19958,20,8,4416.03,5,2,5,12,Big Spenders
19959,458,14,1941.91,2,5,4,11,At Risk
19960,257,8,814.34,2,2,1,5,Hibernating
19961,84,12,1157.03,4,4,2,10,Loyal
19962,93,11,685.0,4,3,1,8,Loyal
19963,133,10,1713.02,4,3,3,10,Loyal
19964,302,11,1133.05,2,3,2,7,Regulars
19965,305,12,2615.81,2,4,5,11,At Risk
19966,300,4,214.51999999999998,2,1,1,4,Hibernating
19967,27,6,494.05,5,1,1,7,Regulars
19968,102,16,1348.08,4,5,3,12,Loyal
19969,251,10,4561.969999999999,2,3,5,10,Regulars
19970,1113,6,921.25,1,1,2,4,Hibernating
19971,319,13,969.1700000000001,2,4,2,8,At Risk
19972,111,8,1087.76,4,2,2,8,Regulars
19973,961,6,555.62,1,1,1,3,Hibernating
19974,113,10,2603.7999999999997,4,3,5,12,Loyal
19975,278,12,3163.84,2,4,5,11,At Risk
19976,113,11,1708.5900000000001,4,3,3,10,Loyal
19977,483,10,2472.22,1,3,4,8,Regulars
19978,334,10,1251.5,2,3,3,8,Regulars
19979,0,9,847.85,5,2,2,9,Regulars
19980,243,7,2501.1,3,1,4,8,Big Spenders
19981,78,15,3784.06,4,5,5,14,Champions
19982,61,15,2435.42,5,5,4,14,Champions
19983,30,16,2204.71,5,5,4,14,Champions
19984,139,7,2550.6,4,1,4,9,Big Spenders
19985,166,11,4374.42,3,3,5,11,Big Spenders
19986,183,10,1662.2799999999997,3,3,3,9,Regulars
19987,301,10,2256.02,2,3,4,9,Regulars
19988,63,11,747.27,5,3,1,9,Loyal
19989,19,15,2825.73,5,5,5,15,Champions
19990,924,6,710.48,1,1,1,3,Hibernating
19991,437,7,506.19,2,1,1,4,Hibernating
19992,892,7,454.11,1,1,1,3,Hibernating
19993,219,8,866.83,3,2,2,7,Regulars
19994,40,13,7388.879999999999,5,4,5,14,Champions
19995,1055,13,6272.7699999999995,1,4,5,10,At Risk
19996,16,12,1222.39,5,4,2,11,Loyal
19997,455,10,1904.29,2,3,4,9,Regulars
19998,607,10,996.59,1,3,2,6,Regulars
19999,17,11,1065.9099999999999,5,3,2,10,Loyal
20000,170,16,2042.08,3,5,4,12,Big Spenders
20001,74,11,1825.13,4,3,4,11,Loyal
20002,122,11,2003.7299999999998,4,3,4,11,Loyal
20003,484,7,1138.85,1,1,2,4,Hibernating
20004,183,10,2607.02,3,3,5,11,Big Spenders
20005,549,8,3106.1400000000003,1,2,5,8,Regulars
20006,623,10,4547.96,1,3,5,9,Regulars
20007,54,10,2470.2,5,3,4,12,Loyal
20008,102,14,4375.280000000001,4,5,5,14,Champions
20009,41,8,1225.72,5,2,2,9,Regulars
20010,146,5,499.93999999999994,4,1,1,6,Regulars
20011,146,15,1501.22,4,5,3,12,Loyal
20012,397,15,3019.58,2,5,5,12,At Risk
20013,266,5,2347.4900000000002,2,1,4,7,Regulars
20014,244,10,1237.24,3,3,2,8,Regulars
20015,157,10,1420.18,3,3,3,9,Regulars
20016,477,16,1067.1499999999999,1,5,2,8,At Risk
20017,160,11,776.5999999999999,3,3,1,7,Regulars
20018,663,9,1003.8299999999999,1,2,2,5,Hibernating
20019,72,8,1126.31,4,2,2,8,Regulars
20020,71,7,589.85,4,1,1,6,Regulars
20021,625,9,2937.02,1,2,5,8,Regulars
20022,530,9,1181.69,1,2,2,5,Hibernating
20023,312,9,653.49,2,2,1,5,Hibernating
20024,44,5,792.64,5,1,1,7,Regulars
20025,595,13,6086.980000000001,1,4,5,10,At Risk
20026,447,5,373.53,2,1,1,4,Hibernating
20027,50,8,1079.38,5,2,2,9,Regulars
20028,110,12,1451.07,4,4,3,11,Loyal
20029,276,11,1215.66,2,3,2,7,Regulars
20030,560,9,690.9200000000001,1,2,1,4,Hibernating
20031,253,11,2015.07,2,3,4,9,Regulars
20032,313,9,985.94,2,2,2,6,Hibernating
20033,77,11,2652.7000000000003,4,3,5,12,Loyal
20034,17,13,1168.17,5,4,2,11,Loyal
20035,170,16,1806.0,3,5,4,12,Big Spenders
20036,125,12,1257.5,4,4,3,11,Loyal
20037,197,12,3911.85,3,4,5,12,Big Spenders
20038,56,11,3011.56,5,3,5,13,Loyal
20039,153,12,2441.95,3,4,4,11,Big Spenders
20040,36,15,2478.49,5,5,4,14,Champions
20041,408,9,679.16,2,2,1,5,Hibernating
20042,621,8,894.02,1,2,2,5,Hibernating
20043,83,10,1075.85,4,3,2,9,Loyal
20044,83,10,1211.53,4,3,2,9,Loyal
20045,132,10,1111.66,4,3,2,9,Loyal
20046,471,10,1097.04,1,3,2,6,Regulars
20047,82,12,1690.94,4,4,3,11,Loyal
20048,820,8,792.16,1,2,1,4,Hibernating
20049,30,14,1972.92,5,5,4,14,Champions
20050,520,8,2504.2599999999998,1,2,4,7,Regulars
20051,74,13,2661.22,4,4,5,13,Champions
20052,147,11,2898.3300000000004,4,3,5,12,Loyal
20053,544,10,2153.16,1,3,4,8,Regulars
20054,794,8,2718.6999999999994,1,2,5,8,Regulars
20055,1135,10,1717.21,1,3,3,7,Regulars
20056,155,20,3157.4700000000003,3,5,5,13,Big Spenders
20057,592,11,1497.6999999999998,1,3,3,7,Regulars
20058,55,13,1372.51,5,4,3,12,Loyal
20059,124,11,701.1,4,3,1,8,Loyal
20060,533,12,881.26,1,4,2,7,At Risk
20061,88,7,951.19,4,1,2,7,Regulars
20062,124,6,329.96,4,1,1,6,Regulars
20063,121,14,1895.1,4,5,4,13,Champions
20064,567,6,306.79,1,1,1,3,Hibernating
20065,761,6,672.74,1,1,1,3,Hibernating
20066,605,9,1624.1899999999998,1,2,3,6,Regulars
20067,1023,8,727.95,1,2,1,4,Hibernating
20068,58,13,1881.6100000000001,5,4,4,13,Champions
20069,205,8,1740.3799999999997,3,2,4,9,Big Spenders
20070,288,13,2502.38,2,4,4,10,At Risk
20071,71,10,1685.31,4,3,3,10,Loyal
20072,175,13,1370.93,3,4,3,10,Regulars
20073,21,12,1815.11,5,4,4,13,Champions
20074,409,6,704.1200000000001,2,1,1,4,Hibernating
20075,154,12,1192.12,3,4,2,9,Regulars
20076,307,13,2962.8,2,4,5,11,At Risk
20077,0,9,716.21,5,2,1,8,Regulars
20078,1,19,2059.27,5,5,4,14,Champions
20079,122,14,1457.1799999999998,4,5,3,12,Loyal
20080,178,9,1371.13,3,2,3,8,Regulars
20081,418,10,1590.83,2,3,3,8,Regulars
20082,132,11,1909.0500000000002,4,3,4,11,Loyal
20083,590,12,1714.26,1,4,3,8,At Risk
20084,383,13,6624.26,2,4,5,11,At Risk
20085,55,21,3781.31,5,5,5,15,Champions
20086,55,7,774.84,5,1,1,7,Regulars
20087,323,11,1145.6799999999998,2,3,2,7,Regulars
20088,663,5,1001.23,1,1,2,4,Hibernating
20089,158,5,724.48,3,1,1,5,Regulars
20090,531,11,3993.92,1,3,5,9,Regulars
20091,84,6,584.98,4,1,1,6,Regulars
20092,133,13,1604.8400000000001,4,4,3,11,Loyal
20093,127,9,1608.0,4,2,3,9,Regulars
20094,663,9,5077.01,1,2,5,8,Regulars
20095,708,13,1813.8300000000002,1,4,4,9,At Risk
20096,265,6,2228.37,2,1,4,7,Regulars
20097,353,6,2180.4500000000003,2,1,4,7,Regulars
20098,56,15,4618.79,5,5,5,15,Champions
20099,445,12,1315.22,2,4,3,9,At Risk
20100,252,11,2140.06,2,3,4,9,Regulars
20101,45,12,614.45,5,4,1,10,Loyal
20102,735,8,499.64,1,2,1,4,Hibernating
20103,56,6,1207.9099999999999,5,1,2,8,Regulars
20104,171,7,1268.05,3,1,3,7,Regulars
20105,530,9,382.24,1,2,1,4,Hibernating
20106,623,5,756.0699999999999,1,1,1,3,Hibernating
20107,117,19,2002.6,4,5,4,13,Champions
20108,58,12,1724.6999999999998,5,4,3,12,Loyal
20109,49,13,3057.19,5,4,5,14,Champions
20110,358,9,939.13,2,2,2,6,Hibernating
20111,331,10,4563.49,2,3,5,10,Regulars
20112,703,6,434.61,1,1,1,3,Hibernating
20113,524,10,1902.3,1,3,4,8,Regulars
20114,328,10,1186.68,2,3,2,7,Regulars
20115,49,13,1501.1,5,4,3,12,Loyal
20116,216,5,443.38,3,1,1,5,Regulars
20117,205,8,892.04,3,2,2,7,Regulars
20118,8,13,1155.97,5,4,2,11,Loyal
20119,51,8,1709.8400000000001,5,2,3,10,Regulars
20120,922,6,3478.22,1,1,5,7,Regulars
20121,347,9,1739.01,2,2,4,8,Regulars
20122,30,10,855.05,5,3,2,10,Loyal
20123,776,6,859.16,1,1,2,4,Hibernating
20124,226,10,1024.05,3,3,2,8,Regulars
20125,642,11,1582.82,1,3,3,7,Regulars
20126,8,11,985.64,5,3,2,10,Loyal
20127,26,13,1768.0,5,4,4,13,Champions
20128,719,5,169.26,1,1,1,3,Hibernating
20129,44,5,5265.16,5,1,5,11,Big Spenders
20130,28,10,881.53,5,3,2,10,Loyal
20131,163,11,1460.35,3,3,3,9,Regulars
20132,732,13,1819.68,1,4,4,9,At Risk
20133,84,7,1319.93,4,1,3,8,Regulars
20134,128,11,3093.94,4,3,5,12,Loyal
20135,351,5,506.62,2,1,1,4,Hibernating
20136,333,10,1480.82,2,3,3,8,Regulars
20137,190,5,421.78000000000003,3,1,1,5,Regulars
20138,221,9,858.86,3,2,2,7,Regulars
20139,461,8,1054.09,1,2,2,5,Hibernating
20140,288,12,1327.32,2,4,3,9,At Risk
20141,145,11,956.25,4,3,2,9,Loyal
20142,294,13,1582.8999999999999,2,4,3,9,At Risk
20143,698,6,778.1,1,1,1,3,Hibernating
20144,278,14,2695.55,2,5,5,12,At Risk
20145,40,9,2161.96,5,2,4,11,Big Spenders
20146,26,13,2021.65,5,4,4,13,Champions
20147,6,9,3497.13,5,2,5,12,Big Spenders
20148,869,8,2338.55,1,2,4,7,Regulars
20149,187,12,1508.6,3,4,3,10,Regulars
20150,793,9,962.52,1,2,2,5,Hibernating
20151,19,5,313.17,5,1,1,7,Regulars
20152,19,9,1419.02,5,2,3,10,Regulars
20153,82,17,4324.42,4,5,5,14,Champions
20154,638,11,3042.14,1,3,5,9,Regulars
20155,12,5,638.46,5,1,1,7,Regulars
20156,54,14,3855.8399999999997,5,5,5,15,Champions
20157,994,4,459.69,1,1,1,3,Hibernating
20158,766,10,933.02,1,3,2,6,Regulars
20159,949,9,865.13,1,2,2,5,Hibernating
20160,255,13,4466.98,2,4,5,11,At Risk
20161,231,10,1936.84,3,3,4,10,Big Spenders
20162,288,17,3807.93,2,5,5,12,At Risk
20163,507,10,789.88,1,3,1,5,Regulars
20164,44,6,1117.54,5,1,2,8,Regulars
20165,121,7,500.8,4,1,1,6,Regulars
20166,167,14,1274.78,3,5,3,11,Regulars
20167,283,5,478.02,2,1,1,4,Hibernating
20168,225,11,4728.23,3,3,5,11,Big Spenders
20169,321,9,2074.2799999999997,2,2,4,8,Regulars
20170,120,10,1991.22,4,3,4,11,Loyal
20171,40,14,2569.9300000000003,5,5,4,14,Champions
20172,428,13,2269.23,2,4,4,10,At Risk
20173,166,13,4750.91,3,4,5,12,Big Spenders
20174,439,13,1080.33,2,4,2,8,At Risk
20175,303,7,662.6700000000001,2,1,1,4,Hibernating
20176,480,12,1271.0,1,4,3,8,At Risk
20177,203,10,1591.07,3,3,3,9,Regulars
20178,667,13,2475.88,1,4,4,9,At Risk
20179,31,9,1228.55,5,2,2,9,Regulars
20180,392,13,4985.88,2,4,5,11,At Risk
20181,149,13,1783.08,3,4,4,11,Big Spenders
20182,6,7,975.9,5,1,2,8,Regulars
20183,258,9,2298.7000000000003,2,2,4,8,Regulars
20184,297,9,924.21,2,2,2,6,Hibernating
20185,420,7,427.68,2,1,1,4,Hibernating
20186,211,10,3417.64,3,3,5,11,Big Spenders
20187,65,14,1101.3899999999999,5,5,2,12,Loyal
20188,175,11,2066.13,3,3,4,10,Big Spenders
20189,470,10,5403.06,1,3,5,9,Regulars
20190,589,12,1894.8,1,4,4,9,At Risk
20191,185,11,1953.5,3,3,4,10,Big Spenders
20192,382,13,1368.5,2,4,3,9,At Risk
20193,1729,4,458.96000000000004,1,1,1,3,Hibernating
20194,168,8,1113.63,3,2,2,7,Regulars
20195,595,10,581.93,1,3,1,5,Regulars
20196,233,10,1006.11,3,3,2,8,Regulars
20197,1744,6,2042.3,1,1,4,6,Regulars
20198,1486,5,1582.9899999999998,1,1,3,5,Regulars
20199,249,9,2045.24,2,2,4,8,Regulars
20200,143,10,979.35,4,3,2,9,Loyal
20201,56,10,1256.18,5,3,3,11,Loyal
20202,420,18,3640.93,2,5,5,12,At Risk
20203,42,15,1283.32,5,5,3,13,Loyal
20204,85,11,1163.49,4,3,2,9,Loyal
20205,159,8,1331.76,3,2,3,8,Regulars
20206,15,4,338.92,5,1,1,7,Regulars
20207,436,10,1140.0,2,3,2,7,Regulars
20208,21,13,1823.24,5,4,4,13,Champions
20209,22,20,2255.9,5,5,4,14,Champions
20210,168,11,1365.6599999999999,3,3,3,9,Regulars
20211,137,12,786.79,4,4,1,9,Loyal
20212,99,10,3607.8500000000004,4,3,5,12,Loyal
20213,523,11,4792.469999999999,1,3,5,9,Regulars
20214,20,13,4925.24,5,4,5,14,Champions
20215,177,11,1305.19,3,3,3,9,Regulars
20216,89,9,873.8000000000001,4,2,2,8,Regulars
20217,166,13,1050.8300000000002,3,4,2,9,Regulars
20218,254,12,1730.23,2,4,4,10,At Risk
20219,3,8,1367.8,5,2,3,10,Regulars
20220,254,9,2691.46,2,2,5,9,Regulars
20221,119,10,1147.56,4,3,2,9,Loyal
20222,38,16,3011.3500000000004,5,5,5,15,Champions
20223,204,13,2200.8,3,4,4,11,Big Spenders
20224,100,9,1385.23,4,2,3,9,Regulars
20225,437,7,2081.45,2,1,4,7,Regulars
20226,56,11,3734.46,5,3,5,13,Loyal
20227,145,10,3302.2200000000003,4,3,5,12,Loyal
20228,385,9,637.8399999999999,2,2,1,5,Hibernating
20229,597,10,1514.06,1,3,3,7,Regulars
20230,878,11,1107.3999999999999,1,3,2,6,Regulars
20231,155,9,1293.6000000000001,3,2,3,8,Regulars
20232,17,16,3390.39,5,5,5,15,Champions
20233,30,10,1428.56,5,3,3,11,Loyal
20234,243,13,2980.14,3,4,5,12,Big Spenders
20235,811,7,840.11,1,1,1,3,Hibernating
20236,173,12,1640.67,3,4,3,10,Regulars
20237,649,14,1070.06,1,5,2,8,At Risk
20238,216,11,3013.14,3,3,5,11,Big Spenders
20239,1096,8,1235.59,1,2,2,5,Hibernating
20240,121,8,683.76,4,2,1,7,Regulars
20241,0,8,1048.5,5,2,2,9,Regulars
20242,298,8,964.9199999999998,2,2,2,6,Hibernating
20243,247,6,641.46,3,1,1,5,Regulars
20244,590,4,291.05,1,1,1,3,Hibernating
20245,207,8,1478.62,3,2,3,8,Regulars
20246,5,13,1746.1299999999999,5,4,4,13,Champions
20247,70,12,1236.39,4,4,2,10,Loyal
20248,214,14,5565.6,3,5,5,13,Big Spenders
20249,456,10,1908.03,2,3,4,9,Regulars
20250,144,9,495.55999999999995,4,2,1,7,Regulars
20251,96,15,2883.59,4,5,5,14,Champions
20252,15,10,1222.26,5,3,2,10,Loyal
20253,363,11,1256.45,2,3,3,8,Regulars
20254,579,13,1585.12,1,4,3,8,At Risk
20255,64,13,2170.55,5,4,4,13,Champions
20256,55,9,1029.4,5,2,2,9,Regulars
20257,208,11,917.41,3,3,2,8,Regulars
20258,6,9,1359.55,5,2,3,10,Regulars
20259,415,13,1559.23,2,4,3,9,At Risk
20260,315,4,2013.7900000000002,2,1,4,7,Regulars
20261,628,10,1192.38,1,3,2,6,Regulars
20262,378,11,1083.52,2,3,2,7,Regulars
20263,174,12,1605.66,3,4,3,10,Regulars
20264,29,17,2416.41,5,5,4,14,Champions
20265,282,6,817.86,2,1,1,4,Hibernating
20266,62,11,1353.44,5,3,3,11,Loyal
20267,0,13,998.0,5,4,2,11,Loyal
20268,348,9,883.52,2,2,2,6,Hibernating
20269,8,11,1067.22,5,3,2,10,Loyal
20270,50,16,1788.7199999999998,5,5,4,14,Champions
20271,540,6,809.99,1,1,1,3,Hibernating
20272,238,14,1097.53,3,5,2,10,Regulars
20273,126,12,2105.83,4,4,4,12,Champions
20274,897,7,3579.89,1,1,5,7,Regulars
20275,1074,12,3176.47,1,4,5,10,At Risk
20276,74,9,817.26,4,2,1,7,Regulars
20277,100,16,3811.6800000000003,4,5,5,14,Champions
20278,109,9,1395.83,4,2,3,9,Regulars
20279,897,8,1214.6799999999998,1,2,2,5,Hibernating
20280,40,13,2354.75,5,4,4,13,Champions
20281,431,6,570.9,2,1,1,4,Hibernating
20282,384,11,2063.31,2,3,4,9,Regulars
20283,46,15,1398.68,5,5,3,13,Loyal
20284,228,7,410.89,3,1,1,5,Regulars
20285,221,4,1025.5700000000002,3,1,2,6,Regulars
20286,438,12,1986.21,2,4,4,10,At Risk
20287,231,8,1910.72,3,2,4,9,Big Spenders
20288,209,3,335.65,3,1,1,5,Regulars
20289,237,4,1226.71,3,1,2,6,Regulars
20290,148,16,3628.39,3,5,5,13,Big Spenders
20291,583,7,1188.27,1,1,2,4,Hibernating
20292,47,9,2146.65,5,2,4,11,Big Spenders
20293,26,8,2095.81,5,2,4,11,Big Spenders
20294,701,13,4038.74,1,4,5,10,At Risk
20295,100,14,2268.03,4,5,4,13,Champions
20296,180,4,448.14,3,1,1,5,Regulars
20297,158,10,959.15,3,3,2,8,Regulars
20298,159,7,628.91,3,1,1,5,Regulars
20299,53,9,886.73,5,2,2,9,Regulars
20300,169,11,2119.85,3,3,4,10,Big Spenders
20301,668,9,1803.47,1,2,4,7,Regulars
20302,14,10,1478.23,5,3,3,11,Loyal
20303,42,11,1171.82,5,3,2,10,Loyal
20304,710,9,2487.68,1,2,4,7,Regulars
20305,142,13,4194.51,4,4,5,13,Champions
20306,128,13,1807.02,4,4,4,12,Champions
20307,161,7,2297.9300000000003,3,1,4,8,Big Spenders
20308,232,9,896.36,3,2,2,7,Regulars
20309,806,6,2768.0499999999997,1,1,5,7,Regulars
20310,43,15,1718.0700000000002,5,5,3,13,Loyal
20311,127,10,1344.55,4,3,3,10,Loyal
20312,45,6,352.18,5,1,1,7,Regulars
20313,796,10,1068.53,1,3,2,6,Regulars
20314,22,12,2952.02,5,4,5,14,Champions
20315,172,10,1307.54,3,3,3,9,Regulars
20316,148,12,3295.71,3,4,5,12,Big Spenders
20317,15,15,2789.61,5,5,5,15,Champions
20318,276,8,1179.4099999999999,2,2,2,6,Hibernating
20319,95,8,1033.1,4,2,2,8,Regulars
20320,399,9,4764.83,2,2,5,9,Regulars
20321,469,13,4104.65,1,4,5,10,At Risk
20322,127,10,1363.52,4,3,3,10,Loyal
20323,325,2,171.42000000000002,2,1,1,4,Hibernating
20324,147,13,1421.98,4,4,3,11,Loyal
20325,243,9,4809.4,3,2,5,10,Big Spenders
20326,383,10,494.63,2,3,1,6,Regulars
20327,896,8,1117.3799999999999,1,2,2,5,Hibernating
20328,495,2,63.23,1,1,1,3,Hibernating
20329,409,10,1379.91,2,3,3,8,Regulars
20330,103,15,1904.8200000000002,4,5,4,13,Champions
20331,145,13,1818.71,4,4,4,12,Champions
20332,20,11,1832.21,5,3,4,12,Loyal
20333,1321,6,1179.94,1,1,2,4,Hibernating
20334,554,11,1924.54,1,3,4,8,Regulars
20335,225,16,1013.11,3,5,2,10,Regulars
20336,328,12,885.9000000000001,2,4,2,8,At Risk
20337,161,13,3286.4,3,4,5,12,Big Spenders
20338,267,14,1969.3200000000002,2,5,4,11,At Risk
20339,121,13,2846.13,4,4,5,13,Champions
20340,376,2,226.55,2,1,1,4,Hibernating
20341,215,15,2283.24,3,5,4,12,Big Spenders
20342,83,8,518.78,4,2,1,7,Regulars
20343,952,13,4266.49,1,4,5,10,At Risk
20344,549,14,1706.48,1,5,3,9,At Risk
20345,74,6,2085.33,4,1,4,9,Big Spenders
20346,436,12,1771.7400000000002,2,4,4,10,At Risk
20347,295,13,1492.61,2,4,3,9,At Risk
20348,127,12,2301.23,4,4,4,12,Champions
20349,287,12,1497.3,2,4,3,9,At Risk
20350,71,9,606.9100000000001,4,2,1,7,Regulars
20351,26,6,694.6999999999999,5,1,1,7,Regulars
20352,122,10,1878.34,4,3,4,11,Loyal
20353,717,9,791.86,1,2,1,4,Hibernating
20354,207,7,527.08,3,1,1,5,Regulars
20355,133,9,3277.24,4,2,5,11,Big Spenders
20356,10,11,1119.47,5,3,2,10,Loyal
20357,51,13,4939.5199999999995,5,4,5,14,Champions
20358,888,5,952.95,1,1,2,4,Hibernating
20359,855,5,367.28000000000003,1,1,1,3,Hibernating
20360,343,13,2688.76,2,4,5,11,At Risk
20361,244,5,860.19,3,1,2,6,Regulars
20362,119,12,2670.29,4,4,5,13,Champions
20363,72,9,1168.96,4,2,2,8,Regulars
20364,33,9,2023.99,5,2,4,11,Big Spenders
20365,149,9,908.7,3,2,2,7,Regulars
20366,161,9,1281.02,3,2,3,8,Regulars
20367,107,12,1991.3400000000001,4,4,4,12,Champions
20368,423,10,1634.62,2,3,3,8,Regulars
20369,169,9,537.92,3,2,1,6,Regulars
20370,53,10,4400.79,5,3,5,13,Loyal
20371,118,8,867.7,4,2,2,8,Regulars
20372,455,10,1760.37,2,3,4,9,Regulars
20373,434,18,2279.35,2,5,4,11,At Risk
20374,120,9,1483.1799999999998,4,2,3,9,Regulars
20375,8,13,2237.17,5,4,4,13,Champions
20376,150,12,1765.7799999999997,3,4,4,11,Big Spenders
20377,19,9,1271.36,5,2,3,10,Regulars
20378,337,9,2282.39,2,2,4,8,Regulars
20379,183,10,1640.53,3,3,3,9,Regulars
20380,600,11,771.71,1,3,1,5,Regulars
20381,23,8,812.77,5,2,1,8,Regulars
20382,35,14,3210.6800000000003,5,5,5,15,Champions
20383,621,10,948.47,1,3,2,6,Regulars
20384,173,8,3188.47,3,2,5,10,Big Spenders
20385,237,10,1698.06,3,3,3,9,Regulars
20386,82,9,2742.78,4,2,5,11,Big Spenders
20387,31,17,3859.98,5,5,5,15,Champions
20388,2,17,4234.34,5,5,5,15,Champions
20389,184,16,2573.13,3,5,4,12,Big Spenders
20390,7,11,2448.7999999999997,5,3,4,12,Loyal
20391,98,9,1109.11,4,2,2,8,Regulars
20392,295,12,1276.82,2,4,3,9,At Risk
20393,141,11,1242.88,4,3,3,10,Loyal
20394,53,8,762.1899999999999,5,2,1,8,Regulars
20395,486,12,1415.67,1,4,3,8,At Risk
20396,404,7,275.0,2,1,1,4,Hibernating
20397,63,14,1108.95,5,5,2,12,Loyal
20398,133,9,3478.34,4,2,5,11,Big Spenders
20399,9,13,4350.5599999999995,5,4,5,14,Champions
20400,233,6,402.59,3,1,1,5,Regulars
20401,505,14,2327.49,1,5,4,10,At Risk
20402,117,10,4075.92,4,3,5,12,Loyal
20403,1195,5,277.35,1,1,1,3,Hibernating
20404,1036,7,1212.85,1,1,2,4,Hibernating
20405,245,5,264.0,3,1,1,5,Regulars
20406,91,15,2186.41,4,5,4,13,Champions
20407,4,15,1420.8899999999999,5,5,3,13,Loyal
20408,171,14,1985.51,3,5,4,12,Big Spenders
20409,208,10,711.54,3,3,1,7,Regulars
20410,81,9,606.0400000000001,4,2,1,7,Regulars
20411,301,10,1239.14,2,3,2,7,Regulars
20412,416,11,1594.44,2,3,3,8,Regulars
20413,221,9,1345.96,3,2,3,8,Regulars
20414,519,14,1797.8000000000002,1,5,4,10,At Risk
20415,103,10,1887.8500000000001,4,3,4,11,Loyal
20416,177,13,6558.139999999999,3,4,5,12,Big Spenders
20417,894,5,498.52000000000004,1,1,1,3,Hibernating
20418,42,16,2086.83,5,5,4,14,Champions
20419,486,7,1086.28,1,1,2,4,Hibernating
20420,40,14,2951.3500000000004,5,5,5,15,Champions
20421,82,12,2630.29,4,4,5,13,Champions
20422,207,12,1464.29,3,4,3,10,Regulars
20423,119,11,4861.88,4,3,5,12,Loyal
20424,76,6,907.5699999999999,4,1,2,7,Regulars
20425,203,4,708.86,3,1,1,5,Regulars
20426,898,5,305.82,1,1,1,3,Hibernating
20427,249,11,4347.68,2,3,5,10,Regulars
20428,398,8,2550.2200000000003,2,2,4,8,Regulars
20429,1048,11,1640.47,1,3,3,7,Regulars
20430,376,11,1457.52,2,3,3,8,Regulars
20431,693,8,3130.44,1,2,5,8,Regulars
20432,220,8,448.03,3,2,1,6,Regulars
20433,335,8,667.62,2,2,1,5,Hibernating
20434,73,13,963.21,4,4,2,10,Loyal
20435,402,11,4054.92,2,3,5,10,Regulars
20436,161,18,3064.5099999999998,3,5,5,13,Big Spenders
20437,20,15,1833.97,5,5,4,14,Champions
20438,640,9,3300.2500000000005,1,2,5,8,Regulars
20439,2,13,1799.4,5,4,4,13,Champions
20440,33,13,3099.53,5,4,5,14,Champions
20441,457,8,394.90999999999997,2,2,1,5,Hibernating
20442,312,12,1117.96,2,4,2,8,At Risk
20443,51,5,384.81,5,1,1,7,Regulars
20444,191,9,1047.4,3,2,2,7,Regulars
20445,40,8,2161.59,5,2,4,11,Big Spenders
20446,33,10,892.5899999999999,5,3,2,10,Loyal
20447,132,7,2203.1400000000003,4,1,4,9,Big Spenders
20448,3,11,1531.8500000000001,5,3,3,11,Loyal
20449,736,9,2628.6600000000003,1,2,5,8,Regulars
20450,26,9,647.38,5,2,1,8,Regulars
20451,356,4,315.11,2,1,1,4,Hibernating
20452,310,9,1980.55,2,2,4,8,Regulars
20453,106,13,2980.0899999999997,4,4,5,13,Champions
20454,242,11,1486.54,3,3,3,9,Regulars
20455,298,8,1508.58,2,2,3,7,Regulars
20456,548,14,1068.02,1,5,2,8,At Risk
20457,766,7,1953.82,1,1,4,6,Regulars
20458,40,11,1126.66,5,3,2,10,Loyal
20459,21,7,1035.74,5,1,2,8,Regulars
20460,165,9,1195.23,3,2,2,7,Regulars
20461,377,14,1727.86,2,5,4,11,At Risk
20462,424,12,2159.96,2,4,4,10,At Risk
20463,266,16,1690.41,2,5,3,10,At Risk
20464,53,7,1011.69,5,1,2,8,Regulars
20465,251,10,1154.71,2,3,2,7,Regulars
20466,896,9,760.1600000000001,1,2,1,4,Hibernating
20467,2,13,3033.81,5,4,5,14,Champions
20468,104,15,1638.84,4,5,3,12,Loyal
20469,146,9,799.3299999999999,4,2,1,7,Regulars
20470,310,11,1436.84,2,3,3,8,Regulars
20471,47,17,3474.51,5,5,5,15,Champions
20472,369,12,3529.65,2,4,5,11,At Risk
20473,21,6,820.23,5,1,1,7,Regulars
20474,331,6,917.99,2,1,2,5,Hibernating
20475,297,5,1018.53,2,1,2,5,Hibernating
20476,436,6,1079.87,2,1,2,5,Hibernating
20477,222,9,1392.63,3,2,3,8,Regulars
20478,748,3,370.51,1,1,1,3,Hibernating
20479,375,12,1363.24,2,4,3,9,At Risk
20480,266,9,789.75,2,2,1,5,Hibernating
20481,104,13,1383.9199999999998,4,4,3,11,Loyal
20482,64,14,5135.54,5,5,5,15,Champions
20483,257,15,4161.97,2,5,5,12,At Risk
20484,102,14,1437.78,4,5,3,12,Loyal
20485,237,9,1480.0,3,2,3,8,Regulars
20486,583,9,3550.4800000000005,1,2,5,8,Regulars
20487,295,15,3840.2999999999997,2,5,5,12,At Risk
20488,201,12,2738.55,3,4,5,12,Big Spenders
20489,279,16,7397.88,2,5,5,12,At Risk
20490,127,15,2334.36,4,5,4,13,Champions
20491,100,11,1187.68,4,3,2,9,Loyal
20492,605,10,919.5,1,3,2,6,Regulars
20493,24,8,1207.6999999999998,5,2,2,9,Regulars
20494,161,4,823.78,3,1,1,5,Regulars
20495,781,3,391.74,1,1,1,3,Hibernating
20496,293,12,1264.58,2,4,3,9,At Risk
20497,201,20,3053.45,3,5,5,13,Big Spenders
20498,325,9,572.65,2,2,1,5,Hibernating
20499,197,10,601.42,3,3,1,7,Regulars
20500,29,15,3727.34,5,5,5,15,Champions
20501,249,13,1818.1299999999999,2,4,4,10,At Risk
20502,68,6,2366.38,4,1,4,9,Big Spenders
20503,5,12,998.71,5,4,2,11,Loyal
20504,29,7,1628.79,5,1,3,9,Regulars
20505,89,17,2867.48,4,5,5,14,Champions
20506,306,7,942.9300000000001,2,1,2,5,Hibernating
20507,14,13,2151.68,5,4,4,13,Champions
20508,209,12,1545.92,3,4,3,10,Regulars
20509,68,8,728.79,4,2,1,7,Regulars
20510,191,13,1569.3700000000001,3,4,3,10,Regulars
20511,281,8,579.89,2,2,1,5,Hibernating
20512,228,5,615.45,3,1,1,5,Regulars
20513,1373,7,1020.21,1,1,2,4,Hibernating
20514,474,12,1860.6000000000001,1,4,4,9,At Risk
20515,389,9,752.52,2,2,1,5,Hibernating
20516,76,13,3093.21,4,4,5,13,Champions
20517,879,9,1015.59,1,2,2,5,Hibernating
20518,311,11,2675.57,2,3,5,10,Regulars
20519,236,9,1205.78,3,2,2,7,Regulars
20520,125,12,4699.3,4,4,5,13,Champions
20521,384,16,2253.34,2,5,4,11,At Risk
20522,77,9,1167.73,4,2,2,8,Regulars
20523,258,6,860.59,2,1,2,5,Hibernating
20524,109,7,1384.61,4,1,3,8,Regulars
20525,154,16,3037.01,3,5,5,13,Big Spenders
20526,110,10,2311.5099999999998,4,3,4,11,Loyal
20527,144,11,752.38,4,3,1,8,Loyal
20528,45,9,2979.8900000000003,5,2,5,12,Big Spenders
20529,167,15,3930.75,3,5,5,13,Big Spenders
20530,24,16,2218.81,5,5,4,14,Champions
20531,19,15,1536.85,5,5,3,13,Loyal
20532,48,10,635.02,5,3,1,9,Loyal
20533,152,14,2664.2,3,5,5,13,Big Spenders
20534,124,15,1141.37,4,5,2,11,Loyal
20535,419,7,1815.6999999999998,2,1,4,7,Regulars
20536,357,10,2694.0299999999997,2,3,5,10,Regulars
20537,531,10,630.62,1,3,1,5,Regulars
20538,146,9,1105.88,4,2,2,8,Regulars
20539,185,11,5641.55,3,3,5,11,Big Spenders
20540,261,8,1532.6399999999999,2,2,3,7,Regulars
20541,12,10,2979.1400000000003,5,3,5,13,Loyal
20542,29,8,708.52,5,2,1,8,Regulars
20543,404,4,1465.1599999999999,2,1,3,6,Regulars
20544,203,13,1786.37,3,4,4,11,Big Spenders
20545,133,16,1606.05,4,5,3,12,Loyal
20546,70,9,1627.7800000000002,4,2,3,9,Regulars
20547,864,6,699.84,1,1,1,3,Hibernating
20548,91,8,2697.35,4,2,5,11,Big Spenders
20549,194,15,2103.34,3,5,4,12,Big Spenders
20550,180,13,2720.05,3,4,5,12,Big Spenders
20551,335,8,1491.93,2,2,3,7,Regulars
20552,222,16,3943.0,3,5,5,13,Big Spenders
20553,287,10,1640.76,2,3,3,8,Regulars
20554,65,6,1517.1000000000001,5,1,3,9,Regulars
20555,640,14,3454.88,1,5,5,11,At Risk
20556,767,7,809.79,1,1,1,3,Hibernating
20557,448,6,895.46,2,1,2,5,Hibernating
20558,556,13,1506.93,1,4,3,8,At Risk
20559,407,10,963.8299999999999,2,3,2,7,Regulars
20560,467,11,1148.57,1,3,2,6,Regulars
20561,53,11,1622.8700000000001,5,3,3,11,Loyal
20562,241,6,2652.8,3,1,5,9,Big Spenders
20563,264,10,3193.97,2,3,5,10,Regulars
20564,383,14,4217.01,2,5,5,12,At Risk
20565,89,8,1496.29,4,2,3,9,Regulars
20566,64,11,2041.19,5,3,4,12,Loyal
20567,55,10,902.1400000000001,5,3,2,10,Loyal
20568,38,17,4298.04,5,5,5,15,Champions
20569,19,18,1795.8200000000002,5,5,4,14,Champions
20570,296,7,1080.08,2,1,2,5,Hibernating
20571,6,19,2466.71,5,5,4,14,Champions
20572,349,8,1001.29,2,2,2,6,Hibernating
20573,441,6,681.98,2,1,1,4,Hibernating
20574,1010,4,376.42,1,1,1,3,Hibernating
20575,136,9,792.4599999999999,4,2,1,7,Regulars
20576,552,12,1792.5500000000002,1,4,4,9,At Risk
20577,190,13,2985.08,3,4,5,12,Big Spenders
20578,130,7,1276.58,4,1,3,8,Regulars
20579,0,8,2436.0,5,2,4,11,Big Spenders
20580,79,14,2919.63,4,5,5,14,Champions
20581,698,14,2676.34,1,5,5,11,At Risk
20582,110,15,2040.08,4,5,4,13,Champions
20583,97,12,3034.58,4,4,5,13,Champions
20584,354,7,623.68,2,1,1,4,Hibernating
20585,7,13,1726.6100000000001,5,4,4,13,Champions
20586,43,14,1303.0900000000001,5,5,3,13,Loyal
20587,22,15,1846.69,5,5,4,14,Champions
20588,97,9,769.95,4,2,1,7,Regulars
20589,35,16,5029.51,5,5,5,15,Champions
20590,310,11,1532.01,2,3,3,8,Regulars
20591,23,11,3493.6699999999996,5,3,5,13,Loyal
20592,526,14,1345.01,1,5,3,9,At Risk
20593,90,14,2396.94,4,5,4,13,Champions
20594,137,10,3093.17,4,3,5,12,Loyal
20595,160,11,1316.0,3,3,3,9,Regulars
20596,165,7,931.46,3,1,2,6,Regulars
20597,445,7,1132.76,2,1,2,5,Hibernating
20598,174,7,679.15,3,1,1,5,Regulars
20599,56,11,842.5,5,3,1,9,Loyal
20600,88,11,2719.77,4,3,5,12,Loyal
20601,276,13,1093.15,2,4,2,8,At Risk
20602,371,9,773.3499999999999,2,2,1,5,Hibernating
20603,89,14,2068.41,4,5,4,13,Champions
20604,15,9,2032.9699999999998,5,2,4,11,Big Spenders
20605,49,10,3094.9300000000003,5,3,5,13,Loyal
20606,19,10,1419.3400000000001,5,3,3,11,Loyal
20607,279,12,1203.84,2,4,2,8,At Risk
20608,441,11,4525.28,2,3,5,10,Regulars
20609,571,9,811.34,1,2,1,4,Hibernating
20610,62,14,1476.43,5,5,3,13,Loyal
20611,290,12,1469.43,2,4,3,9,At Risk
20612,171,7,1217.24,3,1,2,6,Regulars
20613,168,11,2912.41,3,3,5,11,Big Spenders
20614,95,1,82.84,4,1,1,6,Regulars
20615,290,15,3048.84,2,5,5,12,At Risk
20616,164,6,628.35,3,1,1,5,Regulars
20617,374,14,3515.99,2,5,5,12,At Risk
20618,47,17,1863.57,5,5,4,14,Champions
20619,32,13,1385.1499999999999,5,4,3,12,Loyal
20620,520,14,3894.45,1,5,5,11,At Risk
20621,814,7,1138.53,1,1,2,4,Hibernating
20622,1459,7,792.5500000000001,1,1,1,3,Hibernating
20623,183,13,3894.56,3,4,5,12,Big Spenders
20624,195,12,3293.81,3,4,5,12,Big Spenders
20625,486,6,827.92,1,1,1,3,Hibernating
20626,462,9,1657.15,1,2,3,6,Regulars
20627,323,13,1990.65,2,4,4,10,At Risk
20628,6,13,1742.81,5,4,4,13,Champions
20629,1370,5,664.1700000000001,1,1,1,3,Hibernating
20630,268,9,1342.58,2,2,3,7,Regulars
20631,82,12,962.9499999999999,4,4,2,10,Loyal
20632,263,8,826.47,2,2,1,5,Hibernating
20633,514,5,558.19,1,1,1,3,Hibernating
20634,58,9,1414.6,5,2,3,10,Regulars
20635,209,16,1625.66,3,5,3,11,Regulars
20636,441,11,626.88,2,3,1,6,Regulars
20637,1503,4,1377.56,1,1,3,5,Regulars
20638,450,11,1336.85,2,3,3,8,Regulars
20639,182,12,4048.37,3,4,5,12,Big Spenders
20640,33,10,1739.5300000000002,5,3,4,12,Loyal
20641,153,10,1827.92,3,3,4,10,Big Spenders
20642,357,14,1441.56,2,5,3,10,At Risk
20643,878,12,1285.2,1,4,3,8,At Risk
20644,338,10,1384.01,2,3,3,8,Regulars
20645,85,8,741.33,4,2,1,7,Regulars
20646,204,7,1379.18,3,1,3,7,Regulars
20647,297,7,3922.8399999999997,2,1,5,8,Regulars
20648,548,9,1257.45,1,2,3,6,Regulars
20649,425,10,5179.860000000001,2,3,5,10,Regulars
20650,116,17,2834.2200000000003,4,5,5,14,Champions
20651,271,9,1403.27,2,2,3,7,Regulars
20652,392,10,1171.57,2,3,2,7,Regulars
20653,3,14,2687.0699999999997,5,5,5,15,Champions
20654,311,10,1292.81,2,3,3,8,Regulars
20655,490,12,1823.8100000000002,1,4,4,9,At Risk
20656,168,10,956.1800000000001,3,3,2,8,Regulars
20657,467,17,1701.48,1,5,3,9,At Risk
20658,21,15,1777.52,5,5,4,14,Champions
20659,366,10,1743.18,2,3,4,9,Regulars
20660,49,9,1621.56,5,2,3,10,Regulars
20661,264,9,3772.31,2,2,5,9,Regulars
20662,110,12,1477.86,4,4,3,11,Loyal
20663,124,11,1711.42,4,3,3,10,Loyal
20664,45,14,1987.57,5,5,4,14,Champions
20665,634,7,1021.52,1,1,2,4,Hibernating
20666,347,6,718.0400000000001,2,1,1,4,Hibernating
20667,260,11,1735.57,2,3,4,9,Regulars
20668,358,14,621.92,2,5,1,8,At Risk
20669,153,8,1074.99,3,2,2,7,Regulars
20670,505,11,984.5799999999999,1,3,2,6,Regulars
20671,111,18,3072.85,4,5,5,14,Champions
20672,431,10,613.78,2,3,1,6,Regulars
20673,39,15,3470.03,5,5,5,15,Champions
20674,566,5,737.49,1,1,1,3,Hibernating
20675,103,9,670.85,4,2,1,7,Regulars
20676,58,13,1688.13,5,4,3,12,Loyal
20677,6,13,1978.08,5,4,4,13,Champions
20678,474,6,1978.8600000000001,1,1,4,6,Regulars
20679,116,5,1184.23,4,1,2,7,Regulars
20680,101,5,369.03,4,1,1,6,Regulars
20681,88,12,1681.37,4,4,3,11,Loyal
20682,166,8,470.20000000000005,3,2,1,6,Regulars
20683,111,14,1245.05,4,5,3,12,Loyal
20684,147,14,2653.03,4,5,5,14,Champions
20685,521,5,744.19,1,1,1,3,Hibernating
20686,78,10,848.53,4,3,2,9,Loyal
20687,629,8,1138.79,1,2,2,5,Hibernating
20688,125,13,2062.81,4,4,4,12,Champions
20689,568,6,643.91,1,1,1,3,Hibernating
20690,318,10,1281.76,2,3,3,8,Regulars
20691,239,9,770.37,3,2,1,6,Regulars
20692,205,7,1867.5,3,1,4,8,Big Spenders
20693,121,12,1732.2599999999998,4,4,4,12,Champions
20694,523,9,840.38,1,2,1,4,Hibernating
20695,12,8,1769.0100000000002,5,2,4,11,Big Spenders
20696,99,4,182.44,4,1,1,6,Regulars
20697,104,14,1730.55,4,5,4,13,Champions
20698,37,13,1399.44,5,4,3,12,Loyal
20699,406,11,735.53,2,3,1,6,Regulars
20700,179,15,1801.62,3,5,4,12,Big Spenders
20701,13,9,782.18,5,2,1,8,Regulars
20702,31,9,2389.9500000000003,5,2,4,11,Big Spenders
20703,55,16,2223.86,5,5,4,14,Champions
20704,185,9,1060.09,3,2,2,7,Regulars
20705,368,15,2781.72,2,5,5,12,At Risk
20706,44,14,1704.98,5,5,3,13,Loyal
20707,141,17,4846.54,4,5,5,14,Champions
20708,127,8,755.98,4,2,1,7,Regulars
20709,39,7,2687.2700000000004,5,1,5,11,Big Spenders
20710,467,6,357.44,1,1,1,3,Hibernating
20711,156,16,2016.97,3,5,4,12,Big Spenders
20712,201,8,707.8199999999999,3,2,1,6,Regulars
20713,473,7,3509.16,1,1,5,7,Regulars
20714,39,7,793.93,5,1,1,7,Regulars
20715,231,14,2455.8199999999997,3,5,4,12,Big Spenders
20716,9,15,2173.56,5,5,4,14,Champions
20717,88,9,1083.04,4,2,2,8,Regulars
20718,397,10,1081.3999999999999,2,3,2,7,Regulars
20719,9,13,1376.78,5,4,3,12,Loyal
20720,298,11,1484.75,2,3,3,8,Regulars
20721,1457,4,1860.3,1,1,4,6,Regulars
20722,349,9,523.88,2,2,1,5,Hibernating
20723,931,7,766.4200000000001,1,1,1,3,Hibernating
20724,171,6,1262.19,3,1,3,7,Regulars
20725,514,9,556.48,1,2,1,4,Hibernating
20726,255,11,4922.88,2,3,5,10,Regulars
20727,51,14,1573.02,5,5,3,13,Loyal
20728,403,10,2907.71,2,3,5,10,Regulars
20729,295,15,3703.18,2,5,5,12,At Risk
20730,379,9,3140.92,2,2,5,9,Regulars
20731,76,9,725.0,4,2,1,7,Regulars
20732,36,15,2761.8,5,5,5,15,Champions
20733,287,9,618.36,2,2,1,5,Hibernating
20734,15,5,891.03,5,1,2,8,Regulars
20735,90,13,2534.91,4,4,4,12,Champions
20736,5,10,916.23,5,3,2,10,Loyal
20737,163,13,3104.15,3,4,5,12,Big Spenders
20738,126,11,2711.31,4,3,5,12,Loyal
20739,78,4,295.07,4,1,1,6,Regulars
20740,218,12,1397.6599999999999,3,4,3,10,Regulars
20741,164,8,808.97,3,2,1,6,Regulars
20742,178,11,1147.28,3,3,2,8,Regulars
20743,250,14,1424.05,2,5,3,10,At Risk
20744,1005,7,1276.93,1,1,3,5,Regulars
20745,175,14,2088.93,3,5,4,12,Big Spenders
20746,475,12,1409.3799999999999,1,4,3,8,At Risk
20747,27,7,1024.15,5,1,2,8,Regulars
20748,227,11,2892.39,3,3,5,11,Big Spenders
20749,83,12,785.27,4,4,1,9,Loyal
20750,168,7,1687.58,3,1,3,7,Regulars
20751,243,16,2043.5800000000002,3,5,4,12,Big Spenders
20752,285,11,919.51,2,3,2,7,Regulars
20753,177,10,2939.91,3,3,5,11,Big Spenders
20754,127,9,3299.6400000000003,4,2,5,11,Big Spenders
20755,279,13,2364.65,2,4,4,10,At Risk
20756,248,12,989.49,2,4,2,8,At Risk
20757,295,5,670.6400000000001,2,1,1,4,Hibernating
20758,145,3,248.14000000000001,4,1,1,6,Regulars
20759,153,11,845.55,3,3,2,8,Regulars
20760,990,11,1407.8700000000001,1,3,3,7,Regulars
20761,99,7,498.93,4,1,1,6,Regulars
20762,509,10,4085.5300000000007,1,3,5,9,Regulars
20763,726,2,216.4,1,1,1,3,Hibernating
20764,196,12,1279.38,3,4,3,10,Regulars
20765,116,8,729.0699999999999,4,2,1,7,Regulars
20766,214,15,3053.11,3,5,5,13,Big Spenders
20767,612,10,1557.11,1,3,3,7,Regulars
20768,336,11,1786.99,2,3,4,9,Regulars
20769,274,14,2778.88,2,5,5,12,At Risk
20770,330,10,1195.92,2,3,2,7,Regulars
20771,109,16,1014.13,4,5,2,11,Loyal
20772,23,10,992.37,5,3,2,10,Loyal
20773,464,10,4240.11,1,3,5,9,Regulars
20774,75,12,2251.38,4,4,4,12,Champions
20775,182,10,1194.01,3,3,2,8,Regulars
20776,209,8,710.68,3,2,1,6,Regulars
20777,190,11,1233.4,3,3,2,8,Regulars
20778,792,9,942.33,1,2,2,5,Hibernating
20779,497,16,1592.2,1,5,3,9,At Risk
20780,58,12,698.77,5,4,1,10,Loyal
20781,707,6,1049.0,1,1,2,4,Hibernating
20782,48,11,1366.1,5,3,3,11,Loyal
20783,830,9,787.92,1,2,1,4,Hibernating
20784,175,12,1253.23,3,4,3,10,Regulars
20785,1052,9,1033.21,1,2,2,5,Hibernating
20786,228,19,3675.0899999999997,3,5,5,13,Big Spenders
20787,93,8,1006.08,4,2,2,8,Regulars
20788,797,5,609.99,1,1,1,3,Hibernating
20789,289,8,793.56,2,2,1,5,Hibernating
20790,609,6,3616.2200000000003,1,1,5,7,Regulars
20791,618,4,488.69,1,1,1,3,Hibernating
20792,315,7,789.4,2,1,1,4,Hibernating
20793,97,12,3102.68,4,4,5,13,Champions
20794,630,13,987.73,1,4,2,7,At Risk
20795,390,12,1762.63,2,4,4,10,At Risk
20796,414,8,939.01,2,2,2,6,Hibernating
20797,1042,7,917.71,1,1,2,4,Hibernating
20798,362,10,485.21999999999997,2,3,1,6,Regulars
20799,122,12,4111.860000000001,4,4,5,13,Champions
20800,340,8,1489.03,2,2,3,7,Regulars
20801,203,9,817.87,3,2,1,6,Regulars
20802,454,7,1500.9699999999998,2,1,3,6,Regulars
20803,188,9,1647.1200000000001,3,2,3,8,Regulars
20804,138,12,1626.48,4,4,3,11,Loyal
20805,897,7,787.7900000000001,1,1,1,3,Hibernating
20806,4,11,1412.33,5,3,3,11,Loyal
20807,331,18,3120.31,2,5,5,12,At Risk
20808,1,19,4858.0199999999995,5,5,5,15,Champions
20809,162,12,2485.87,3,4,4,11,Big Spenders
20810,409,14,1544.61,2,5,3,10,At Risk
20811,619,10,5046.46,1,3,5,9,Regulars
20812,261,9,1177.51,2,2,2,6,Hibernating
20813,1161,7,884.03,1,1,2,4,Hibernating
20814,602,8,802.3499999999999,1,2,1,4,Hibernating
20815,65,12,1882.73,5,4,4,13,Champions
20816,156,7,1252.19,3,1,3,7,Regulars
20817,485,9,4118.79,1,2,5,8,Regulars
20818,15,9,1189.96,5,2,2,9,Regulars
20819,248,14,1520.68,2,5,3,10,At Risk
20820,30,8,1257.52,5,2,3,10,Regulars
20821,213,9,1001.52,3,2,2,7,Regulars
20822,141,12,2279.42,4,4,4,12,Champions
20823,39,12,1306.6599999999999,5,4,3,12,Loyal
20824,610,11,2893.79,1,3,5,9,Regulars
20825,370,11,1536.02,2,3,3,8,Regulars
20826,105,19,2659.69,4,5,5,14,Champions
20827,32,15,1235.69,5,5,2,12,Loyal
20828,585,11,1381.4,1,3,3,7,Regulars
20829,194,13,2266.6,3,4,4,11,Big Spenders
20830,199,7,419.37,3,1,1,5,Regulars
20831,164,14,1020.22,3,5,2,10,Regulars
20832,276,9,1030.4,2,2,2,6,Hibernating
20833,6,14,2230.07,5,5,4,14,Champions
20834,785,10,2337.9700000000003,1,3,4,8,Regulars
20835,698,5,699.9200000000001,1,1,1,3,Hibernating
20836,61,10,1131.81,5,3,2,10,Loyal
20837,48,10,3136.48,5,3,5,13,Loyal
20838,111,13,1421.11,4,4,3,11,Loyal
20839,129,9,1882.47,4,2,4,10,Big Spenders
20840,187,8,974.16,3,2,2,7,Regulars
20841,258,11,2845.85,2,3,5,10,Regulars
20842,181,11,1931.14,3,3,4,10,Big Spenders
20843,150,8,935.76,3,2,2,7,Regulars
20844,283,8,358.65,2,2,1,5,Hibernating
20845,434,4,357.04999999999995,2,1,1,4,Hibernating
20846,57,7,651.95,5,1,1,7,Regulars
20847,319,7,925.8299999999999,2,1,2,5,Hibernating
20848,240,5,423.8,3,1,1,5,Regulars
20849,461,10,1086.9499999999998,1,3,2,6,Regulars
20850,357,12,3442.44,2,4,5,11,At Risk
20851,497,7,645.65,1,1,1,3,Hibernating
20852,33,15,6494.0,5,5,5,15,Champions
20853,582,10,1242.88,1,3,3,7,Regulars
20854,34,10,1383.17,5,3,3,11,Loyal
20855,195,7,767.76,3,1,1,5,Regulars
20856,145,9,3886.7400000000002,4,2,5,11,Big Spenders
20857,103,11,881.3000000000001,4,3,2,9,Loyal
20858,582,11,2060.72,1,3,4,8,Regulars
20859,231,10,1845.38,3,3,4,10,Big Spenders
20860,386,11,2796.97,2,3,5,10,Regulars
20861,206,13,4032.3900000000003,3,4,5,12,Big Spenders
20862,108,13,3894.7000000000003,4,4,5,13,Champions
20863,751,11,1878.5900000000001,1,3,4,8,Regulars
20864,196,8,779.54,3,2,1,6,Regulars
20865,139,13,4714.84,4,4,5,13,Champions
20866,146,15,2810.79,4,5,5,14,Champions
20867,67,12,779.18,4,4,1,9,Loyal
20868,47,7,933.77,5,1,2,8,Regulars
20869,1,9,1721.21,5,2,3,10,Regulars
20870,41,13,3587.79,5,4,5,14,Champions
20871,63,8,1293.71,5,2,3,10,Regulars
20872,173,8,2622.4300000000003,3,2,5,10,Big Spenders
20873,101,9,1373.56,4,2,3,9,Regulars
20874,967,9,1622.6599999999999,1,2,3,6,Regulars
20875,51,6,481.97999999999996,5,1,1,7,Regulars
20876,482,10,1689.65,1,3,3,7,Regulars
20877,306,8,3289.7999999999997,2,2,5,9,Regulars
20878,230,8,535.1800000000001,3,2,1,6,Regulars
20879,132,9,3232.21,4,2,5,11,Big Spenders
20880,125,12,1757.23,4,4,4,12,Champions
20881,181,8,632.67,3,2,1,6,Regulars
20882,630,14,2596.96,1,5,5,11,At Risk
20883,24,13,2889.24,5,4,5,14,Champions
20884,380,9,757.3100000000001,2,2,1,5,Hibernating
20885,35,14,1858.15,5,5,4,14,Champions
20886,122,11,4501.53,4,3,5,12,Loyal
20887,195,17,2505.67,3,5,4,12,Big Spenders
20888,183,12,1481.15,3,4,3,10,Regulars
20889,284,14,1425.32,2,5,3,10,At Risk
20890,193,16,1811.18,3,5,4,12,Big Spenders
20891,148,17,2049.92,3,5,4,12,Big Spenders
20892,207,4,170.94000000000005,3,1,1,5,Regulars
20893,97,6,815.38,4,1,1,6,Regulars
20894,552,9,2452.75,1,2,4,7,Regulars
20895,254,9,2990.97,2,2,5,9,Regulars
20896,133,8,437.09999999999997,4,2,1,7,Regulars
20897,18,5,896.76,5,1,2,8,Regulars
20898,232,10,2292.4799999999996,3,3,4,10,Big Spenders
20899,325,8,627.46,2,2,1,5,Hibernating
20900,166,15,1400.3500000000001,3,5,3,11,Regulars
20901,57,11,973.89,5,3,2,10,Loyal
20902,303,10,1272.55,2,3,3,8,Regulars
20903,595,2,341.21,1,1,1,3,Hibernating
20904,123,12,1767.32,4,4,4,12,Champions
20905,54,6,937.09,5,1,2,8,Regulars
20906,96,9,1399.81,4,2,3,9,Regulars
20907,59,16,3409.0000000000005,5,5,5,15,Champions
20908,638,9,1442.71,1,2,3,6,Regulars
20909,571,13,1251.9,1,4,3,8,At Risk
20910,1698,5,351.43,1,1,1,3,Hibernating
20911,385,17,2344.3500000000004,2,5,4,11,At Risk
20912,293,8,2090.57,2,2,4,8,Regulars
20913,384,8,1288.75,2,2,3,7,Regulars
20914,291,7,1747.8000000000002,2,1,4,7,Regulars
20915,293,10,1549.64,2,3,3,8,Regulars
20916,375,10,931.38,2,3,2,7,Regulars
20917,188,10,3684.62,3,3,5,11,Big Spenders
20918,432,9,1728.61,2,2,4,8,Regulars
20919,12,7,2167.2000000000003,5,1,4,10,Big Spenders
20920,20,13,1971.75,5,4,4,13,Champions
20921,6,11,4192.16,5,3,5,13,Loyal
20922,716,11,1353.1299999999999,1,3,3,7,Regulars
20923,567,8,3096.6,1,2,5,8,Regulars
20924,213,13,1551.85,3,4,3,10,Regulars
20925,432,7,1079.3999999999999,2,1,2,5,Hibernating
20926,0,15,1990.71,5,5,4,14,Champions
20927,313,14,3755.23,2,5,5,12,At Risk
20928,3,9,1804.06,5,2,4,11,Big Spenders
20929,301,10,2582.17,2,3,5,10,Regulars
20930,148,20,3162.88,3,5,5,13,Big Spenders
20931,669,8,662.97,1,2,1,4,Hibernating
20932,207,11,1739.44,3,3,4,10,Big Spenders
20933,123,13,1213.44,4,4,2,10,Loyal
20934,64,12,1586.65,5,4,3,12,Loyal
20935,1350,5,323.94,1,1,1,3,Hibernating
20936,937,5,729.38,1,1,1,3,Hibernating
20937,242,17,1557.79,3,5,3,11,Regulars
20938,225,3,379.88,3,1,1,5,Regulars
20939,630,9,1664.4399999999998,1,2,3,6,Regulars
20940,214,5,816.69,3,1,1,5,Regulars
20941,27,17,4040.54,5,5,5,15,Champions
20942,18,7,3176.74,5,1,5,11,Big Spenders
20943,131,17,1642.19,4,5,3,12,Loyal
20944,78,8,3546.3399999999997,4,2,5,11,Big Spenders
20945,210,14,4806.43,3,5,5,13,Big Spenders
20946,880,5,786.84,1,1,1,3,Hibernating
20947,25,11,3767.21,5,3,5,13,Loyal
20948,20,8,1246.6,5,2,3,10,Regulars
20949,252,6,536.07,2,1,1,4,Hibernating
20950,270,14,1729.8700000000001,2,5,4,11,At Risk
20951,60,11,4141.969999999999,5,3,5,13,Loyal
20952,122,15,2972.95,4,5,5,14,Champions
20953,268,5,430.94,2,1,1,4,Hibernating
20954,92,6,1769.02,4,1,4,9,Big Spenders
20955,54,13,1212.5,5,4,2,11,Loyal
20956,392,12,1540.32,2,4,3,9,At Risk
20957,33,7,641.3000000000001,5,1,1,7,Regulars
20958,599,12,3557.8900000000003,1,4,5,10,At Risk
20959,128,6,654.0799999999999,4,1,1,6,Regulars
20960,598,12,4080.62,1,4,5,10,At Risk
20961,184,9,1496.94,3,2,3,8,Regulars
20962,578,6,1370.5499999999997,1,1,3,5,Regulars
20963,154,11,1833.6100000000001,3,3,4,10,Big Spenders
20964,442,12,2041.4599999999998,2,4,4,10,At Risk
20965,301,10,2868.79,2,3,5,10,Regulars
20966,239,10,3923.9100000000003,3,3,5,11,Big Spenders
20967,80,7,1295.96,4,1,3,8,Regulars
20968,121,9,1140.73,4,2,2,8,Regulars
20969,228,11,912.04,3,3,2,8,Regulars
20970,595,6,759.31,1,1,1,3,Hibernating
20971,400,17,6493.469999999999,2,5,5,12,At Risk
20972,119,11,2606.66,4,3,5,12,Loyal
20973,788,5,1018.26,1,1,2,4,Hibernating
20974,65,14,1894.54,5,5,4,14,Champions
20975,243,6,683.78,3,1,1,5,Regulars
20976,206,12,1171.28,3,4,2,9,Regulars
20977,454,4,353.52,2,1,1,4,Hibernating
20978,953,7,2753.34,1,1,5,7,Regulars
20979,248,12,1866.5400000000002,2,4,4,10,At Risk
20980,156,12,1185.41,3,4,2,9,Regulars
20981,151,11,3585.7599999999998,3,3,5,11,Big Spenders
20982,177,13,2043.58,3,4,4,11,Big Spenders
20983,888,9,900.29,1,2,2,5,Hibernating
20984,217,14,1561.4399999999998,3,5,3,11,Regulars
20985,85,14,1367.07,4,5,3,12,Loyal
20986,98,20,4007.8,4,5,5,14,Champions
20987,559,13,1574.86,1,4,3,8,At Risk
20988,704,8,1208.68,1,2,2,5,Hibernating
20989,280,7,1271.61,2,1,3,6,Regulars
20990,101,6,465.15,4,1,1,6,Regulars
20991,435,10,1171.85,2,3,2,7,Regulars
20992,50,11,2103.28,5,3,4,12,Loyal
20993,160,7,754.79,3,1,1,5,Regulars
20994,21,14,1849.99,5,5,4,14,Champions
20995,499,11,2019.15,1,3,4,8,Regulars
20996,134,14,1977.1699999999998,4,5,4,13,Champions
20997,472,8,912.41,1,2,2,5,Hibernating
20998,1282,10,665.59,1,3,1,5,Regulars
20999,52,15,2632.67,5,5,5,15,Champions
21000,198,6,982.5400000000001,3,1,2,6,Regulars
21001,71,12,1631.45,4,4,3,11,Loyal
21002,188,10,1681.57,3,3,3,9,Regulars
21003,199,12,1569.02,3,4,3,10,Regulars
21004,64,9,1505.89,5,2,3,10,Regulars
21005,130,10,733.0500000000001,4,3,1,8,Loyal
21006,112,11,830.2099999999999,4,3,1,8,Loyal
21007,46,10,1652.99,5,3,3,11,Loyal
21008,306,12,1248.5,2,4,3,9,At Risk
21009,105,9,1543.01,4,2,3,9,Regulars
21010,472,15,1609.3100000000002,1,5,3,9,At Risk
21011,676,9,769.1999999999999,1,2,1,4,Hibernating
21012,149,7,389.76,3,1,1,5,Regulars
21013,219,7,703.33,3,1,1,5,Regulars
21014,323,13,1875.4,2,4,4,10,At Risk
21015,106,8,1760.97,4,2,4,10,Big Spenders
21016,4,12,1124.48,5,4,2,11,Loyal
21017,33,10,1073.26,5,3,2,10,Loyal
21018,128,11,3796.42,4,3,5,12,Loyal
21019,87,11,1915.6299999999999,4,3,4,11,Loyal
21020,147,6,283.57,4,1,1,6,Regulars
21021,451,1,21.01,2,1,1,4,Hibernating
21022,563,12,2022.34,1,4,4,9,At Risk
21023,46,9,651.1899999999999,5,2,1,8,Regulars
21024,150,13,1181.86,3,4,2,9,Regulars
21025,73,12,3020.45,4,4,5,13,Champions
21026,90,12,2138.45,4,4,4,12,Champions
21027,361,11,1089.38,2,3,2,7,Regulars
21028,102,14,2750.13,4,5,5,14,Champions
21029,177,10,2767.92,3,3,5,11,Big Spenders
21030,36,13,1141.26,5,4,2,11,Loyal
21031,890,9,840.79,1,2,1,4,Hibernating
21032,236,4,445.28,3,1,1,5,Regulars
21033,123,14,4990.65,4,5,5,14,Champions
21034,233,16,2215.03,3,5,4,12,Big Spenders
21035,55,12,1821.9099999999999,5,4,4,13,Champions
21036,90,14,3220.2599999999998,4,5,5,14,Champions
21037,407,8,610.17,2,2,1,5,Hibernating
21038,605,7,2015.5300000000002,1,1,4,6,Regulars
21039,174,18,5103.67,3,5,5,13,Big Spenders
21040,441,7,448.78,2,1,1,4,Hibernating
21041,457,9,1166.33,2,2,2,6,Hibernating
21042,285,13,952.38,2,4,2,8,At Risk
21043,857,6,728.51,1,1,1,3,Hibernating
21044,391,11,1923.68,2,3,4,9,Regulars
21045,118,11,978.21,4,3,2,9,Loyal
21046,221,12,1305.49,3,4,3,10,Regulars
21047,187,8,880.0300000000001,3,2,2,7,Regulars
21048,35,9,1100.27,5,2,2,9,Regulars
21049,205,9,1166.3,3,2,2,7,Regulars
21050,132,8,2121.0699999999997,4,2,4,10,Big Spenders
21051,618,10,737.47,1,3,1,5,Regulars
21052,172,10,1453.16,3,3,3,9,Regulars
21053,1008,10,1406.9899999999998,1,3,3,7,Regulars
21054,60,11,1132.14,5,3,2,10,Loyal
21055,521,13,1559.95,1,4,3,8,At Risk
21056,384,12,1529.96,2,4,3,9,At Risk
21057,171,11,1379.48,3,3,3,9,Regulars
21058,104,13,2464.08,4,4,4,12,Champions
21059,244,7,762.66,3,1,1,5,Regulars
21060,111,9,2301.14,4,2,4,10,Big Spenders
21061,135,11,2020.0099999999998,4,3,4,11,Loyal
21062,131,10,816.66,4,3,1,8,Loyal
21063,66,10,1491.94,4,3,3,10,Loyal
21064,71,9,1120.99,4,2,2,8,Regulars
21065,61,10,640.1700000000001,5,3,1,9,Loyal
21066,54,18,2075.4,5,5,4,14,Champions
21067,141,15,2447.56,4,5,4,13,Champions
21068,302,11,2291.2,2,3,4,9,Regulars
21069,194,10,1501.1,3,3,3,9,Regulars
21070,355,10,1016.02,2,3,2,7,Regulars
21071,458,9,836.24,2,2,1,5,Hibernating
21072,798,11,700.5,1,3,1,5,Regulars
21073,9,6,878.44,5,1,2,8,Regulars
21074,488,5,636.4000000000001,1,1,1,3,Hibernating
21075,195,10,2026.75,3,3,4,10,Big Spenders
21076,292,11,1477.15,2,3,3,8,Regulars
21077,75,9,4692.58,4,2,5,11,Big Spenders
21078,197,5,932.09,3,1,2,6,Regulars
21079,20,9,493.91,5,2,1,8,Regulars
21080,52,9,1179.98,5,2,2,9,Regulars
21081,25,8,1548.97,5,2,3,10,Regulars
21082,1109,5,694.45,1,1,1,3,Hibernating
21083,61,13,4328.86,5,4,5,14,Champions
21084,129,12,3587.35,4,4,5,13,Champions
21085,151,14,2396.18,3,5,4,12,Big Spenders
21086,199,11,1744.73,3,3,4,10,Big Spenders
21087,180,9,941.73,3,2,2,7,Regulars
21088,181,7,517.98,3,1,1,5,Regulars
21089,285,13,3252.7400000000002,2,4,5,11,At Risk
21090,274,9,2701.67,2,2,5,9,Regulars
21091,45,11,1082.44,5,3,2,10,Loyal
21092,149,8,3386.18,3,2,5,10,Big Spenders
21093,134,13,3135.13,4,4,5,13,Champions
21094,15,12,603.15,5,4,1,10,Loyal
21095,388,4,310.01,2,1,1,4,Hibernating
21096,17,8,905.84,5,2,2,9,Regulars
21097,53,16,3182.98,5,5,5,15,Champions
21098,171,10,2107.36,3,3,4,10,Big Spenders
21099,376,15,1829.01,2,5,4,11,At Risk
21100,65,16,1888.22,5,5,4,14,Champions
21101,243,7,3337.62,3,1,5,9,Big Spenders
21102,448,15,1352.24,2,5,3,10,At Risk
21103,54,9,763.6,5,2,1,8,Regulars
21104,281,6,2766.7000000000003,2,1,5,8,Regulars
21105,17,16,3398.0800000000004,5,5,5,15,Champions
21106,151,13,1783.52,3,4,4,11,Big Spenders
21107,71,14,3462.8,4,5,5,14,Champions
21108,418,22,2470.88,2,5,4,11,At Risk
21109,55,8,884.75,5,2,2,9,Regulars
21110,321,15,3448.6600000000003,2,5,5,12,At Risk
21111,552,8,2418.96,1,2,4,7,Regulars
21112,162,8,1401.53,3,2,3,8,Regulars
21113,454,9,524.18,2,2,1,5,Hibernating
21114,113,9,913.4599999999999,4,2,2,8,Regulars
21115,100,16,5472.7,4,5,5,14,Champions
21116,147,9,3161.13,4,2,5,11,Big Spenders
21117,325,7,810.9100000000001,2,1,1,4,Hibernating
21118,296,13,1717.93,2,4,3,9,At Risk
21119,20,5,616.85,5,1,1,7,Regulars
21120,688,7,444.55,1,1,1,3,Hibernating
21121,350,4,275.69,2,1,1,4,Hibernating
21122,419,8,1172.73,2,2,2,6,Hibernating
21123,30,17,1745.95,5,5,4,14,Champions
21124,289,5,489.21,2,1,1,4,Hibernating
21125,301,11,1669.3899999999999,2,3,3,8,Regulars
21126,220,13,4916.94,3,4,5,12,Big Spenders
21127,342,8,1838.1299999999999,2,2,4,8,Regulars
21128,237,10,888.37,3,3,2,8,Regulars
21129,152,9,529.44,3,2,1,6,Regulars
21130,209,7,1063.9,3,1,2,6,Regulars
21131,40,11,1465.9,5,3,3,11,Loyal
21132,138,11,966.12,4,3,2,9,Loyal
21133,145,12,1701.96,4,4,3,11,Loyal
21134,287,10,1471.8400000000001,2,3,3,8,Regulars
21135,438,11,763.58,2,3,1,6,Regulars
21136,560,9,1676.56,1,2,3,6,Regulars
21137,407,16,1669.1100000000001,2,5,3,10,At Risk
21138,911,7,1734.3899999999999,1,1,4,6,Regulars
21139,56,12,1660.42,5,4,3,12,Loyal
21140,765,4,286.29999999999995,1,1,1,3,Hibernating
21141,307,10,1133.24,2,3,2,7,Regulars
21142,161,15,4165.87,3,5,5,13,Big Spenders
21143,25,12,3024.18,5,4,5,14,Champions
21144,7,14,758.3199999999999,5,5,1,11,Loyal
21145,162,9,686.02,3,2,1,6,Regulars
21146,564,17,1965.3500000000001,1,5,4,10,At Risk
21147,21,4,140.65,5,1,1,7,Regulars
21148,246,11,2893.7700000000004,3,3,5,11,Big Spenders
21149,172,8,999.46,3,2,2,7,Regulars
21150,606,11,2218.86,1,3,4,8,Regulars
21151,151,8,3274.0699999999997,3,2,5,10,Big Spenders
21152,305,9,682.6800000000001,2,2,1,5,Hibernating
21153,51,11,1442.57,5,3,3,11,Loyal
21154,223,16,2906.79,3,5,5,13,Big Spenders
21155,661,7,701.47,1,1,1,3,Hibernating
21156,1085,5,2014.84,1,1,4,6,Regulars
21157,177,19,1691.35,3,5,3,11,Regulars
21158,583,8,612.53,1,2,1,4,Hibernating
21159,220,17,1905.27,3,5,4,12,Big Spenders
21160,761,9,1502.11,1,2,3,6,Regulars
21161,43,11,1208.19,5,3,2,10,Loyal
21162,255,13,3746.3700000000003,2,4,5,11,At Risk
21163,770,9,1056.48,1,2,2,5,Hibernating
21164,186,11,673.32,3,3,1,7,Regulars
21165,354,12,3459.5499999999997,2,4,5,11,At Risk
21166,95,7,615.37,4,1,1,6,Regulars
21167,54,9,4063.52,5,2,5,12,Big Spenders
21168,146,10,2119.37,4,3,4,11,Loyal
21169,355,5,385.22,2,1,1,4,Hibernating
21170,102,11,1330.1399999999999,4,3,3,10,Loyal
21171,46,10,2528.81,5,3,4,12,Loyal
21172,615,12,1168.6399999999999,1,4,2,7,At Risk
21173,285,6,463.06,2,1,1,4,Hibernating
21174,42,14,1417.19,5,5,3,13,Loyal
21175,250,13,2495.54,2,4,4,10,At Risk
21176,835,6,362.3,1,1,1,3,Hibernating
21177,566,10,2169.3,1,3,4,8,Regulars
21178,181,10,2143.7599999999998,3,3,4,10,Big Spenders
21179,203,8,2399.18,3,2,4,9,Big Spenders
21180,1215,7,727.95,1,1,1,3,Hibernating
21181,349,9,1218.62,2,2,2,6,Hibernating
21182,671,13,1260.46,1,4,3,8,At Risk
21183,218,9,2372.2400000000002,3,2,4,9,Big Spenders
21184,42,8,2471.23,5,2,4,11,Big Spenders
21185,298,6,1512.44,2,1,3,6,Regulars
21186,138,10,833.77,4,3,1,8,Loyal
21187,198,10,2047.9199999999998,3,3,4,10,Big Spenders
21188,156,7,926.63,3,1,2,6,Regulars
21189,223,14,1384.02,3,5,3,11,Regulars
21190,637,5,261.85,1,1,1,3,Hibernating
21191,8,11,1163.8,5,3,2,10,Loyal
21192,819,4,1305.3000000000002,1,1,3,5,Regulars
21193,34,8,432.53000000000003,5,2,1,8,Regulars
21194,199,13,1393.6399999999999,3,4,3,10,Regulars
21195,467,9,720.15,1,2,1,4,Hibernating
21196,341,10,3553.13,2,3,5,10,Regulars
21197,244,11,1355.65,3,3,3,9,Regulars
21198,69,9,1152.45,4,2,2,8,Regulars
21199,35,9,1809.04,5,2,4,11,Big Spenders
21200,479,11,1534.81,1,3,3,7,Regulars
21201,89,14,3924.7799999999997,4,5,5,14,Champions
21202,216,4,1900.55,3,1,4,8,Big Spenders
21203,139,7,547.83,4,1,1,6,Regulars
21204,218,8,1078.8400000000001,3,2,2,7,Regulars
21205,153,15,2742.8,3,5,5,13,Big Spenders
21206,55,9,498.64,5,2,1,8,Regulars
21207,404,16,3233.21,2,5,5,12,At Risk
21208,158,8,1365.3000000000002,3,2,3,8,Regulars
21209,171,13,2685.4500000000003,3,4,5,12,Big Spenders
21210,561,10,1836.6100000000001,1,3,4,8,Regulars
21211,117,12,1623.99,4,4,3,11,Loyal
21212,792,8,412.18,1,2,1,4,Hibernating
21213,113,4,3425.46,4,1,5,10,Big Spenders
21214,331,14,1428.58,2,5,3,10,At Risk
21215,369,12,1073.29,2,4,2,8,At Risk
21216,20,13,2443.72,5,4,4,13,Champions
21217,54,10,2683.04,5,3,5,13,Loyal
21218,119,7,1385.3600000000001,4,1,3,8,Regulars
21219,127,13,1143.47,4,4,2,10,Loyal
21220,678,9,4466.74,1,2,5,8,Regulars
21221,249,11,1890.14,2,3,4,9,Regulars
21222,650,5,475.14000000000004,1,1,1,3,Hibernating
21223,493,15,2766.8,1,5,5,11,At Risk
21224,23,11,1156.83,5,3,2,10,Loyal
21225,281,11,2360.79,2,3,4,9,Regulars
21226,238,9,2489.62,3,2,4,9,Big Spenders
21227,160,12,3130.2,3,4,5,12,Big Spenders
21228,466,7,948.52,1,1,2,4,Hibernating
21229,73,8,1577.27,4,2,3,9,Regulars
21230,720,4,1132.1499999999999,1,1,2,4,Hibernating
21231,207,9,921.94,3,2,2,7,Regulars
21232,31,14,1583.8400000000001,5,5,3,13,Loyal
21233,73,9,3424.7400000000002,4,2,5,11,Big Spenders
21234,51,12,1330.87,5,4,3,12,Loyal
21235,425,7,462.89,2,1,1,4,Hibernating
21236,217,11,1820.5200000000002,3,3,4,10,Big Spenders
21237,162,10,2310.4300000000003,3,3,4,10,Big Spenders
21238,40,5,801.76,5,1,1,7,Regulars
21239,293,11,1241.6000000000001,2,3,3,8,Regulars
21240,26,8,1812.45,5,2,4,11,Big Spenders
21241,1331,3,264.26,1,1,1,3,Hibernating
21242,426,2,779.68,2,1,1,4,Hibernating
21243,452,12,3272.5699999999997,2,4,5,11,At Risk
21244,158,12,2679.08,3,4,5,12,Big Spenders
21245,1337,4,1609.9800000000002,1,1,3,5,Regulars
21246,636,12,2221.9900000000002,1,4,4,9,At Risk
21247,23,13,2025.16,5,4,4,13,Champions
21248,418,7,734.08,2,1,1,4,Hibernating
21249,105,14,2563.01,4,5,4,13,Champions
21250,332,5,761.34,2,1,1,4,Hibernating
21251,6,12,1575.64,5,4,3,12,Loyal
21252,303,11,1082.33,2,3,2,7,Regulars
21253,104,8,1215.21,4,2,2,8,Regulars
21254,709,5,453.47,1,1,1,3,Hibernating
21255,209,12,2670.92,3,4,5,12,Big Spenders
21256,304,10,983.86,2,3,2,7,Regulars
21257,78,13,1164.8,4,4,2,10,Loyal
21258,878,6,750.45,1,1,1,3,Hibernating
21259,245,9,1985.12,3,2,4,9,Big Spenders
21260,0,10,1825.5300000000002,5,3,4,12,Loyal
21261,90,12,3285.2699999999995,4,4,5,13,Champions
21262,615,8,610.51,1,2,1,4,Hibernating
21263,523,9,2757.7,1,2,5,8,Regulars
21264,1077,7,2361.86,1,1,4,6,Regulars
21265,81,11,1524.01,4,3,3,10,Loyal
21266,530,9,1310.87,1,2,3,6,Regulars
21267,124,8,1121.94,4,2,2,8,Regulars
21268,203,7,1443.31,3,1,3,7,Regulars
21269,119,11,835.6600000000001,4,3,1,8,Loyal
21270,186,7,978.49,3,1,2,6,Regulars
21271,1296,5,1433.43,1,1,3,5,Regulars
21272,204,12,5757.51,3,4,5,12,Big Spenders
21273,94,11,2475.2400000000002,4,3,4,11,Loyal
21274,128,14,870.74,4,5,2,11,Loyal
21275,229,14,1455.66,3,5,3,11,Regulars
21276,262,9,1070.8500000000001,2,2,2,6,Hibernating
21277,874,3,910.3,1,1,2,4,Hibernating
21278,253,13,3509.67,2,4,5,11,At Risk
21279,369,8,915.39,2,2,2,6,Hibernating
21280,26,8,1360.59,5,2,3,10,Regulars
21281,301,12,1182.4,2,4,2,8,At Risk
21282,28,7,2477.91,5,1,4,10,Big Spenders
21283,531,13,1771.5,1,4,4,9,At Risk
21284,141,10,706.37,4,3,1,8,Loyal
21285,3,5,645.37,5,1,1,7,Regulars
21286,406,5,515.22,2,1,1,4,Hibernating
21287,195,7,1055.93,3,1,2,6,Regulars
21288,73,8,1940.85,4,2,4,10,Big Spenders
21289,1007,5,1601.98,1,1,3,5,Regulars
21290,157,15,5198.31,3,5,5,13,Big Spenders
21291,28,7,976.3599999999999,5,1,2,8,Regulars
21292,556,17,2552.09,1,5,4,10,At Risk
21293,60,12,1045.69,5,4,2,11,Loyal
21294,376,10,1285.46,2,3,3,8,Regulars
21295,279,12,1726.4099999999999,2,4,4,10,At Risk
21296,305,10,2100.66,2,3,4,9,Regulars
21297,210,7,1031.43,3,1,2,6,Regulars
21298,14,13,4009.83,5,4,5,14,Champions
21299,963,7,2508.69,1,1,4,6,Regulars
21300,207,9,867.6700000000001,3,2,2,7,Regulars
21301,55,9,1178.62,5,2,2,9,Regulars
21302,341,12,806.05,2,4,1,7,At Risk
21303,125,8,3928.38,4,2,5,11,Big Spenders
21304,160,7,1116.06,3,1,2,6,Regulars
21305,62,9,615.83,5,2,1,8,Regulars
21306,122,14,2130.65,4,5,4,13,Champions
21307,617,11,2559.4500000000003,1,3,4,8,Regulars
21308,305,9,3932.8399999999997,2,2,5,9,Regulars
21309,14,12,3526.98,5,4,5,14,Champions
21310,253,8,1025.41,2,2,2,6,Hibernating
21311,939,10,1390.76,1,3,3,7,Regulars
21312,268,8,3175.37,2,2,5,9,Regulars
21313,215,15,4813.79,3,5,5,13,Big Spenders
21314,345,2,86.16,2,1,1,4,Hibernating
21315,71,10,1842.25,4,3,4,11,Loyal
21316,34,12,2992.01,5,4,5,14,Champions
21317,90,13,2802.1099999999997,4,4,5,13,Champions
21318,364,10,4122.83,2,3,5,10,Regulars
21319,566,8,2166.33,1,2,4,7,Regulars
21320,880,6,326.75,1,1,1,3,Hibernating
21321,183,9,777.12,3,2,1,6,Regulars
21322,76,12,2509.94,4,4,4,12,Champions
21323,28,11,2289.6299999999997,5,3,4,12,Loyal
21324,48,9,1217.79,5,2,2,9,Regulars
21325,12,8,687.19,5,2,1,8,Regulars
21326,166,12,2260.5,3,4,4,11,Big Spenders
21327,68,9,2002.16,4,2,4,10,Big Spenders
21328,935,12,2226.94,1,4,4,9,At Risk
21329,375,9,1174.38,2,2,2,6,Hibernating
21330,179,10,1846.8400000000001,3,3,4,10,Big Spenders
21331,261,9,959.6700000000001,2,2,2,6,Hibernating
21332,218,8,1408.25,3,2,3,8,Regulars
21333,1211,7,2875.8,1,1,5,7,Regulars
21334,534,7,550.05,1,1,1,3,Hibernating
21335,274,11,1389.95,2,3,3,8,Regulars
21336,117,10,2139.95,4,3,4,11,Loyal
21337,80,10,2586.9199999999996,4,3,5,12,Loyal
21338,61,12,998.83,5,4,2,11,Loyal
21339,511,4,533.0699999999999,1,1,1,3,Hibernating
21340,22,13,3411.92,5,4,5,14,Champions
21341,109,14,2014.82,4,5,4,13,Champions
21342,16,14,2068.27,5,5,4,14,Champions
21343,88,12,2364.85,4,4,4,12,Champions
21344,30,9,1016.88,5,2,2,9,Regulars
21345,80,10,2240.5299999999997,4,3,4,11,Loyal
21346,216,9,1231.3899999999999,3,2,2,7,Regulars
21347,841,8,1236.35,1,2,2,5,Hibernating
21348,126,10,1182.76,4,3,2,9,Loyal
21349,617,8,2244.41,1,2,4,7,Regulars
21350,762,6,600.5500000000001,1,1,1,3,Hibernating
21351,295,5,980.94,2,1,2,5,Hibernating
21352,183,6,898.5,3,1,2,6,Regulars
21353,104,7,581.4300000000001,4,1,1,6,Regulars
21354,264,15,1857.55,2,5,4,11,At Risk
21355,33,17,3705.23,5,5,5,15,Champions
21356,61,8,873.57,5,2,2,9,Regulars
21357,727,12,3466.84,1,4,5,10,At Risk
21358,523,5,241.7,1,1,1,3,Hibernating
21359,103,9,1021.4300000000001,4,2,2,8,Regulars
21360,790,10,1015.5600000000001,1,3,2,6,Regulars
21361,65,10,735.3,5,3,1,9,Loyal
21362,385,10,822.85,2,3,1,6,Regulars
21363,15,10,1201.5000000000002,5,3,2,10,Loyal
21364,282,10,1373.45,2,3,3,8,Regulars
21365,2,7,1144.05,5,1,2,8,Regulars
21366,373,10,3815.5600000000004,2,3,5,10,Regulars
21367,443,5,869.91,2,1,2,5,Hibernating
21368,360,5,812.04,2,1,1,4,Hibernating
21369,21,11,2154.98,5,3,4,12,Loyal
21370,261,10,565.49,2,3,1,6,Regulars
21371,107,11,758.17,4,3,1,8,Loyal
21372,38,7,591.3,5,1,1,7,Regulars
21373,152,7,890.26,3,1,2,6,Regulars
21374,585,7,817.03,1,1,1,3,Hibernating
21375,27,11,4947.97,5,3,5,13,Loyal
21376,8,12,1737.47,5,4,4,13,Champions
21377,38,9,785.86,5,2,1,8,Regulars
21378,356,12,1698.09,2,4,3,9,At Risk
21379,362,10,1541.35,2,3,3,8,Regulars
21380,408,14,2153.36,2,5,4,11,At Risk
21381,26,14,2956.91,5,5,5,15,Champions
21382,26,16,2181.95,5,5,4,14,Champions
21383,158,11,660.13,3,3,1,7,Regulars
21384,1431,3,63.44,1,1,1,3,Hibernating
21385,20,15,4294.93,5,5,5,15,Champions
21386,34,12,1162.59,5,4,2,11,Loyal
21387,0,7,3146.99,5,1,5,11,Big Spenders
21388,303,12,3846.8,2,4,5,11,At Risk
21389,222,9,2990.18,3,2,5,10,Big Spenders
21390,251,10,5192.630000000001,2,3,5,10,Regulars
21391,305,4,371.09,2,1,1,4,Hibernating
21392,610,7,1129.84,1,1,2,4,Hibernating
21393,349,9,1512.8,2,2,3,7,Regulars
21394,83,10,1167.84,4,3,2,9,Loyal
21395,0,13,1257.36,5,4,3,12,Loyal
21396,54,7,1234.9499999999998,5,1,2,8,Regulars
21397,408,12,1962.49,2,4,4,10,At Risk
21398,29,19,3421.0099999999998,5,5,5,15,Champions
21399,243,13,3280.5,3,4,5,12,Big Spenders
21400,680,13,5329.320000000001,1,4,5,10,At Risk
21401,422,13,1438.3600000000001,2,4,3,9,At Risk
21402,73,15,1977.54,4,5,4,13,Champions
21403,808,8,558.34,1,2,1,4,Hibernating
21404,627,9,5343.339999999999,1,2,5,8,Regulars
21405,63,20,2817.84,5,5,5,15,Champions
21406,16,14,3029.01,5,5,5,15,Champions
21407,114,15,4458.43,4,5,5,14,Champions
21408,49,11,1193.1100000000001,5,3,2,10,Loyal
21409,117,6,420.79,4,1,1,6,Regulars
21410,32,9,999.13,5,2,2,9,Regulars
21411,439,10,488.59999999999997,2,3,1,6,Regulars
21412,197,12,6388.67,3,4,5,12,Big Spenders
21413,41,14,1894.69,5,5,4,14,Champions
21414,89,8,1032.62,4,2,2,8,Regulars
21415,92,6,526.44,4,1,1,6,Regulars
21416,1031,4,439.84,1,1,1,3,Hibernating
21417,2,8,1650.4,5,2,3,10,Regulars
21418,22,12,1376.14,5,4,3,12,Loyal
21419,81,12,1899.78,4,4,4,12,Champions
21420,229,12,1872.07,3,4,4,11,Big Spenders
21421,1189,7,589.39,1,1,1,3,Hibernating
21422,207,11,952.8,3,3,2,8,Regulars
21423,120,15,1994.51,4,5,4,13,Champions
21424,245,9,3481.08,3,2,5,10,Big Spenders
21425,48,13,1611.47,5,4,3,12,Loyal
21426,564,9,870.7,1,2,2,5,Hibernating
21427,6,12,1213.9,5,4,2,11,Loyal
21428,54,9,628.56,5,2,1,8,Regulars
21429,56,17,1612.42,5,5,3,13,Loyal
21430,178,8,801.71,3,2,1,6,Regulars
21431,9,14,7965.47,5,5,5,15,Champions
21432,408,12,1295.3,2,4,3,9,At Risk
21433,755,7,652.0500000000001,1,1,1,3,Hibernating
21434,329,12,2452.85,2,4,4,10,At Risk
21435,15,11,1691.1200000000001,5,3,3,11,Loyal
21436,31,4,364.79,5,1,1,7,Regulars
21437,114,16,2408.42,4,5,4,13,Champions
21438,118,6,623.48,4,1,1,6,Regulars
21439,151,14,1067.01,3,5,2,10,Regulars
21440,97,6,1214.54,4,1,2,7,Regulars
21441,594,10,1760.02,1,3,4,8,Regulars
21442,121,9,1591.97,4,2,3,9,Regulars
21443,43,9,1408.17,5,2,3,10,Regulars
21444,59,12,4314.88,5,4,5,14,Champions
21445,205,8,1304.08,3,2,3,8,Regulars
21446,125,12,2598.3900000000003,4,4,5,13,Champions
21447,14,12,2175.71,5,4,4,13,Champions
21448,101,12,1866.37,4,4,4,12,Champions
21449,701,10,1098.24,1,3,2,6,Regulars
21450,267,10,3860.46,2,3,5,10,Regulars
21451,101,11,957.52,4,3,2,9,Loyal
21452,751,8,652.66,1,2,1,4,Hibernating
21453,89,13,2178.01,4,4,4,12,Champions
21454,29,11,1428.01,5,3,3,11,Loyal
21455,243,12,983.08,3,4,2,9,Regulars
21456,292,8,544.86,2,2,1,5,Hibernating
21457,133,9,663.54,4,2,1,7,Regulars
21458,488,12,1985.45,1,4,4,9,At Risk
21459,156,11,1973.22,3,3,4,10,Big Spenders
21460,232,11,1936.48,3,3,4,10,Big Spenders
21461,292,12,1550.45,2,4,3,9,At Risk
21462,285,5,866.56,2,1,2,5,Hibernating
21463,350,14,2106.59,2,5,4,11,At Risk
21464,205,7,402.79,3,1,1,5,Regulars
21465,231,7,411.54999999999995,3,1,1,5,Regulars
21466,14,11,3404.34,5,3,5,13,Loyal
21467,517,13,3231.7999999999997,1,4,5,10,At Risk
21468,936,8,1102.77,1,2,2,5,Hibernating
21469,107,14,3749.86,4,5,5,14,Champions
21470,31,18,3146.67,5,5,5,15,Champions
21471,238,6,499.53,3,1,1,5,Regulars
21472,4,13,3419.2799999999997,5,4,5,14,Champions
21473,453,12,1829.6699999999998,2,4,4,10,At Risk
21474,202,15,1340.8899999999999,3,5,3,11,Regulars
21475,533,6,521.44,1,1,1,3,Hibernating
21476,345,8,2675.8900000000003,2,2,5,9,Regulars
21477,173,7,859.21,3,1,2,6,Regulars
21478,112,8,732.01,4,2,1,7,Regulars
21479,101,7,1300.73,4,1,3,8,Regulars
21480,110,14,2334.46,4,5,4,13,Champions
21481,139,10,901.73,4,3,2,9,Loyal
21482,120,5,573.78,4,1,1,6,Regulars
21483,180,7,1226.1,3,1,2,6,Regulars
21484,312,9,860.96,2,2,2,6,Hibernating
21485,226,6,310.43,3,1,1,5,Regulars
21486,548,10,2592.3399999999997,1,3,5,9,Regulars
21487,5,12,2856.33,5,4,5,14,Champions
21488,129,15,2762.77,4,5,5,14,Champions
21489,227,11,2189.47,3,3,4,10,Big Spenders
21490,491,5,423.18,1,1,1,3,Hibernating
21491,79,15,852.3,4,5,2,11,Loyal
21492,70,12,1625.29,4,4,3,11,Loyal
21493,775,8,1070.9099999999999,1,2,2,5,Hibernating
21494,62,18,1647.65,5,5,3,13,Loyal
21495,202,13,3149.07,3,4,5,12,Big Spenders
21496,90,15,2431.91,4,5,4,13,Champions
21497,287,9,927.7,2,2,2,6,Hibernating
21498,91,14,1962.04,4,5,4,13,Champions
21499,616,10,1328.56,1,3,3,7,Regulars
21500,312,7,596.84,2,1,1,4,Hibernating
21501,83,9,626.99,4,2,1,7,Regulars
21502,34,14,5007.94,5,5,5,15,Champions
21503,172,8,901.76,3,2,2,7,Regulars
21504,239,8,770.3399999999999,3,2,1,6,Regulars
21505,403,8,1175.8,2,2,2,6,Hibernating
21506,141,9,4050.81,4,2,5,11,Big Spenders
21507,83,9,2175.06,4,2,4,10,Big Spenders
21508,170,7,2452.09,3,1,4,8,Big Spenders
21509,404,7,646.06,2,1,1,4,Hibernating
21510,261,9,4544.71,2,2,5,9,Regulars
21511,206,9,2152.24,3,2,4,9,Big Spenders
21512,752,4,335.37,1,1,1,3,Hibernating
21513,556,9,1557.78,1,2,3,6,Regulars
21514,83,11,2726.51,4,3,5,12,Loyal
21515,555,11,774.99,1,3,1,5,Regulars
21516,271,9,1104.69,2,2,2,6,Hibernating
21517,99,13,2919.44,4,4,5,13,Champions
21518,239,7,2824.25,3,1,5,9,Big Spenders
21519,37,13,1762.02,5,4,4,13,Champions
21520,261,10,870.21,2,3,2,7,Regulars
21521,80,11,2792.53,4,3,5,12,Loyal
21522,98,7,452.42,4,1,1,6,Regulars
21523,224,13,3379.96,3,4,5,12,Big Spenders
21524,250,12,1177.66,2,4,2,8,At Risk
21525,274,9,2024.55,2,2,4,8,Regulars
21526,474,10,1164.9099999999999,1,3,2,6,Regulars
21527,477,8,454.71000000000004,1,2,1,4,Hibernating
21528,647,6,429.84,1,1,1,3,Hibernating
21529,7,18,3654.8999999999996,5,5,5,15,Champions
21530,38,8,872.9000000000001,5,2,2,9,Regulars
21531,211,8,1465.0800000000002,3,2,3,8,Regulars
21532,93,10,751.3000000000001,4,3,1,8,Loyal
21533,273,7,1420.89,2,1,3,6,Regulars
21534,921,5,792.38,1,1,1,3,Hibernating
21535,523,13,1988.19,1,4,4,9,At Risk
21536,299,15,1296.9,2,5,3,10,At Risk
21537,60,13,2006.01,5,4,4,13,Champions
21538,108,9,1457.68,4,2,3,9,Regulars
21539,144,9,1085.21,4,2,2,8,Regulars
21540,904,5,271.09000000000003,1,1,1,3,Hibernating
21541,132,15,2054.27,4,5,4,13,Champions
21542,68,16,3367.0,4,5,5,14,Champions
21543,40,8,2605.4700000000003,5,2,5,12,Big Spenders
21544,397,8,1221.91,2,2,2,6,Hibernating
21545,22,10,3508.71,5,3,5,13,Loyal
21546,63,15,1446.4099999999999,5,5,3,13,Loyal
21547,79,11,1090.63,4,3,2,9,Loyal
21548,151,5,682.87,3,1,1,5,Regulars
21549,506,10,658.55,1,3,1,5,Regulars
21550,127,9,978.12,4,2,2,8,Regulars
21551,21,7,1154.98,5,1,2,8,Regulars
21552,17,12,1587.3400000000001,5,4,3,12,Loyal
21553,129,15,1946.59,4,5,4,13,Champions
21554,60,9,682.21,5,2,1,8,Regulars
21555,581,7,1515.39,1,1,3,5,Regulars
21556,10,8,568.83,5,2,1,8,Regulars
21557,258,12,1674.1599999999999,2,4,3,9,At Risk
21558,147,13,1488.9099999999999,4,4,3,11,Loyal
21559,120,18,3305.34,4,5,5,14,Champions
21560,80,11,813.66,4,3,1,8,Loyal
21561,209,14,2835.32,3,5,5,13,Big Spenders
21562,47,13,7782.87,5,4,5,14,Champions
21563,270,7,1177.53,2,1,2,5,Hibernating
21564,116,11,2563.7599999999998,4,3,4,11,Loyal
21565,113,14,1889.71,4,5,4,13,Champions
21566,89,6,2884.05,4,1,5,10,Big Spenders
21567,275,14,2221.98,2,5,4,11,At Risk
21568,12,11,2077.91,5,3,4,12,Loyal
21569,481,13,1034.8999999999999,1,4,2,7,At Risk
21570,70,14,2445.03,4,5,4,13,Champions
21571,9,11,976.1699999999998,5,3,2,10,Loyal
21572,949,8,3276.9499999999994,1,2,5,8,Regulars
21573,167,8,1258.6699999999998,3,2,3,8,Regulars
21574,718,9,1717.1699999999998,1,2,3,6,Regulars
21575,162,8,1048.44,3,2,2,7,Regulars
21576,132,12,1912.76,4,4,4,12,Champions
21577,826,7,270.98,1,1,1,3,Hibernating
21578,817,9,981.68,1,2,2,5,Hibernating
21579,789,8,948.98,1,2,2,5,Hibernating
21580,463,11,1432.88,1,3,3,7,Regulars
21581,607,8,667.14,1,2,1,4,Hibernating
21582,46,9,3524.93,5,2,5,12,Big Spenders
21583,145,12,1547.36,4,4,3,11,Loyal
21584,62,12,2435.98,5,4,4,13,Champions
21585,1680,7,1254.7399999999998,1,1,3,5,Regulars
21586,247,13,944.92,3,4,2,9,Regulars
21587,97,10,3101.2599999999998,4,3,5,12,Loyal
21588,68,20,3148.08,4,5,5,14,Champions
21589,47,6,470.22,5,1,1,7,Regulars
21590,18,14,2423.74,5,5,4,14,Champions
21591,131,13,1854.5,4,4,4,12,Champions
21592,24,14,3576.41,5,5,5,15,Champions
21593,118,6,425.28,4,1,1,6,Regulars
21594,12,6,753.36,5,1,1,7,Regulars
21595,485,9,4677.31,1,2,5,8,Regulars
21596,118,6,509.25,4,1,1,6,Regulars
21597,55,8,1298.28,5,2,3,10,Regulars
21598,166,8,578.25,3,2,1,6,Regulars
21599,61,10,967.96,5,3,2,10,Loyal
21600,72,13,1173.3600000000001,4,4,2,10,Loyal
21601,145,9,2949.6,4,2,5,11,Big Spenders
21602,247,10,2849.97,3,3,5,11,Big Spenders
21603,381,8,1261.52,2,2,3,7,Regulars
21604,29,13,2654.33,5,4,5,14,Champions
21605,90,8,2185.6200000000003,4,2,4,10,Big Spenders
21606,264,17,1507.22,2,5,3,10,At Risk
21607,34,14,4165.49,5,5,5,15,Champions
21608,629,9,513.4,1,2,1,4,Hibernating
21609,143,15,1550.32,4,5,3,12,Loyal
21610,14,13,2921.44,5,4,5,14,Champions
21611,119,9,1868.05,4,2,4,10,Big Spenders
21612,1125,2,1368.0,1,1,3,5,Regulars
21613,62,8,1319.71,5,2,3,10,Regulars
21614,9,16,1818.8200000000002,5,5,4,14,Champions
21615,803,6,742.63,1,1,1,3,Hibernating
21616,247,7,2458.08,3,1,4,8,Big Spenders
21617,418,12,570.09,2,4,1,7,At Risk
21618,352,11,1457.17,2,3,3,8,Regulars
21619,248,9,1046.8,2,2,2,6,Hibernating
21620,156,7,375.95,3,1,1,5,Regulars
21621,160,6,768.0699999999999,3,1,1,5,Regulars
21622,42,14,3296.97,5,5,5,15,Champions
21623,6,12,924.5,5,4,2,11,Loyal
21624,144,14,3493.8300000000004,4,5,5,14,Champions
21625,156,14,3843.87,3,5,5,13,Big Spenders
21626,130,11,1069.24,4,3,2,9,Loyal
21627,385,9,2776.81,2,2,5,9,Regulars
21628,480,12,1370.69,1,4,3,8,At Risk
21629,211,8,994.8299999999999,3,2,2,7,Regulars
21630,133,10,4040.2200000000003,4,3,5,12,Loyal
21631,156,13,1989.67,3,4,4,11,Big Spenders
21632,231,8,569.3299999999999,3,2,1,6,Regulars
21633,14,6,1420.06,5,1,3,9,Regulars
21634,50,15,2184.2400000000002,5,5,4,14,Champions
21635,270,8,1144.07,2,2,2,6,Hibernating
21636,29,11,1601.67,5,3,3,11,Loyal
21637,502,7,1013.44,1,1,2,4,Hibernating
21638,78,9,1694.9,4,2,3,9,Regulars
21639,174,11,2402.71,3,3,4,10,Big Spenders
21640,523,10,1621.8,1,3,3,7,Regulars
21641,293,9,1180.5,2,2,2,6,Hibernating
21642,227,10,1634.05,3,3,3,9,Regulars
21643,21,14,932.14,5,5,2,12,Loyal
21644,197,12,1583.54,3,4,3,10,Regulars
21645,450,8,734.47,2,2,1,5,Hibernating
21646,193,11,2427.7,3,3,4,10,Big Spenders
21647,14,11,3470.75,5,3,5,13,Loyal
21648,103,16,2405.07,4,5,4,13,Champions
21649,212,16,1381.04,3,5,3,11,Regulars
21650,417,10,4450.43,2,3,5,10,Regulars
21651,7,8,1804.46,5,2,4,11,Big Spenders
21652,122,11,772.9699999999999,4,3,1,8,Loyal
21653,284,14,5134.929999999999,2,5,5,12,At Risk
21654,844,8,719.35,1,2,1,4,Hibernating
21655,35,11,2129.96,5,3,4,12,Loyal
21656,200,10,990.94,3,3,2,8,Regulars
21657,543,17,2462.83,1,5,4,10,At Risk
21658,236,8,762.1600000000001,3,2,1,6,Regulars
21659,150,12,1376.83,3,4,3,10,Regulars
21660,220,9,4048.37,3,2,5,10,Big Spenders
21661,29,11,746.76,5,3,1,9,Loyal
21662,688,3,1950.6100000000001,1,1,4,6,Regulars
21663,389,10,1518.56,2,3,3,8,Regulars
21664,538,8,1394.1399999999999,1,2,3,6,Regulars
21665,42,10,801.39,5,3,1,9,Loyal
21666,567,10,3888.3500000000004,1,3,5,9,Regulars
21667,773,6,241.76,1,1,1,3,Hibernating
21668,418,6,1163.04,2,1,2,5,Hibernating
21669,432,12,1656.45,2,4,3,9,At Risk
21670,662,12,2003.63,1,4,4,9,At Risk
21671,85,7,436.03,4,1,1,6,Regulars
21672,173,11,1385.2800000000002,3,3,3,9,Regulars
21673,126,12,2399.3799999999997,4,4,4,12,Champions
21674,734,7,799.69,1,1,1,3,Hibernating
21675,610,11,2669.35,1,3,5,9,Regulars
21676,396,8,814.4200000000001,2,2,1,5,Hibernating
21677,39,13,2447.28,5,4,4,13,Champions
21678,85,16,1589.3,4,5,3,12,Loyal
21679,188,11,1267.1100000000001,3,3,3,9,Regulars
21680,266,14,1802.8799999999999,2,5,4,11,At Risk
21681,193,10,1890.07,3,3,4,10,Big Spenders
21682,11,5,984.72,5,1,2,8,Regulars
21683,614,10,1400.4299999999998,1,3,3,7,Regulars
21684,157,7,1194.29,3,1,2,6,Regulars
21685,338,12,943.55,2,4,2,8,At Risk
21686,15,16,1275.47,5,5,3,13,Loyal
21687,318,12,1676.4299999999998,2,4,3,9,At Risk
21688,107,12,3494.55,4,4,5,13,Champions
21689,429,8,617.6700000000001,2,2,1,5,Hibernating
21690,157,12,1861.51,3,4,4,11,Big Spenders
21691,79,12,1110.54,4,4,2,10,Loyal
21692,6,13,4804.62,5,4,5,14,Champions
21693,35,11,1295.68,5,3,3,11,Loyal
21694,33,12,2102.22,5,4,4,13,Champions
21695,193,15,1584.35,3,5,3,11,Regulars
21696,192,11,4461.7300000000005,3,3,5,11,Big Spenders
21697,127,9,532.86,4,2,1,7,Regulars
21698,108,12,1826.31,4,4,4,12,Champions
21699,489,7,302.46,1,1,1,3,Hibernating
21700,187,10,428.59999999999997,3,3,1,7,Regulars
21701,54,12,1453.3300000000002,5,4,3,12,Loyal
21702,154,13,3164.69,3,4,5,12,Big Spenders
21703,94,11,2937.91,4,3,5,12,Loyal
21704,519,15,2442.93,1,5,4,10,At Risk
21705,117,14,2652.87,4,5,5,14,Champions
21706,2,12,1909.07,5,4,4,13,Champions
21707,18,8,1043.34,5,2,2,9,Regulars
21708,165,11,976.25,3,3,2,8,Regulars
21709,55,15,3052.21,5,5,5,15,Champions
21710,416,8,2230.58,2,2,4,8,Regulars
21711,432,6,1152.33,2,1,2,5,Hibernating
21712,68,13,1775.8899999999999,4,4,4,12,Champions
21713,593,3,251.54999999999998,1,1,1,3,Hibernating
21714,429,13,4418.76,2,4,5,11,At Risk
21715,205,8,2457.6,3,2,4,9,Big Spenders
21716,224,8,933.94,3,2,2,7,Regulars
21717,284,3,328.99,2,1,1,4,Hibernating
21718,539,10,4172.41,1,3,5,9,Regulars
21719,643,8,1262.92,1,2,3,6,Regulars
21720,257,11,994.6299999999999,2,3,2,7,Regulars
21721,199,14,1405.49,3,5,3,11,Regulars
21722,81,8,1563.27,4,2,3,9,Regulars
21723,166,11,1866.21,3,3,4,10,Big Spenders
21724,124,4,478.59,4,1,1,6,Regulars
21725,111,10,1543.55,4,3,3,10,Loyal
21726,345,12,2101.27,2,4,4,10,At Risk
21727,187,11,1665.04,3,3,3,9,Regulars
21728,58,11,3830.0299999999997,5,3,5,13,Loyal
21729,11,9,932.8699999999999,5,2,2,9,Regulars
21730,116,10,2215.95,4,3,4,11,Loyal
21731,260,9,2076.38,2,2,4,8,Regulars
21732,224,8,1103.54,3,2,2,7,Regulars
21733,505,5,593.83,1,1,1,3,Hibernating
21734,889,9,795.41,1,2,1,4,Hibernating
21735,453,4,366.47999999999996,2,1,1,4,Hibernating
21736,83,8,808.73,4,2,1,7,Regulars
21737,95,8,1595.3300000000002,4,2,3,9,Regulars
21738,23,5,1607.36,5,1,3,9,Regulars
21739,369,13,1930.46,2,4,4,10,At Risk
21740,213,9,1485.54,3,2,3,8,Regulars
21741,467,4,663.59,1,1,1,3,Hibernating
21742,243,6,458.31,3,1,1,5,Regulars
21743,841,8,983.55,1,2,2,5,Hibernating
21744,347,11,1474.67,2,3,3,8,Regulars
21745,46,10,735.92,5,3,1,9,Loyal
21746,32,13,3882.66,5,4,5,14,Champions
21747,199,12,1349.8500000000001,3,4,3,10,Regulars
21748,186,7,2851.0,3,1,5,9,Big Spenders
21749,395,8,1406.05,2,2,3,7,Regulars
21750,210,8,2640.7,3,2,5,10,Big Spenders
21751,495,10,721.71,1,3,1,5,Regulars
21752,21,14,3853.85,5,5,5,15,Champions
21753,29,8,753.94,5,2,1,8,Regulars
21754,168,12,2336.99,3,4,4,11,Big Spenders
21755,263,11,1695.14,2,3,3,8,Regulars
21756,95,9,2492.69,4,2,4,10,Big Spenders
21757,247,14,1374.28,3,5,3,11,Regulars
21758,484,7,596.1,1,1,1,3,Hibernating
21759,261,4,368.89,2,1,1,4,Hibernating
21760,440,6,2031.8799999999999,2,1,4,7,Regulars
21761,195,8,3813.4199999999996,3,2,5,10,Big Spenders
21762,25,8,794.99,5,2,1,8,Regulars
21763,159,10,1375.66,3,3,3,9,Regulars
21764,266,7,2723.43,2,1,5,8,Regulars
21765,1135,4,677.46,1,1,1,3,Hibernating
21766,123,16,2926.6,4,5,5,14,Champions
21767,108,8,3963.0700000000006,4,2,5,11,Big Spenders
21768,72,13,1561.58,4,4,3,11,Loyal
21769,25,13,1888.9199999999998,5,4,4,13,Champions
21770,109,10,1354.88,4,3,3,10,Loyal
21771,92,5,775.25,4,1,1,6,Regulars
21772,25,13,1419.63,5,4,3,12,Loyal
21773,89,16,3856.8900000000003,4,5,5,14,Champions
21774,540,9,1356.25,1,2,3,6,Regulars
21775,962,9,1998.17,1,2,4,7,Regulars
21776,791,3,305.73,1,1,1,3,Hibernating
21777,577,8,1992.6499999999999,1,2,4,7,Regulars
21778,125,12,3230.68,4,4,5,13,Champions
21779,254,8,583.29,2,2,1,5,Hibernating
21780,28,13,1553.8700000000001,5,4,3,12,Loyal
21781,432,8,2216.87,2,2,4,8,Regulars
21782,655,7,2990.330000000001,1,1,5,7,Regulars
21783,179,13,2090.17,3,4,4,11,Big Spenders
21784,268,13,9186.640000000001,2,4,5,11,At Risk
21785,10,12,1772.58,5,4,4,13,Champions
21786,103,7,2607.4300000000003,4,1,5,10,Big Spenders
21787,206,14,3990.36,3,5,5,13,Big Spenders
21788,204,8,851.37,3,2,2,7,Regulars
21789,390,11,1266.6799999999998,2,3,3,8,Regulars
21790,326,4,541.5600000000001,2,1,1,4,Hibernating
21791,133,9,2538.8,4,2,4,10,Big Spenders
21792,161,9,1790.67,3,2,4,9,Big Spenders
21793,484,9,1732.65,1,2,4,7,Regulars
21794,238,6,1779.55,3,1,4,8,Big Spenders
21795,337,8,953.78,2,2,2,6,Hibernating
21796,161,15,2532.9300000000003,3,5,4,12,Big Spenders
21797,133,15,1795.19,4,5,4,13,Champions
21798,300,6,2028.82,2,1,4,7,Regulars
21799,5,9,892.67,5,2,2,9,Regulars
21800,172,5,453.69,3,1,1,5,Regulars
21801,397,11,2193.6,2,3,4,9,Regulars
21802,401,12,2458.08,2,4,4,10,At Risk
21803,293,10,3312.79,2,3,5,10,Regulars
21804,104,13,2513.6,4,4,4,12,Champions
21805,69,8,3232.76,4,2,5,11,Big Spenders
21806,647,10,2026.3999999999999,1,3,4,8,Regulars
21807,4,13,1910.63,5,4,4,13,Champions
21808,132,11,1549.8000000000002,4,3,3,10,Loyal
21809,12,8,997.03,5,2,2,9,Regulars
21810,236,12,1100.59,3,4,2,9,Regulars
21811,107,11,795.2,4,3,1,8,Loyal
21812,55,11,2511.85,5,3,4,12,Loyal
21813,12,9,1076.7199999999998,5,2,2,9,Regulars
21814,157,8,578.72,3,2,1,6,Regulars
21815,140,9,3600.7799999999997,4,2,5,11,Big Spenders
21816,20,4,144.86999999999998,5,1,1,7,Regulars
21817,569,7,688.13,1,1,1,3,Hibernating
21818,88,12,1587.61,4,4,3,11,Loyal
21819,23,12,3157.22,5,4,5,14,Champions
21820,468,10,1641.27,1,3,3,7,Regulars
21821,106,12,1082.19,4,4,2,10,Loyal
21822,18,11,4527.76,5,3,5,13,Loyal
21823,52,12,2019.97,5,4,4,13,Champions
21824,190,8,1855.43,3,2,4,9,Big Spenders
21825,165,12,1861.95,3,4,4,11,Big Spenders
21826,424,4,298.02,2,1,1,4,Hibernating
21827,33,5,1527.57,5,1,3,9,Regulars
21828,40,14,3081.21,5,5,5,15,Champions
21829,497,10,706.47,1,3,1,5,Regulars
21830,542,12,1334.29,1,4,3,8,At Risk
21831,732,10,914.16,1,3,2,6,Regulars
21832,410,7,468.89,2,1,1,4,Hibernating
21833,156,7,2570.36,3,1,4,8,Big Spenders
21834,309,6,2078.65,2,1,4,7,Regulars
21835,218,5,1806.2500000000002,3,1,4,8,Big Spenders
21836,379,5,1087.66,2,1,2,5,Hibernating
21837,15,6,208.29000000000002,5,1,1,7,Regulars
21838,166,12,954.6700000000001,3,4,2,9,Regulars
21839,136,16,1967.76,4,5,4,13,Champions
21840,52,8,1188.58,5,2,2,9,Regulars
21841,79,13,956.4499999999999,4,4,2,10,Loyal
21842,14,6,900.29,5,1,2,8,Regulars
21843,49,18,9886.81,5,5,5,15,Champions
21844,134,13,1537.78,4,4,3,11,Loyal
21845,0,16,2055.27,5,5,4,14,Champions
21846,403,6,1303.5900000000001,2,1,3,6,Regulars
21847,112,9,569.44,4,2,1,7,Regulars
21848,842,9,1614.4700000000003,1,2,3,6,Regulars
21849,166,5,544.37,3,1,1,5,Regulars
21850,471,8,3866.51,1,2,5,8,Regulars
21851,64,16,1664.67,5,5,3,13,Loyal
21852,592,10,593.54,1,3,1,5,Regulars
21853,630,7,742.64,1,1,1,3,Hibernating
21854,74,12,967.48,4,4,2,10,Loyal
21855,409,7,368.11,2,1,1,4,Hibernating
21856,16,7,3165.62,5,1,5,11,Big Spenders
21857,231,10,2182.38,3,3,4,10,Big Spenders
21858,79,8,681.71,4,2,1,7,Regulars
21859,238,8,2727.67,3,2,5,10,Big Spenders
21860,113,10,2925.5099999999998,4,3,5,12,Loyal
21861,530,13,2388.88,1,4,4,9,At Risk
21862,42,6,487.35,5,1,1,7,Regulars
21863,282,15,1234.91,2,5,2,9,At Risk
21864,377,15,2875.65,2,5,5,12,At Risk
21865,29,7,921.76,5,1,2,8,Regulars
21866,468,13,2146.98,1,4,4,9,At Risk
21867,374,7,1043.76,2,1,2,5,Hibernating
21868,489,7,875.84,1,1,2,4,Hibernating
21869,397,13,1551.37,2,4,3,9,At Risk
21870,612,9,760.9300000000001,1,2,1,4,Hibernating
21871,30,11,1221.63,5,3,2,10,Loyal
21872,226,10,559.25,3,3,1,7,Regulars
21873,338,7,3589.77,2,1,5,8,Regulars
21874,43,15,3927.31,5,5,5,15,Champions
21875,148,6,984.66,3,1,2,6,Regulars
21876,513,8,848.19,1,2,2,5,Hibernating
21877,21,10,1868.8500000000001,5,3,4,12,Loyal
21878,181,10,1271.1899999999998,3,3,3,9,Regulars
21879,566,13,1383.46,1,4,3,8,At Risk
21880,167,9,1077.6100000000001,3,2,2,7,Regulars
21881,212,9,1075.66,3,2,2,7,Regulars
21882,932,6,1001.2,1,1,2,4,Hibernating
21883,401,6,580.87,2,1,1,4,Hibernating
21884,418,11,887.54,2,3,2,7,Regulars
21885,61,8,1462.4299999999998,5,2,3,10,Regulars
21886,93,15,2210.46,4,5,4,13,Champions
21887,60,8,1966.03,5,2,4,11,Big Spenders
21888,23,11,1870.38,5,3,4,12,Loyal
21889,334,8,1681.82,2,2,3,7,Regulars
21890,315,13,2968.7000000000003,2,4,5,11,At Risk
21891,35,8,1034.5900000000001,5,2,2,9,Regulars
21892,199,8,857.44,3,2,2,7,Regulars
21893,358,9,553.93,2,2,1,5,Hibernating
21894,12,8,690.79,5,2,1,8,Regulars
21895,96,10,2727.53,4,3,5,12,Loyal
21896,117,6,236.35999999999999,4,1,1,6,Regulars
21897,384,5,2556.73,2,1,4,7,Regulars
21898,517,8,2126.35,1,2,4,7,Regulars
21899,202,14,2693.0,3,5,5,13,Big Spenders
21900,651,12,3067.07,1,4,5,10,At Risk
21901,93,8,793.34,4,2,1,7,Regulars
21902,77,11,1530.11,4,3,3,10,Loyal
21903,39,11,2540.97,5,3,4,12,Loyal
21904,265,12,2139.77,2,4,4,10,At Risk
21905,38,8,1331.69,5,2,3,10,Regulars
21906,219,6,546.1800000000001,3,1,1,5,Regulars
21907,237,20,5089.96,3,5,5,13,Big Spenders
21908,134,12,2587.13,4,4,5,13,Champions
21909,85,9,3913.6699999999996,4,2,5,11,Big Spenders
21910,152,8,2623.8500000000004,3,2,5,10,Big Spenders
21911,250,10,3276.69,2,3,5,10,Regulars
21912,267,11,1447.6200000000001,2,3,3,8,Regulars
21913,121,13,1756.49,4,4,4,12,Champions
21914,518,12,1050.54,1,4,2,7,At Risk
21915,298,6,394.56,2,1,1,4,Hibernating
21916,254,11,2847.1100000000006,2,3,5,10,Regulars
21917,800,12,906.09,1,4,2,7,At Risk
21918,910,5,621.8,1,1,1,3,Hibernating
21919,30,16,2496.2000000000003,5,5,4,14,Champions
21920,800,9,668.28,1,2,1,4,Hibernating
21921,108,8,841.47,4,2,1,7,Regulars
21922,132,9,1188.6,4,2,2,8,Regulars
21923,1673,6,501.48999999999995,1,1,1,3,Hibernating
21924,56,19,5073.599999999999,5,5,5,15,Champions
21925,171,8,825.8499999999999,3,2,1,6,Regulars
21926,128,11,907.67,4,3,2,9,Loyal
21927,8,12,2144.4700000000003,5,4,4,13,Champions
21928,135,11,1423.34,4,3,3,10,Loyal
21929,613,10,865.58,1,3,2,6,Regulars
21930,127,11,1827.81,4,3,4,11,Loyal
21931,119,8,781.6600000000001,4,2,1,7,Regulars
21932,42,10,1770.39,5,3,4,12,Loyal
21933,128,10,4575.92,4,3,5,12,Loyal
21934,229,12,1035.65,3,4,2,9,Regulars
21935,282,6,732.8800000000001,2,1,1,4,Hibernating
21936,228,7,3584.86,3,1,5,9,Big Spenders
21937,17,7,811.0,5,1,1,7,Regulars
21938,452,11,2841.0,2,3,5,10,Regulars
21939,357,12,3766.46,2,4,5,11,At Risk
21940,245,12,1767.1100000000001,3,4,4,11,Big Spenders
21941,452,10,768.76,2,3,1,6,Regulars
21942,829,4,2032.66,1,1,4,6,Regulars
21943,3,15,1138.14,5,5,2,12,Loyal
21944,71,8,706.03,4,2,1,7,Regulars
21945,100,13,3113.49,4,4,5,13,Champions
21946,42,5,334.15,5,1,1,7,Regulars
21947,566,13,989.05,1,4,2,7,At Risk
21948,301,15,5732.32,2,5,5,12,At Risk
21949,733,12,1422.0800000000002,1,4,3,8,At Risk
21950,97,12,1632.81,4,4,3,11,Loyal
21951,525,18,1516.22,1,5,3,9,At Risk
21952,722,6,399.13,1,1,1,3,Hibernating
21953,57,9,1485.65,5,2,3,10,Regulars
21954,197,12,3135.19,3,4,5,12,Big Spenders
21955,370,8,1199.56,2,2,2,6,Hibernating
21956,484,13,928.97,1,4,2,7,At Risk
21957,215,13,4380.8,3,4,5,12,Big Spenders
21958,291,7,834.48,2,1,1,4,Hibernating
21959,213,12,2692.3999999999996,3,4,5,12,Big Spenders
21960,449,6,987.14,2,1,2,5,Hibernating
21961,20,12,1200.05,5,4,2,11,Loyal
21962,410,8,1137.99,2,2,2,6,Hibernating
21963,343,9,1995.6299999999999,2,2,4,8,Regulars
21964,455,9,1634.9,2,2,3,7,Regulars
21965,135,11,730.56,4,3,1,8,Loyal
21966,113,11,1375.74,4,3,3,10,Loyal
21967,113,16,3505.93,4,5,5,14,Champions
21968,971,9,1138.25,1,2,2,5,Hibernating
21969,405,14,2506.94,2,5,4,11,At Risk
21970,744,9,1288.56,1,2,3,6,Regulars
21971,12,7,801.79,5,1,1,7,Regulars
21972,67,9,1576.27,4,2,3,9,Regulars
21973,7,13,1191.15,5,4,2,11,Loyal
21974,174,20,4524.88,3,5,5,13,Big Spenders
21975,197,6,1609.56,3,1,3,7,Regulars
21976,251,12,1043.2,2,4,2,8,At Risk
21977,172,13,1828.26,3,4,4,11,Big Spenders
21978,122,8,1902.2599999999998,4,2,4,10,Big Spenders
21979,61,8,1628.02,5,2,3,10,Regulars
21980,665,8,1362.7,1,2,3,6,Regulars
21981,497,10,1410.63,1,3,3,7,Regulars
21982,550,14,1386.74,1,5,3,9,At Risk
21983,162,14,2699.29,3,5,5,13,Big Spenders
21984,49,11,2055.96,5,3,4,12,Loyal
21985,267,5,647.93,2,1,1,4,Hibernating
21986,274,8,1091.57,2,2,2,6,Hibernating
21987,85,7,2371.34,4,1,4,9,Big Spenders
21988,27,10,3882.01,5,3,5,13,Loyal
21989,887,5,3029.05,1,1,5,7,Regulars
21990,184,14,1495.81,3,5,3,11,Regulars
21991,228,15,3333.5499999999997,3,5,5,13,Big Spenders
21992,229,8,1400.35,3,2,3,8,Regulars
21993,181,6,457.16999999999996,3,1,1,5,Regulars
21994,46,11,1491.37,5,3,3,11,Loyal
21995,230,11,2184.9,3,3,4,10,Big Spenders
21996,170,17,1912.97,3,5,4,12,Big Spenders
21997,430,6,5253.79,2,1,5,8,Regulars
21998,218,11,1489.73,3,3,3,9,Regulars
21999,234,13,2795.79,3,4,5,12,Big Spenders
22000,110,14,2143.57,4,5,4,13,Champions
22001,103,13,1836.13,4,4,4,12,Champions
22002,490,12,2856.81,1,4,5,10,At Risk
22003,278,11,3186.9999999999995,2,3,5,10,Regulars
22004,174,9,910.93,3,2,2,7,Regulars
22005,118,8,1707.6499999999996,4,2,3,9,Regulars
22006,628,10,2376.9700000000003,1,3,4,8,Regulars
22007,281,13,2040.54,2,4,4,10,At Risk
22008,322,8,3460.0299999999997,2,2,5,9,Regulars
22009,191,11,1418.92,3,3,3,9,Regulars
22010,20,10,687.99,5,3,1,9,Loyal
22011,234,11,3307.28,3,3,5,11,Big Spenders
22012,253,11,1672.91,2,3,3,8,Regulars
22013,89,8,3812.87,4,2,5,11,Big Spenders
22014,65,14,2074.86,5,5,4,14,Champions
22015,47,11,1219.91,5,3,2,10,Loyal
22016,70,12,1414.1499999999999,4,4,3,11,Loyal
22017,423,5,717.87,2,1,1,4,Hibernating
22018,61,10,1489.52,5,3,3,11,Loyal
22019,73,8,718.11,4,2,1,7,Regulars
22020,168,10,3502.09,3,3,5,11,Big Spenders
22021,21,7,1052.1000000000001,5,1,2,8,Regulars
22022,100,10,902.16,4,3,2,9,Loyal
22023,383,6,2596.38,2,1,5,8,Regulars
22024,421,14,2789.14,2,5,5,12,At Risk
22025,704,4,149.17000000000002,1,1,1,3,Hibernating
22026,323,13,2198.4700000000003,2,4,4,10,At Risk
22027,268,11,5803.47,2,3,5,10,Regulars
22028,38,8,1561.28,5,2,3,10,Regulars
22029,124,10,820.04,4,3,1,8,Loyal
22030,99,11,1915.81,4,3,4,11,Loyal
22031,290,15,2024.9,2,5,4,11,At Risk
22032,45,12,1253.56,5,4,3,12,Loyal
22033,165,11,3056.4300000000003,3,3,5,11,Big Spenders
22034,495,8,3522.46,1,2,5,8,Regulars
22035,139,12,1493.45,4,4,3,11,Loyal
22036,308,9,3216.2999999999997,2,2,5,9,Regulars
22037,362,10,958.57,2,3,2,7,Regulars
22038,609,11,3449.4,1,3,5,9,Regulars
22039,349,6,684.3299999999999,2,1,1,4,Hibernating
22040,450,6,1110.83,2,1,2,5,Hibernating
22041,1229,10,673.6700000000001,1,3,1,5,Regulars
22042,223,9,781.6800000000001,3,2,1,6,Regulars
22043,53,11,2487.3,5,3,4,12,Loyal
22044,153,7,1681.8600000000001,3,1,3,7,Regulars
22045,119,17,2701.63,4,5,5,14,Champions
22046,23,14,4244.86,5,5,5,15,Champions
22047,89,12,1346.1200000000001,4,4,3,11,Loyal
22048,58,15,2816.7,5,5,5,15,Champions
22049,188,18,1411.8300000000002,3,5,3,11,Regulars
22050,36,8,2671.7599999999998,5,2,5,12,Big Spenders
22051,973,13,1211.84,1,4,2,7,At Risk
22052,497,10,1001.5999999999999,1,3,2,6,Regulars
22053,170,10,4896.870000000001,3,3,5,11,Big Spenders
22054,160,8,501.63,3,2,1,6,Regulars
22055,73,7,1035.5700000000002,4,1,2,7,Regulars
22056,266,12,1102.05,2,4,2,8,At Risk
22057,34,10,2231.14,5,3,4,12,Loyal
22058,153,9,1648.93,3,2,3,8,Regulars
22059,119,10,1911.79,4,3,4,11,Loyal
22060,310,15,2572.17,2,5,4,11,At Risk
22061,686,11,2900.91,1,3,5,9,Regulars
22062,239,9,626.72,3,2,1,6,Regulars
22063,395,6,471.72999999999996,2,1,1,4,Hibernating
22064,624,10,1256.98,1,3,3,7,Regulars
22065,389,4,927.25,2,1,2,5,Hibernating
22066,107,5,510.14,4,1,1,6,Regulars
22067,450,14,1252.09,2,5,3,10,At Risk
22068,66,8,1263.99,4,2,3,9,Regulars
22069,48,7,624.48,5,1,1,7,Regulars
22070,743,7,564.02,1,1,1,3,Hibernating
22071,390,8,589.72,2,2,1,5,Hibernating
22072,794,8,2006.3899999999999,1,2,4,7,Regulars
22073,30,15,1924.75,5,5,4,14,Champions
22074,201,10,1880.3700000000001,3,3,4,10,Big Spenders
22075,26,13,2154.7,5,4,4,13,Champions
22076,206,9,1032.96,3,2,2,7,Regulars
22077,14,10,3498.7400000000002,5,3,5,13,Loyal
22078,346,7,1279.1799999999998,2,1,3,6,Regulars
22079,326,10,626.92,2,3,1,6,Regulars
22080,193,11,2807.5,3,3,5,11,Big Spenders
22081,440,12,3776.6200000000003,2,4,5,11,At Risk
22082,193,9,2219.85,3,2,4,9,Big Spenders
22083,603,9,875.16,1,2,2,5,Hibernating
22084,372,9,1149.1899999999998,2,2,2,6,Hibernating
22085,187,13,3646.94,3,4,5,12,Big Spenders
22086,49,8,2416.38,5,2,4,11,Big Spenders
22087,669,9,1649.49,1,2,3,6,Regulars
22088,54,5,1298.7,5,1,3,9,Regulars
22089,49,10,1539.49,5,3,3,11,Loyal
22090,109,15,2811.5499999999997,4,5,5,14,Champions
22091,90,10,2829.32,4,3,5,12,Loyal
22092,287,6,1652.0600000000002,2,1,3,6,Regulars
22093,525,10,2091.84,1,3,4,8,Regulars
22094,932,7,1432.22,1,1,3,5,Regulars
22095,924,7,754.35,1,1,1,3,Hibernating
22096,34,9,1326.75,5,2,3,10,Regulars
22097,191,18,1841.67,3,5,4,12,Big Spenders
22098,302,9,787.15,2,2,1,5,Hibernating
22099,79,15,3875.1600000000003,4,5,5,14,Champions
22100,166,12,1459.8799999999999,3,4,3,10,Regulars
22101,470,12,1024.96,1,4,2,7,At Risk
22102,168,13,1446.71,3,4,3,10,Regulars
22103,9,9,873.01,5,2,2,9,Regulars
22104,250,8,1575.1,2,2,3,7,Regulars
22105,152,11,2022.0199999999998,3,3,4,10,Big Spenders
22106,879,8,449.29,1,2,1,4,Hibernating
22107,549,12,2208.94,1,4,4,9,At Risk
22108,474,9,1352.99,1,2,3,6,Regulars
22109,118,15,3288.91,4,5,5,14,Champions
22110,502,12,4506.55,1,4,5,10,At Risk
22111,36,14,2285.18,5,5,4,14,Champions
22112,630,5,791.5,1,1,1,3,Hibernating
22113,2,7,414.26,5,1,1,7,Regulars
22114,1336,9,1152.06,1,2,2,5,Hibernating
22115,554,11,1088.52,1,3,2,6,Regulars
22116,118,10,2956.07,4,3,5,12,Loyal
22117,0,12,2016.33,5,4,4,13,Champions
22118,243,11,1811.56,3,3,4,10,Big Spenders
22119,309,14,1163.05,2,5,2,9,At Risk
22120,221,11,2908.74,3,3,5,11,Big Spenders
22121,81,6,1476.34,4,1,3,8,Regulars
22122,772,10,935.06,1,3,2,6,Regulars
22123,149,14,1625.3400000000001,3,5,3,11,Regulars
22124,487,12,2045.6399999999999,1,4,4,9,At Risk
22125,169,8,642.28,3,2,1,6,Regulars
22126,396,8,723.71,2,2,1,5,Hibernating
22127,670,12,2752.96,1,4,5,10,At Risk
22128,343,9,1019.34,2,2,2,6,Hibernating
22129,4,10,936.24,5,3,2,10,Loyal
22130,166,11,4318.969999999999,3,3,5,11,Big Spenders
22131,287,2,205.91000000000003,2,1,1,4,Hibernating
22132,52,7,862.4000000000001,5,1,2,8,Regulars
22133,68,12,1016.27,4,4,2,10,Loyal
22134,264,7,2609.6099999999997,2,1,5,8,Regulars
22135,302,11,1284.26,2,3,3,8,Regulars
22136,131,12,1301.5800000000002,4,4,3,11,Loyal
22137,21,13,1023.3000000000001,5,4,2,11,Loyal
22138,108,13,2475.19,4,4,4,12,Champions
22139,55,7,482.62,5,1,1,7,Regulars
22140,79,13,3596.5,4,4,5,13,Champions
22141,342,11,1915.62,2,3,4,9,Regulars
22142,228,8,1153.49,3,2,2,7,Regulars
22143,259,9,2333.39,2,2,4,8,Regulars
22144,85,14,1571.6000000000001,4,5,3,12,Loyal
22145,46,7,636.64,5,1,1,7,Regulars
22146,192,7,1014.57,3,1,2,6,Regulars
22147,0,16,1598.52,5,5,3,13,Loyal
22148,156,7,489.81,3,1,1,5,Regulars
22149,651,5,817.53,1,1,1,3,Hibernating
22150,161,11,1134.95,3,3,2,8,Regulars
22151,118,10,1745.76,4,3,4,11,Loyal
22152,386,5,2720.7999999999997,2,1,5,8,Regulars
22153,220,11,977.91,3,3,2,8,Regulars
22154,68,17,1412.04,4,5,3,12,Loyal
22155,125,11,1844.27,4,3,4,11,Loyal
22156,722,10,1361.1599999999999,1,3,3,7,Regulars
22157,677,7,1537.81,1,1,3,5,Regulars
22158,19,13,2751.35,5,4,5,14,Champions
22159,308,9,996.02,2,2,2,6,Hibernating
22160,63,10,2275.6600000000003,5,3,4,12,Loyal
22161,87,13,1380.26,4,4,3,11,Loyal
22162,651,5,595.85,1,1,1,3,Hibernating
22163,83,6,563.92,4,1,1,6,Regulars
22164,509,10,998.18,1,3,2,6,Regulars
22165,915,9,3167.61,1,2,5,8,Regulars
22166,24,12,1874.1,5,4,4,13,Champions
22167,335,8,899.11,2,2,2,6,Hibernating
22168,76,8,402.07,4,2,1,7,Regulars
22169,69,10,1374.66,4,3,3,10,Loyal
22170,545,5,435.29,1,1,1,3,Hibernating
22171,160,3,112.07,3,1,1,5,Regulars
22172,7,12,1972.8500000000001,5,4,4,13,Champions
22173,130,12,768.8199999999999,4,4,1,9,Loyal
22174,98,12,3611.35,4,4,5,13,Champions
22175,47,11,1795.6399999999999,5,3,4,12,Loyal
22176,228,13,1614.98,3,4,3,10,Regulars
22177,23,14,1115.12,5,5,2,12,Loyal
22178,718,8,1174.9199999999998,1,2,2,5,Hibernating
22179,275,13,1134.0400000000002,2,4,2,8,At Risk
22180,341,10,1544.29,2,3,3,8,Regulars
22181,139,14,1832.1200000000001,4,5,4,13,Champions
22182,421,7,1063.06,2,1,2,5,Hibernating
22183,160,12,1198.65,3,4,2,9,Regulars
22184,172,12,3111.6499999999996,3,4,5,12,Big Spenders
22185,480,7,2393.96,1,1,4,6,Regulars
22186,941,2,40.85,1,1,1,3,Hibernating
22187,502,8,348.68,1,2,1,4,Hibernating
22188,419,8,2633.74,2,2,5,9,Regulars
22189,383,10,1019.96,2,3,2,7,Regulars
22190,1057,5,789.69,1,1,1,3,Hibernating
22191,255,13,2107.09,2,4,4,10,At Risk
22192,47,11,4727.85,5,3,5,13,Loyal
22193,325,11,993.59,2,3,2,7,Regulars
22194,297,10,829.83,2,3,1,6,Regulars
22195,534,10,2179.74,1,3,4,8,Regulars
22196,789,9,598.7,1,2,1,4,Hibernating
22197,7,15,2187.98,5,5,4,14,Champions
22198,274,7,1586.06,2,1,3,6,Regulars
22199,15,8,1043.72,5,2,2,9,Regulars
22200,336,9,734.7,2,2,1,5,Hibernating
22201,107,15,1566.63,4,5,3,12,Loyal
22202,447,9,1446.52,2,2,3,7,Regulars
22203,403,5,861.0999999999999,2,1,2,5,Hibernating
22204,97,12,2109.28,4,4,4,12,Champions
22205,383,10,1470.6999999999998,2,3,3,8,Regulars
22206,349,14,3968.52,2,5,5,12,At Risk
22207,190,13,1067.76,3,4,2,9,Regulars
22208,127,10,1433.79,4,3,3,10,Loyal
22209,405,8,1573.1000000000001,2,2,3,7,Regulars
22210,8,17,2687.38,5,5,5,15,Champions
22211,543,7,1087.41,1,1,2,4,Hibernating
22212,52,7,680.4,5,1,1,7,Regulars
22213,494,13,1139.68,1,4,2,7,At Risk
22214,245,10,1356.23,3,3,3,9,Regulars
22215,50,14,1987.95,5,5,4,14,Champions
22216,59,10,904.0899999999999,5,3,2,10,Loyal
22217,246,16,4163.53,3,5,5,13,Big Spenders
22218,729,11,1848.67,1,3,4,8,Regulars
22219,370,14,2194.02,2,5,4,11,At Risk
22220,384,4,1222.92,2,1,2,5,Hibernating
22221,151,13,1322.5,3,4,3,10,Regulars
22222,38,15,3960.08,5,5,5,15,Champions
22223,1069,12,3640.5099999999998,1,4,5,10,At Risk
22224,25,9,1593.18,5,2,3,10,Regulars
22225,30,14,2133.04,5,5,4,14,Champions
22226,581,10,1573.8600000000001,1,3,3,7,Regulars
22227,489,5,1238.29,1,1,2,4,Hibernating
22228,145,17,3192.18,4,5,5,14,Champions
22229,181,11,990.7,3,3,2,8,Regulars
22230,244,11,6438.340000000001,3,3,5,11,Big Spenders
22231,62,12,2194.31,5,4,4,13,Champions
22232,674,13,1579.99,1,4,3,8,At Risk
22233,140,11,1699.6200000000001,4,3,3,10,Loyal
22234,696,7,713.98,1,1,1,3,Hibernating
22235,441,6,2069.71,2,1,4,7,Regulars
22236,346,12,1628.82,2,4,3,9,At Risk
22237,264,9,626.17,2,2,1,5,Hibernating
22238,91,16,2562.14,4,5,4,13,Champions
22239,684,9,775.68,1,2,1,4,Hibernating
22240,0,11,921.99,5,3,2,10,Loyal
22241,496,8,696.7199999999999,1,2,1,4,Hibernating
22242,1792,4,547.64,1,1,1,3,Hibernating
22243,442,8,905.51,2,2,2,6,Hibernating
22244,56,9,1197.51,5,2,2,9,Regulars
22245,157,9,796.9,3,2,1,6,Regulars
22246,38,7,1182.55,5,1,2,8,Regulars
22247,415,9,4009.11,2,2,5,9,Regulars
22248,74,16,1632.67,4,5,3,12,Loyal
22249,89,12,1913.64,4,4,4,12,Champions
22250,6,6,2509.96,5,1,4,10,Big Spenders
22251,931,9,1712.87,1,2,3,6,Regulars
22252,711,10,1451.4999999999998,1,3,3,7,Regulars
22253,323,9,785.5899999999999,2,2,1,5,Hibernating
22254,96,13,968.82,4,4,2,10,Loyal
22255,272,13,2220.7400000000002,2,4,4,10,At Risk
22256,192,13,3586.5299999999997,3,4,5,12,Big Spenders
22257,176,7,1510.68,3,1,3,7,Regulars
22258,863,10,2572.0299999999997,1,3,4,8,Regulars
22259,342,7,858.97,2,1,2,5,Hibernating
22260,499,10,1213.8500000000001,1,3,2,6,Regulars
22261,220,9,5166.5599999999995,3,2,5,10,Big Spenders
22262,232,11,4884.2300000000005,3,3,5,11,Big Spenders
22263,8,9,658.23,5,2,1,8,Regulars
22264,84,8,618.5600000000001,4,2,1,7,Regulars
22265,81,16,1644.07,4,5,3,12,Loyal
22266,232,11,1029.73,3,3,2,8,Regulars
22267,135,12,2376.62,4,4,4,12,Champions
22268,174,13,1427.56,3,4,3,10,Regulars
22269,455,9,1921.1000000000001,2,2,4,8,Regulars
22270,165,9,805.21,3,2,1,6,Regulars
22271,7,5,336.87,5,1,1,7,Regulars
22272,47,9,743.8399999999999,5,2,1,8,Regulars
22273,237,13,2291.7000000000003,3,4,4,11,Big Spenders
22274,505,10,2886.83,1,3,5,9,Regulars
22275,21,15,2184.41,5,5,4,14,Champions
22276,67,8,1857.88,4,2,4,10,Big Spenders
22277,28,9,1384.52,5,2,3,10,Regulars
22278,656,8,405.3,1,2,1,4,Hibernating
22279,512,8,1359.14,1,2,3,6,Regulars
22280,26,8,852.96,5,2,2,9,Regulars
22281,2,11,1366.3999999999999,5,3,3,11,Loyal
22282,320,10,1781.32,2,3,4,9,Regulars
22283,15,9,2192.45,5,2,4,11,Big Spenders
22284,1417,7,1020.58,1,1,2,4,Hibernating
22285,218,7,2532.49,3,1,4,8,Big Spenders
22286,281,12,2314.35,2,4,4,10,At Risk
22287,823,11,2330.48,1,3,4,8,Regulars
22288,2,12,4503.88,5,4,5,14,Champions
22289,296,10,1940.24,2,3,4,9,Regulars
22290,17,10,1413.27,5,3,3,11,Loyal
22291,148,3,471.09,3,1,1,5,Regulars
22292,170,10,1808.41,3,3,4,10,Big Spenders
22293,638,6,665.64,1,1,1,3,Hibernating
22294,329,12,3131.57,2,4,5,11,At Risk
22295,432,14,1554.03,2,5,3,10,At Risk
22296,275,9,3578.53,2,2,5,9,Regulars
22297,204,10,1395.87,3,3,3,9,Regulars
22298,43,9,2578.05,5,2,5,12,Big Spenders
22299,293,11,894.0799999999999,2,3,2,7,Regulars
22300,351,13,1655.1999999999998,2,4,3,9,At Risk
22301,179,7,497.12,3,1,1,5,Regulars
22302,541,8,1056.12,1,2,2,5,Hibernating
22303,168,12,1299.5700000000002,3,4,3,10,Regulars
22304,224,6,922.7099999999999,3,1,2,6,Regulars
22305,16,11,807.9,5,3,1,9,Loyal
22306,746,7,1478.49,1,1,3,5,Regulars
22307,277,10,1366.91,2,3,3,8,Regulars
22308,211,15,2119.03,3,5,4,12,Big Spenders
22309,598,12,2875.31,1,4,5,10,At Risk
22310,1086,4,256.1,1,1,1,3,Hibernating
22311,140,10,1776.79,4,3,4,11,Loyal
22312,351,8,1070.3899999999999,2,2,2,6,Hibernating
22313,267,19,2316.92,2,5,4,11,At Risk
22314,531,6,448.45,1,1,1,3,Hibernating
22315,134,14,1560.25,4,5,3,12,Loyal
22316,464,12,1829.04,1,4,4,9,At Risk
22317,150,6,3115.0800000000004,3,1,5,9,Big Spenders
22318,524,8,3800.59,1,2,5,8,Regulars
22319,233,13,4233.04,3,4,5,12,Big Spenders
22320,14,13,1806.7499999999998,5,4,4,13,Champions
22321,1166,4,739.02,1,1,1,3,Hibernating
22322,447,8,326.57,2,2,1,5,Hibernating
22323,379,9,1198.48,2,2,2,6,Hibernating
22324,128,9,818.5,4,2,1,7,Regulars
22325,504,5,764.47,1,1,1,3,Hibernating
22326,23,15,2554.7599999999998,5,5,4,14,Champions
22327,187,16,2238.69,3,5,4,12,Big Spenders
22328,953,7,329.84,1,1,1,3,Hibernating
22329,402,10,1214.24,2,3,2,7,Regulars
22330,216,12,1877.42,3,4,4,11,Big Spenders
22331,239,6,991.0300000000001,3,1,2,6,Regulars
22332,1,12,1293.8400000000001,5,4,3,12,Loyal
22333,372,13,1221.12,2,4,2,8,At Risk
22334,417,6,1942.52,2,1,4,7,Regulars
22335,726,9,1309.73,1,2,3,6,Regulars
22336,39,8,2121.73,5,2,4,11,Big Spenders
22337,44,13,2680.47,5,4,5,14,Champions
22338,265,10,1065.18,2,3,2,7,Regulars
22339,160,9,1344.28,3,2,3,8,Regulars
22340,1402,5,2180.27,1,1,4,6,Regulars
22341,222,17,4704.51,3,5,5,13,Big Spenders
22342,196,10,610.2900000000001,3,3,1,7,Regulars
22343,999,5,393.33000000000004,1,1,1,3,Hibernating
22344,105,10,2016.2299999999998,4,3,4,11,Loyal
22345,173,12,1666.05,3,4,3,10,Regulars
22346,299,7,525.74,2,1,1,4,Hibernating
22347,168,14,1834.74,3,5,4,12,Big Spenders
22348,139,9,1314.54,4,2,3,9,Regulars
22349,80,10,1687.35,4,3,3,10,Loyal
22350,111,12,1653.0800000000002,4,4,3,11,Loyal
22351,542,8,500.09000000000003,1,2,1,4,Hibernating
22352,342,11,2116.02,2,3,4,9,Regulars
22353,189,14,3747.76,3,5,5,13,Big Spenders
22354,40,13,1952.2199999999998,5,4,4,13,Champions
22355,172,6,627.63,3,1,1,5,Regulars
22356,79,15,1702.87,4,5,3,12,Loyal
22357,79,9,1029.55,4,2,2,8,Regulars
22358,42,12,2676.98,5,4,5,14,Champions
22359,102,11,2391.77,4,3,4,11,Loyal
22360,292,14,4337.63,2,5,5,12,At Risk
22361,441,6,452.73,2,1,1,4,Hibernating
22362,1266,6,874.73,1,1,2,4,Hibernating
22363,108,9,2535.7200000000003,4,2,4,10,Big Spenders
22364,239,6,738.3,3,1,1,5,Regulars
22365,7,8,966.99,5,2,2,9,Regulars
22366,814,8,483.94,1,2,1,4,Hibernating
22367,19,12,788.36,5,4,1,10,Loyal
22368,207,12,3587.6,3,4,5,12,Big Spenders
22369,432,11,700.33,2,3,1,6,Regulars
22370,412,9,632.0,2,2,1,5,Hibernating
22371,280,11,801.94,2,3,1,6,Regulars
22372,1063,9,976.47,1,2,2,5,Hibernating
22373,177,6,459.44,3,1,1,5,Regulars
22374,666,11,1365.42,1,3,3,7,Regulars
22375,386,9,2120.16,2,2,4,8,Regulars
22376,328,8,3462.1200000000003,2,2,5,9,Regulars
22377,1061,10,1444.3,1,3,3,7,Regulars
22378,532,9,1496.77,1,2,3,6,Regulars
22379,44,19,5034.68,5,5,5,15,Champions
22380,343,14,1573.2,2,5,3,10,At Risk
22381,230,10,811.5400000000001,3,3,1,7,Regulars
22382,308,10,1854.68,2,3,4,9,Regulars
22383,331,12,3900.92,2,4,5,11,At Risk
22384,127,14,3954.3599999999997,4,5,5,14,Champions
22385,988,11,1685.78,1,3,3,7,Regulars
22386,15,9,1012.75,5,2,2,9,Regulars
22387,200,15,1078.92,3,5,2,10,Regulars
22388,61,12,2349.33,5,4,4,13,Champions
22389,187,10,2420.44,3,3,4,10,Big Spenders
22390,23,5,388.65999999999997,5,1,1,7,Regulars
22391,31,7,2828.28,5,1,5,11,Big Spenders
22392,237,7,404.89,3,1,1,5,Regulars
22393,167,12,2580.11,3,4,5,12,Big Spenders
22394,312,7,722.5,2,1,1,4,Hibernating
22395,334,8,1114.52,2,2,2,6,Hibernating
22396,120,9,908.1800000000001,4,2,2,8,Regulars
22397,21,8,573.6,5,2,1,8,Regulars
22398,83,11,1817.37,4,3,4,11,Loyal
22399,45,11,3749.9800000000005,5,3,5,13,Loyal
22400,29,10,3413.11,5,3,5,13,Loyal
22401,466,16,3282.29,1,5,5,11,At Risk
22402,58,19,4534.08,5,5,5,15,Champions
22403,762,9,910.61,1,2,2,5,Hibernating
22404,49,12,1072.16,5,4,2,11,Loyal
22405,200,9,1587.85,3,2,3,8,Regulars
22406,108,7,1278.9699999999998,4,1,3,8,Regulars
22407,155,8,623.6899999999999,3,2,1,6,Regulars
22408,44,9,1917.6499999999999,5,2,4,11,Big Spenders
22409,5,10,1224.8799999999999,5,3,2,10,Loyal
22410,119,15,1430.25,4,5,3,12,Loyal
22411,59,11,2832.8900000000003,5,3,5,13,Loyal
22412,356,7,1841.1,2,1,4,7,Regulars
22413,189,9,1827.31,3,2,4,9,Big Spenders
22414,135,7,1885.3400000000001,4,1,4,9,Big Spenders
22415,265,13,1656.93,2,4,3,9,At Risk
22416,5,14,3086.2799999999997,5,5,5,15,Champions
22417,215,18,4762.379999999999,3,5,5,13,Big Spenders
22418,500,11,1349.11,1,3,3,7,Regulars
22419,274,9,1072.3400000000001,2,2,2,6,Hibernating
22420,353,9,1386.0900000000001,2,2,3,7,Regulars
22421,154,7,2772.77,3,1,5,9,Big Spenders
22422,638,5,1771.54,1,1,4,6,Regulars
22423,134,13,2199.06,4,4,4,12,Champions
22424,212,9,483.03999999999996,3,2,1,6,Regulars
22425,925,5,492.9,1,1,1,3,Hibernating
22426,491,13,2726.31,1,4,5,10,At Risk
22427,725,10,1631.0800000000002,1,3,3,7,Regulars
22428,181,15,2668.13,3,5,5,13,Big Spenders
22429,239,17,1805.4,3,5,4,12,Big Spenders
22430,152,23,5244.71,3,5,5,13,Big Spenders
22431,486,7,2167.5299999999997,1,1,4,6,Regulars
22432,173,8,728.87,3,2,1,6,Regulars
22433,458,11,2133.87,2,3,4,9,Regulars
22434,386,14,4665.33,2,5,5,12,At Risk
22435,215,11,1992.6700000000003,3,3,4,10,Big Spenders
22436,122,8,825.24,4,2,1,7,Regulars
22437,459,15,3768.45,2,5,5,12,At Risk
22438,208,15,2589.83,3,5,5,13,Big Spenders
22439,9,7,2337.45,5,1,4,10,Big Spenders
22440,266,10,2463.8999999999996,2,3,4,9,Regulars
22441,138,7,618.45,4,1,1,6,Regulars
22442,340,7,601.06,2,1,1,4,Hibernating
22443,33,12,1348.71,5,4,3,12,Loyal
22444,26,8,2169.83,5,2,4,11,Big Spenders
22445,165,13,1261.13,3,4,3,10,Regulars
22446,365,7,1054.97,2,1,2,5,Hibernating
22447,30,15,1255.8999999999999,5,5,3,13,Loyal
22448,216,12,1529.21,3,4,3,10,Regulars
22449,78,11,639.11,4,3,1,8,Loyal
22450,203,11,629.44,3,3,1,7,Regulars
22451,7,14,2311.74,5,5,4,14,Champions
22452,566,5,437.03,1,1,1,3,Hibernating
22453,256,7,2806.29,2,1,5,8,Regulars
22454,159,13,1270.45,3,4,3,10,Regulars
22455,671,8,783.9,1,2,1,4,Hibernating
22456,19,12,1382.21,5,4,3,12,Loyal
22457,366,8,900.89,2,2,2,6,Hibernating
22458,476,5,1650.87,1,1,3,5,Regulars
22459,92,9,2431.7599999999998,4,2,4,10,Big Spenders
22460,12,9,851.79,5,2,2,9,Regulars
22461,83,9,1340.3,4,2,3,9,Regulars
22462,22,6,407.65999999999997,5,1,1,7,Regulars
22463,15,15,2159.55,5,5,4,14,Champions
22464,285,8,390.68,2,2,1,5,Hibernating
22465,151,12,2249.7,3,4,4,11,Big Spenders
22466,120,13,1709.1200000000001,4,4,3,11,Loyal
22467,133,14,1654.3400000000001,4,5,3,12,Loyal
22468,125,10,2075.84,4,3,4,11,Loyal
22469,102,10,1109.8000000000002,4,3,2,9,Loyal
22470,154,10,1371.1399999999999,3,3,3,9,Regulars
22471,221,11,955.62,3,3,2,8,Regulars
22472,528,14,1213.59,1,5,2,8,At Risk
22473,226,17,2055.5299999999997,3,5,4,12,Big Spenders
22474,122,7,473.84,4,1,1,6,Regulars
22475,69,7,594.49,4,1,1,6,Regulars
22476,988,4,612.8199999999999,1,1,1,3,Hibernating
22477,615,11,1653.5900000000001,1,3,3,7,Regulars
22478,254,13,1159.48,2,4,2,8,At Risk
22479,686,9,850.0,1,2,2,5,Hibernating
22480,178,9,1140.3400000000001,3,2,2,7,Regulars
22481,55,7,1039.48,5,1,2,8,Regulars
22482,86,13,1706.03,4,4,3,11,Loyal
22483,304,9,1268.01,2,2,3,7,Regulars
22484,184,12,1715.83,3,4,3,10,Regulars
22485,29,11,1383.62,5,3,3,11,Loyal
22486,512,11,978.12,1,3,2,6,Regulars
22487,335,14,3903.9999999999995,2,5,5,12,At Risk
22488,213,8,368.4,3,2,1,6,Regulars
22489,420,13,1529.19,2,4,3,9,At Risk
22490,171,12,2525.49,3,4,4,11,Big Spenders
22491,593,13,1786.06,1,4,4,9,At Risk
22492,993,6,184.8,1,1,1,3,Hibernating
22493,168,8,496.4,3,2,1,6,Regulars
22494,64,11,972.44,5,3,2,10,Loyal
22495,101,8,1372.84,4,2,3,9,Regulars
22496,315,6,1232.05,2,1,2,5,Hibernating
22497,0,13,1049.31,5,4,2,11,Loyal
22498,593,11,1298.96,1,3,3,7,Regulars
22499,174,16,1475.83,3,5,3,11,Regulars
22500,84,7,2542.03,4,1,4,9,Big Spenders
22501,7,10,2137.24,5,3,4,12,Loyal
22502,6,11,3104.71,5,3,5,13,Loyal
22503,213,6,1663.4900000000002,3,1,3,7,Regulars
22504,203,12,1386.91,3,4,3,10,Regulars
22505,226,13,978.01,3,4,2,9,Regulars
22506,325,13,1344.18,2,4,3,9,At Risk
22507,319,13,1090.55,2,4,2,8,At Risk
22508,860,9,1347.1799999999998,1,2,3,6,Regulars
22509,822,5,1179.22,1,1,2,4,Hibernating
22510,535,12,2659.69,1,4,5,10,At Risk
22511,1057,6,1573.83,1,1,3,5,Regulars
22512,52,14,1744.7,5,5,4,14,Champions
22513,40,11,1433.5400000000002,5,3,3,11,Loyal
22514,680,17,3205.25,1,5,5,11,At Risk
22515,0,9,1491.3,5,2,3,10,Regulars
22516,34,7,400.32000000000005,5,1,1,7,Regulars
22517,20,13,1313.9,5,4,3,12,Loyal
22518,40,9,1852.7,5,2,4,11,Big Spenders
22519,797,9,1589.37,1,2,3,6,Regulars
22520,260,8,773.28,2,2,1,5,Hibernating
22521,50,13,3964.1200000000003,5,4,5,14,Champions
22522,242,8,1168.49,3,2,2,7,Regulars
22523,26,17,6018.57,5,5,5,15,Champions
22524,189,4,573.71,3,1,1,5,Regulars
22525,92,10,1426.35,4,3,3,10,Loyal
22526,93,15,2308.18,4,5,4,13,Champions
22527,225,8,986.94,3,2,2,7,Regulars
22528,903,4,640.42,1,1,1,3,Hibernating
22529,215,10,4096.07,3,3,5,11,Big Spenders
22530,279,7,2313.6500000000005,2,1,4,7,Regulars
22531,659,7,456.27,1,1,1,3,Hibernating
22532,129,13,4106.38,4,4,5,13,Champions
22533,295,10,1254.1299999999999,2,3,3,8,Regulars
22534,17,13,2149.52,5,4,4,13,Champions
22535,116,15,1395.11,4,5,3,12,Loyal
22536,86,7,818.69,4,1,1,6,Regulars
22537,261,11,4274.34,2,3,5,10,Regulars
22538,1349,6,522.14,1,1,1,3,Hibernating
22539,339,10,624.4100000000001,2,3,1,6,Regulars
22540,983,5,580.59,1,1,1,3,Hibernating
22541,261,6,537.6500000000001,2,1,1,4,Hibernating
22542,194,8,628.9100000000001,3,2,1,6,Regulars
22543,727,8,1679.68,1,2,3,6,Regulars
22544,159,16,1898.7,3,5,4,12,Big Spenders
22545,320,9,1777.24,2,2,4,8,Regulars
22546,234,7,901.1,3,1,2,6,Regulars
22547,240,10,1552.32,3,3,3,9,Regulars
22548,84,13,2865.28,4,4,5,13,Champions
22549,224,9,558.98,3,2,1,6,Regulars
22550,184,16,2966.7100000000005,3,5,5,13,Big Spenders
22551,227,8,2061.67,3,2,4,9,Big Spenders
22552,71,12,1808.9199999999998,4,4,4,12,Champions
22553,416,11,1354.08,2,3,3,8,Regulars
22554,28,10,2340.03,5,3,4,12,Loyal
22555,225,9,519.1500000000001,3,2,1,6,Regulars
22556,702,6,1817.0200000000002,1,1,4,6,Regulars
22557,11,10,1025.16,5,3,2,10,Loyal
22558,49,12,1712.06,5,4,3,12,Loyal
22559,133,12,2452.0,4,4,4,12,Champions
22560,193,4,236.94,3,1,1,5,Regulars
22561,16,17,3012.5,5,5,5,15,Champions
22562,286,17,3420.3,2,5,5,12,At Risk
22563,578,7,829.54,1,1,1,3,Hibernating
22564,154,10,1338.88,3,3,3,9,Regulars
22565,81,13,1354.6200000000001,4,4,3,11,Loyal
22566,288,8,818.44,2,2,1,5,Hibernating
22567,564,11,1875.46,1,3,4,8,Regulars
22568,169,11,1096.57,3,3,2,8,Regulars
22569,170,6,390.5,3,1,1,5,Regulars
22570,187,6,1689.6399999999999,3,1,3,7,Regulars
22571,201,8,1632.02,3,2,3,8,Regulars
22572,44,16,4089.7999999999997,5,5,5,15,Champions
22573,562,5,2092.6200000000003,1,1,4,6,Regulars
22574,62,13,1375.43,5,4,3,12,Loyal
22575,175,10,1862.3999999999999,3,3,4,10,Big Spenders
22576,252,8,1249.56,2,2,3,7,Regulars
22577,329,6,607.47,2,1,1,4,Hibernating
22578,138,9,589.0,4,2,1,7,Regulars
22579,109,7,2004.86,4,1,4,9,Big Spenders
22580,49,10,749.29,5,3,1,9,Loyal
22581,506,12,2673.5699999999997,1,4,5,10,At Risk
22582,39,11,1344.97,5,3,3,11,Loyal
22583,23,9,3160.5800000000004,5,2,5,12,Big Spenders
22584,113,9,2723.94,4,2,5,11,Big Spenders
22585,21,16,4130.61,5,5,5,15,Champions
22586,60,11,1300.42,5,3,3,11,Loyal
22587,210,6,792.57,3,1,1,5,Regulars
22588,156,11,3383.0399999999995,3,3,5,11,Big Spenders
22589,85,12,1769.6,4,4,4,12,Champions
22590,60,12,2393.3500000000004,5,4,4,13,Champions
22591,642,7,870.62,1,1,2,4,Hibernating
22592,588,6,694.17,1,1,1,3,Hibernating
22593,32,11,1133.28,5,3,2,10,Loyal
22594,104,8,427.02,4,2,1,7,Regulars
22595,0,9,2038.37,5,2,4,11,Big Spenders
22596,129,11,2343.51,4,3,4,11,Loyal
22597,32,13,1898.06,5,4,4,13,Champions
22598,508,10,1306.1100000000001,1,3,3,7,Regulars
22599,85,11,2645.1499999999996,4,3,5,12,Loyal
22600,314,7,926.32,2,1,2,5,Hibernating
22601,6,14,2584.31,5,5,5,15,Champions
22602,191,10,1129.98,3,3,2,8,Regulars
22603,1001,10,1084.6100000000001,1,3,2,6,Regulars
22604,435,7,1343.07,2,1,3,6,Regulars
22605,319,14,3300.0800000000004,2,5,5,12,At Risk
22606,152,16,2255.79,3,5,4,12,Big Spenders
22607,132,11,1499.18,4,3,3,10,Loyal
22608,119,11,1454.41,4,3,3,10,Loyal
22609,339,9,2637.09,2,2,5,9,Regulars
22610,874,7,560.65,1,1,1,3,Hibernating
22611,518,14,2984.34,1,5,5,11,At Risk
22612,165,10,1456.28,3,3,3,9,Regulars
22613,553,12,1879.92,1,4,4,9,At Risk
22614,90,15,2277.26,4,5,4,13,Champions
22615,346,10,1178.33,2,3,2,7,Regulars
22616,862,6,726.62,1,1,1,3,Hibernating
22617,29,9,1337.83,5,2,3,10,Regulars
22618,0,14,2257.58,5,5,4,14,Champions
22619,498,11,1527.88,1,3,3,7,Regulars
22620,124,15,5150.459999999999,4,5,5,14,Champions
22621,36,12,917.74,5,4,2,11,Loyal
22622,150,14,1932.03,3,5,4,12,Big Spenders
22623,365,10,2436.5,2,3,4,9,Regulars
22624,262,9,1518.6100000000001,2,2,3,7,Regulars
22625,161,10,964.81,3,3,2,8,Regulars
22626,368,9,1063.5100000000002,2,2,2,6,Hibernating
22627,238,8,304.64,3,2,1,6,Regulars
22628,604,5,1252.65,1,1,3,5,Regulars
22629,147,6,817.53,4,1,1,6,Regulars
22630,8,9,2448.8,5,2,4,11,Big Spenders
22631,292,13,1886.27,2,4,4,10,At Risk
22632,379,18,1778.09,2,5,4,11,At Risk
22633,284,11,752.89,2,3,1,6,Regulars
22634,244,11,1985.26,3,3,4,10,Big Spenders
22635,331,12,877.44,2,4,2,8,At Risk
22636,125,15,1898.85,4,5,4,13,Champions
22637,119,20,1896.8,4,5,4,13,Champions
22638,191,8,1729.93,3,2,4,9,Big Spenders
22639,133,9,1042.48,4,2,2,8,Regulars
22640,130,10,1418.06,4,3,3,10,Loyal
22641,534,7,661.48,1,1,1,3,Hibernating
22642,601,6,828.3800000000001,1,1,1,3,Hibernating
22643,57,15,1591.39,5,5,3,13,Loyal
22644,594,12,1366.45,1,4,3,8,At Risk
22645,279,9,1100.4099999999999,2,2,2,6,Hibernating
22646,361,15,2314.5099999999998,2,5,4,11,At Risk
22647,54,7,1115.92,5,1,2,8,Regulars
22648,631,5,599.0799999999999,1,1,1,3,Hibernating
22649,292,11,1458.39,2,3,3,8,Regulars
22650,859,9,1303.33,1,2,3,6,Regulars
22651,326,10,749.6500000000001,2,3,1,6,Regulars
22652,146,13,3072.7,4,4,5,13,Champions
22653,239,6,1278.0,3,1,3,7,Regulars
22654,114,9,1157.7199999999998,4,2,2,8,Regulars
22655,378,11,2478.62,2,3,4,9,Regulars
22656,941,9,851.55,1,2,2,5,Hibernating
22657,363,13,2258.32,2,4,4,10,At Risk
22658,477,9,841.16,1,2,1,4,Hibernating
22659,127,6,643.55,4,1,1,6,Regulars
22660,623,7,972.1099999999999,1,1,2,4,Hibernating
22661,353,11,2244.12,2,3,4,9,Regulars
22662,117,15,1611.81,4,5,3,12,Loyal
22663,27,9,1123.22,5,2,2,9,Regulars
22664,65,13,2496.71,5,4,4,13,Champions
22665,214,11,1724.76,3,3,3,9,Regulars
22666,116,7,1026.92,4,1,2,7,Regulars
22667,53,12,1185.56,5,4,2,11,Loyal
22668,43,7,1042.8999999999999,5,1,2,8,Regulars
22669,216,11,1133.49,3,3,2,8,Regulars
22670,92,9,1470.65,4,2,3,9,Regulars
22671,44,14,2841.6000000000004,5,5,5,15,Champions
22672,241,5,314.24,3,1,1,5,Regulars
22673,84,9,664.46,4,2,1,7,Regulars
22674,427,16,3120.24,2,5,5,12,At Risk
22675,33,19,3670.24,5,5,5,15,Champions
22676,282,7,615.7199999999999,2,1,1,4,Hibernating
22677,2255,4,729.8900000000001,1,1,1,3,Hibernating
22678,236,6,869.1800000000001,3,1,2,6,Regulars
22679,203,7,981.52,3,1,2,6,Regulars
22680,1047,11,3970.68,1,3,5,9,Regulars
22681,286,7,1055.28,2,1,2,5,Hibernating
22682,63,11,1133.84,5,3,2,10,Loyal
22683,231,11,3121.29,3,3,5,11,Big Spenders
22684,661,10,612.59,1,3,1,5,Regulars
22685,1443,9,1386.3,1,2,3,6,Regulars
22686,124,7,3523.39,4,1,5,10,Big Spenders
22687,254,10,430.96,2,3,1,6,Regulars
22688,282,8,1741.3500000000001,2,2,4,8,Regulars
22689,166,12,1947.54,3,4,4,11,Big Spenders
22690,510,10,1147.71,1,3,2,6,Regulars
22691,50,9,704.5400000000001,5,2,1,8,Regulars
22692,344,6,2193.5299999999997,2,1,4,7,Regulars
22693,230,8,909.55,3,2,2,7,Regulars
22694,243,16,1960.45,3,5,4,12,Big Spenders
22695,497,9,998.6300000000001,1,2,2,5,Hibernating
22696,48,11,2038.08,5,3,4,12,Loyal
22697,502,12,1360.61,1,4,3,8,At Risk
22698,1018,12,2230.71,1,4,4,9,At Risk
22699,3,14,1562.27,5,5,3,13,Loyal
22700,426,9,3575.86,2,2,5,9,Regulars
22701,167,16,2914.99,3,5,5,13,Big Spenders
22702,98,16,7401.49,4,5,5,14,Champions
22703,671,8,570.66,1,2,1,4,Hibernating
22704,176,8,2206.09,3,2,4,9,Big Spenders
22705,129,9,490.14,4,2,1,7,Regulars
22706,993,10,1107.66,1,3,2,6,Regulars
22707,4,11,1779.16,5,3,4,12,Loyal
22708,64,14,3092.81,5,5,5,15,Champions
22709,168,13,2229.4,3,4,4,11,Big Spenders
22710,21,12,2052.36,5,4,4,13,Champions
22711,3,7,1055.3600000000001,5,1,2,8,Regulars
22712,433,10,1408.49,2,3,3,8,Regulars
22713,295,18,1994.17,2,5,4,11,At Risk
22714,6,11,3150.6800000000003,5,3,5,13,Loyal
22715,763,8,2275.07,1,2,4,7,Regulars
22716,473,10,1474.9299999999998,1,3,3,7,Regulars
22717,579,12,1900.8799999999999,1,4,4,9,At Risk
22718,231,13,2488.65,3,4,4,11,Big Spenders
22719,854,8,2770.54,1,2,5,8,Regulars
22720,24,14,1669.8799999999999,5,5,3,13,Loyal
22721,193,10,864.84,3,3,2,8,Regulars
22722,175,12,2501.48,3,4,4,11,Big Spenders
22723,122,9,853.36,4,2,2,8,Regulars
22724,1066,9,1303.93,1,2,3,6,Regulars
22725,272,15,1349.25,2,5,3,10,At Risk
22726,252,12,657.93,2,4,1,7,At Risk
22727,180,9,2118.14,3,2,4,9,Big Spenders
22728,610,10,979.97,1,3,2,6,Regulars
22729,35,13,3498.7799999999997,5,4,5,14,Champions
22730,125,6,2127.63,4,1,4,9,Big Spenders
22731,89,11,1012.05,4,3,2,9,Loyal
22732,15,12,969.29,5,4,2,11,Loyal
22733,271,9,894.9399999999999,2,2,2,6,Hibernating
22734,131,11,1457.24,4,3,3,10,Loyal
22735,601,8,1482.78,1,2,3,6,Regulars
22736,940,6,285.37,1,1,1,3,Hibernating
22737,600,6,991.4399999999999,1,1,2,4,Hibernating
22738,362,11,3398.59,2,3,5,10,Regulars
22739,7,13,1081.8600000000001,5,4,2,11,Loyal
22740,12,11,3493.34,5,3,5,13,Loyal
22741,38,6,577.6,5,1,1,7,Regulars
22742,958,7,1592.96,1,1,3,5,Regulars
22743,140,10,2107.54,4,3,4,11,Loyal
22744,325,13,2886.33,2,4,5,11,At Risk
22745,81,7,259.36,4,1,1,6,Regulars
22746,188,15,2162.11,3,5,4,12,Big Spenders
22747,264,11,1450.09,2,3,3,8,Regulars
22748,118,13,2563.52,4,4,4,12,Champions
22749,351,10,2509.4300000000003,2,3,4,9,Regulars
22750,566,7,293.41,1,1,1,3,Hibernating
22751,177,14,3728.3,3,5,5,13,Big Spenders
22752,45,12,2657.01,5,4,5,14,Champions
22753,21,18,2641.27,5,5,5,15,Champions
22754,268,10,1067.8200000000002,2,3,2,7,Regulars
22755,440,13,2422.04,2,4,4,10,At Risk
22756,209,11,1091.9,3,3,2,8,Regulars
22757,103,9,2116.73,4,2,4,10,Big Spenders
22758,125,10,2908.12,4,3,5,12,Loyal
22759,400,12,1531.87,2,4,3,9,At Risk
22760,610,13,1253.57,1,4,3,8,At Risk
22761,9,11,3426.94,5,3,5,13,Loyal
22762,363,7,819.6,2,1,1,4,Hibernating
22763,670,4,562.67,1,1,1,3,Hibernating
22764,476,8,1199.26,1,2,2,5,Hibernating
22765,15,13,1033.43,5,4,2,11,Loyal
22766,120,13,948.75,4,4,2,10,Loyal
22767,60,15,2672.68,5,5,5,15,Champions
22768,842,5,458.64,1,1,1,3,Hibernating
22769,89,12,4025.37,4,4,5,13,Champions
22770,162,11,1721.05,3,3,3,9,Regulars
22771,250,7,516.87,2,1,1,4,Hibernating
22772,267,6,745.62,2,1,1,4,Hibernating
22773,712,12,500.62,1,4,1,6,At Risk
22774,509,9,1477.42,1,2,3,6,Regulars
22775,678,11,929.52,1,3,2,6,Regulars
22776,35,12,2485.39,5,4,4,13,Champions
22777,148,9,1933.96,3,2,4,9,Big Spenders
22778,8,12,5511.66,5,4,5,14,Champions
22779,40,22,3316.83,5,5,5,15,Champions
22780,101,14,1192.87,4,5,2,11,Loyal
22781,292,9,2803.32,2,2,5,9,Regulars
22782,41,16,2404.53,5,5,4,14,Champions
22783,746,7,1736.41,1,1,4,6,Regulars
22784,971,8,755.14,1,2,1,4,Hibernating
22785,25,12,1587.4099999999999,5,4,3,12,Loyal
22786,152,8,4690.360000000001,3,2,5,10,Big Spenders
22787,149,5,2517.08,3,1,4,8,Big Spenders
22788,335,10,4002.0299999999997,2,3,5,10,Regulars
22789,305,11,1621.79,2,3,3,8,Regulars
22790,142,12,3287.82,4,4,5,13,Champions
22791,454,10,971.37,2,3,2,7,Regulars
22792,214,8,718.16,3,2,1,6,Regulars
22793,295,9,811.8000000000001,2,2,1,5,Hibernating
22794,141,16,2780.42,4,5,5,14,Champions
22795,109,8,1283.36,4,2,3,9,Regulars
22796,671,8,878.3199999999999,1,2,2,5,Hibernating
22797,270,12,898.31,2,4,2,8,At Risk
22798,84,9,1159.1399999999999,4,2,2,8,Regulars
22799,188,12,1255.11,3,4,3,10,Regulars
22800,544,7,680.3,1,1,1,3,Hibernating
22801,171,8,824.72,3,2,1,6,Regulars
22802,190,10,750.67,3,3,1,7,Regulars
22803,24,9,961.66,5,2,2,9,Regulars
22804,632,3,1903.0,1,1,4,6,Regulars
22805,182,6,399.62,3,1,1,5,Regulars
22806,195,7,876.6700000000001,3,1,2,6,Regulars
22807,58,6,306.53,5,1,1,7,Regulars
22808,201,14,1772.3,3,5,4,12,Big Spenders
22809,489,10,2523.56,1,3,4,8,Regulars
22810,152,11,2347.55,3,3,4,10,Big Spenders
22811,398,9,3290.2500000000005,2,2,5,9,Regulars
22812,2,7,1513.52,5,1,3,9,Regulars
22813,23,9,1573.7800000000002,5,2,3,10,Regulars
22814,296,8,871.0600000000001,2,2,2,6,Hibernating
22815,455,11,2387.03,2,3,4,9,Regulars
22816,488,7,892.34,1,1,2,4,Hibernating
22817,387,11,5518.2300000000005,2,3,5,10,Regulars
22818,91,13,1585.75,4,4,3,11,Loyal
22819,502,9,2777.1699999999996,1,2,5,8,Regulars
22820,432,11,1030.83,2,3,2,7,Regulars
22821,65,13,2469.22,5,4,4,13,Champions
22822,25,13,4589.5,5,4,5,14,Champions
22823,218,9,4919.53,3,2,5,10,Big Spenders
22824,153,3,170.27999999999997,3,1,1,5,Regulars
22825,735,12,4948.26,1,4,5,10,At Risk
22826,160,9,1698.03,3,2,3,8,Regulars
22827,829,10,912.36,1,3,2,6,Regulars
22828,327,6,952.4200000000001,2,1,2,5,Hibernating
22829,151,10,3278.1,3,3,5,11,Big Spenders
22830,55,9,2526.34,5,2,4,11,Big Spenders
22831,213,13,2990.5099999999998,3,4,5,12,Big Spenders
22832,417,11,3317.26,2,3,5,10,Regulars
22833,183,14,5690.11,3,5,5,13,Big Spenders
22834,444,10,1167.44,2,3,2,7,Regulars
22835,80,11,1188.38,4,3,2,9,Loyal
22836,410,8,827.47,2,2,1,5,Hibernating
22837,168,11,881.94,3,3,2,8,Regulars
22838,366,11,2976.34,2,3,5,10,Regulars
22839,416,9,971.74,2,2,2,6,Hibernating
22840,74,16,6928.73,4,5,5,14,Champions
22841,140,10,1424.03,4,3,3,10,Loyal
22842,35,7,761.04,5,1,1,7,Regulars
22843,75,6,408.01,4,1,1,6,Regulars
22844,71,16,3833.2699999999995,4,5,5,14,Champions
22845,154,11,3263.68,3,3,5,11,Big Spenders
22846,351,11,3150.87,2,3,5,10,Regulars
22847,1328,8,794.61,1,2,1,4,Hibernating
22848,196,8,708.5600000000001,3,2,1,6,Regulars
22849,170,10,2478.22,3,3,4,10,Big Spenders
22850,219,10,3425.8900000000003,3,3,5,11,Big Spenders
22851,18,6,2663.0999999999995,5,1,5,11,Big Spenders
22852,321,8,1289.1200000000001,2,2,3,7,Regulars
22853,271,9,1351.81,2,2,3,7,Regulars
22854,88,9,1000.53,4,2,2,8,Regulars
22855,216,6,1988.42,3,1,4,8,Big Spenders
22856,756,5,705.29,1,1,1,3,Hibernating
22857,208,15,2414.81,3,5,4,12,Big Spenders
22858,25,7,586.99,5,1,1,7,Regulars
22859,216,15,1032.04,3,5,2,10,Regulars
22860,101,12,1907.8899999999999,4,4,4,12,Champions
22861,903,9,2802.93,1,2,5,8,Regulars
22862,133,13,1132.94,4,4,2,10,Loyal
22863,25,10,620.22,5,3,1,9,Loyal
22864,75,11,1537.9399999999998,4,3,3,10,Loyal
22865,671,8,2187.32,1,2,4,7,Regulars
22866,359,8,987.26,2,2,2,6,Hibernating
22867,460,8,1147.6899999999998,1,2,2,5,Hibernating
22868,337,12,744.62,2,4,1,7,At Risk
22869,233,8,1517.6799999999998,3,2,3,8,Regulars
22870,93,12,1334.04,4,4,3,11,Loyal
22871,50,11,2115.2,5,3,4,12,Loyal
22872,122,10,2163.67,4,3,4,11,Loyal
22873,313,11,2819.6099999999997,2,3,5,10,Regulars
22874,8,17,1892.63,5,5,4,14,Champions
22875,309,11,1514.91,2,3,3,8,Regulars
22876,15,10,1845.1,5,3,4,12,Loyal
22877,589,6,998.06,1,1,2,4,Hibernating
22878,350,12,4002.4300000000003,2,4,5,11,At Risk
22879,61,11,2310.05,5,3,4,12,Loyal
22880,81,12,2460.79,4,4,4,12,Champions
22881,40,8,598.28,5,2,1,8,Regulars
22882,12,13,3680.44,5,4,5,14,Champions
22883,53,6,1624.5400000000002,5,1,3,9,Regulars
22884,163,9,588.24,3,2,1,6,Regulars
22885,405,4,509.73999999999995,2,1,1,4,Hibernating
22886,911,10,985.1899999999999,1,3,2,6,Regulars
22887,456,13,2445.01,2,4,4,10,At Risk
22888,13,8,741.09,5,2,1,8,Regulars
22889,31,15,2117.72,5,5,4,14,Champions
22890,200,8,1282.83,3,2,3,8,Regulars
22891,1330,8,1112.75,1,2,2,5,Hibernating
22892,217,10,1436.72,3,3,3,9,Regulars
22893,34,9,2495.25,5,2,4,11,Big Spenders
22894,347,10,1870.12,2,3,4,9,Regulars
22895,1009,6,2327.25,1,1,4,6,Regulars
22896,234,10,1752.05,3,3,4,10,Big Spenders
22897,562,8,4543.4400000000005,1,2,5,8,Regulars
22898,186,10,1196.78,3,3,2,8,Regulars
22899,533,10,1199.78,1,3,2,6,Regulars
22900,235,11,1959.2,3,3,4,10,Big Spenders
22901,102,12,1405.28,4,4,3,11,Loyal
22902,1016,7,778.25,1,1,1,3,Hibernating
22903,32,12,1457.51,5,4,3,12,Loyal
22904,137,7,580.17,4,1,1,6,Regulars
22905,588,8,894.78,1,2,2,5,Hibernating
22906,736,9,802.11,1,2,1,4,Hibernating
22907,25,17,2499.3399999999997,5,5,4,14,Champions
22908,391,11,1931.4299999999998,2,3,4,9,Regulars
22909,478,10,1291.64,1,3,3,7,Regulars
22910,287,8,502.75,2,2,1,5,Hibernating
22911,145,15,4652.8099999999995,4,5,5,14,Champions
22912,497,5,896.96,1,1,2,4,Hibernating
22913,44,15,2487.93,5,5,4,14,Champions
22914,264,11,682.49,2,3,1,6,Regulars
22915,118,11,4836.78,4,3,5,12,Loyal
22916,136,11,1540.34,4,3,3,10,Loyal
22917,25,9,913.8399999999999,5,2,2,9,Regulars
22918,96,13,2188.16,4,4,4,12,Champions
22919,850,10,1395.56,1,3,3,7,Regulars
22920,47,4,1726.45,5,1,4,10,Big Spenders
22921,551,11,1409.43,1,3,3,7,Regulars
22922,208,9,1331.47,3,2,3,8,Regulars
22923,55,11,1384.5,5,3,3,11,Loyal
22924,119,23,2940.05,4,5,5,14,Champions
22925,141,11,3015.3399999999997,4,3,5,12,Loyal
22926,203,7,2771.0899999999997,3,1,5,9,Big Spenders
22927,37,12,1914.61,5,4,4,13,Champions
22928,545,9,1097.66,1,2,2,5,Hibernating
22929,9,9,495.14,5,2,1,8,Regulars
22930,367,9,1352.27,2,2,3,7,Regulars
22931,164,9,1635.71,3,2,3,8,Regulars
22932,23,8,1192.16,5,2,2,9,Regulars
22933,90,10,1623.7600000000002,4,3,3,10,Loyal
22934,39,11,3145.58,5,3,5,13,Loyal
22935,297,12,1685.43,2,4,3,9,At Risk
22936,10,18,2037.54,5,5,4,14,Champions
22937,68,7,653.78,4,1,1,6,Regulars
22938,126,11,1221.43,4,3,2,9,Loyal
22939,384,11,635.96,2,3,1,6,Regulars
22940,88,9,981.01,4,2,2,8,Regulars
22941,127,12,3411.06,4,4,5,13,Champions
22942,464,9,2532.8599999999997,1,2,4,7,Regulars
22943,97,15,2093.32,4,5,4,13,Champions
22944,689,7,785.55,1,1,1,3,Hibernating
22945,138,11,2162.6800000000003,4,3,4,11,Loyal
22946,44,13,1365.72,5,4,3,12,Loyal
22947,156,5,1199.44,3,1,2,6,Regulars
22948,120,9,912.9499999999999,4,2,2,8,Regulars
22949,173,14,3339.93,3,5,5,13,Big Spenders
22950,97,17,4070.59,4,5,5,14,Champions
22951,99,12,1251.74,4,4,3,11,Loyal
22952,177,8,316.73,3,2,1,6,Regulars
22953,590,12,1871.3700000000001,1,4,4,9,At Risk
22954,370,8,2241.23,2,2,4,8,Regulars
22955,168,12,1455.58,3,4,3,10,Regulars
22956,86,6,1110.6200000000001,4,1,2,7,Regulars
22957,62,14,2936.17,5,5,5,15,Champions
22958,91,7,1298.1000000000001,4,1,3,8,Regulars
22959,185,11,1752.0500000000002,3,3,4,10,Big Spenders
22960,225,8,647.13,3,2,1,6,Regulars
22961,187,10,1801.4,3,3,4,10,Big Spenders
22962,72,11,2780.75,4,3,5,12,Loyal
22963,8,9,1786.13,5,2,4,11,Big Spenders
22964,351,12,1780.92,2,4,4,10,At Risk
22965,68,15,3112.58,4,5,5,14,Champions
22966,33,12,3344.11,5,4,5,14,Champions
22967,98,10,1565.42,4,3,3,10,Loyal
22968,101,16,2540.9700000000003,4,5,4,13,Champions
22969,0,7,1809.21,5,1,4,10,Big Spenders
22970,181,11,1144.74,3,3,2,8,Regulars
22971,135,8,1838.89,4,2,4,10,Big Spenders
22972,285,8,1425.3,2,2,3,7,Regulars
22973,362,13,1625.49,2,4,3,9,At Risk
22974,13,9,446.52,5,2,1,8,Regulars
22975,213,9,4426.32,3,2,5,10,Big Spenders
22976,2,5,1074.68,5,1,2,8,Regulars
22977,1041,10,2270.0099999999998,1,3,4,8,Regulars
22978,208,15,3019.57,3,5,5,13,Big Spenders
22979,170,15,2493.51,3,5,4,12,Big Spenders
22980,25,10,2056.76,5,3,4,12,Loyal
22981,364,11,794.52,2,3,1,6,Regulars
22982,169,12,960.22,3,4,2,9,Regulars
22983,200,12,1061.9299999999998,3,4,2,9,Regulars
22984,66,3,117.5,4,1,1,6,Regulars
22985,181,9,2041.93,3,2,4,9,Big Spenders
22986,207,10,3314.89,3,3,5,11,Big Spenders
22987,91,12,1288.69,4,4,3,11,Loyal
22988,48,11,1073.09,5,3,2,10,Loyal
22989,69,11,1199.79,4,3,2,9,Loyal
22990,490,12,1197.5,1,4,2,7,At Risk
22991,775,8,1418.53,1,2,3,6,Regulars
22992,288,9,868.62,2,2,2,6,Hibernating
22993,374,10,3279.96,2,3,5,10,Regulars
22994,124,10,1754.3999999999999,4,3,4,11,Loyal
22995,170,8,1092.92,3,2,2,7,Regulars
22996,13,11,2084.89,5,3,4,12,Loyal
22997,120,10,2515.5299999999997,4,3,4,11,Loyal
22998,65,11,1023.6200000000001,5,3,2,10,Loyal
22999,40,7,688.13,5,1,1,7,Regulars
23000,110,12,1142.36,4,4,2,10,Loyal
23001,299,8,822.6700000000001,2,2,1,5,Hibernating
23002,268,14,3722.73,2,5,5,12,At Risk
23003,105,7,3178.89,4,1,5,10,Big Spenders
23004,160,15,3108.14,3,5,5,13,Big Spenders
23005,3,17,6833.57,5,5,5,15,Champions
23006,440,11,774.97,2,3,1,6,Regulars
23007,21,9,2645.5099999999998,5,2,5,12,Big Spenders
23008,38,15,1846.5,5,5,4,14,Champions
23009,142,12,1757.49,4,4,4,12,Champions
23010,715,9,1632.25,1,2,3,6,Regulars
23011,722,6,212.66,1,1,1,3,Hibernating
23012,230,9,2747.14,3,2,5,10,Big Spenders
23013,111,8,586.57,4,2,1,7,Regulars
23014,67,11,1537.45,4,3,3,10,Loyal
23015,215,6,1073.52,3,1,2,6,Regulars
23016,40,11,1844.96,5,3,4,12,Loyal
23017,2,15,3229.62,5,5,5,15,Champions
23018,23,11,1906.58,5,3,4,12,Loyal
23019,191,10,1273.24,3,3,3,9,Regulars
23020,36,16,1903.89,5,5,4,14,Champions
23021,213,14,1340.8700000000001,3,5,3,11,Regulars
23022,268,12,3436.07,2,4,5,11,At Risk
23023,481,7,1496.42,1,1,3,5,Regulars
23024,299,11,968.43,2,3,2,7,Regulars
23025,162,7,481.2,3,1,1,5,Regulars
23026,286,15,1765.33,2,5,4,11,At Risk
23027,589,8,657.88,1,2,1,4,Hibernating
23028,370,13,2349.34,2,4,4,10,At Risk
23029,8,7,1270.3500000000001,5,1,3,9,Regulars
23030,10,12,1405.53,5,4,3,12,Loyal
23031,256,7,1399.6399999999999,2,1,3,6,Regulars
23032,370,8,1491.75,2,2,3,7,Regulars
23033,147,9,4057.5499999999997,4,2,5,11,Big Spenders
23034,777,10,1290.81,1,3,3,7,Regulars
23035,1120,12,2451.6,1,4,4,9,At Risk
23036,298,10,867.0699999999999,2,3,2,7,Regulars
23037,591,8,838.44,1,2,1,4,Hibernating
23038,253,12,1587.66,2,4,3,9,At Risk
23039,262,12,2045.45,2,4,4,10,At Risk
23040,283,14,3040.7899999999995,2,5,5,12,At Risk
23041,719,7,979.54,1,1,2,4,Hibernating
23042,145,11,2780.07,4,3,5,12,Loyal
23043,319,10,3101.85,2,3,5,10,Regulars
23044,130,7,2135.29,4,1,4,9,Big Spenders
23045,418,7,749.43,2,1,1,4,Hibernating
23046,91,13,1549.98,4,4,3,11,Loyal
23047,522,6,543.41,1,1,1,3,Hibernating
23048,111,4,252.12,4,1,1,6,Regulars
23049,44,8,1112.46,5,2,2,9,Regulars
23050,484,16,4812.6,1,5,5,11,At Risk
23051,268,10,696.85,2,3,1,6,Regulars
23052,33,12,2810.51,5,4,5,14,Champions
23053,15,14,1457.6100000000001,5,5,3,13,Loyal
23054,108,11,3662.56,4,3,5,12,Loyal
23055,175,8,1913.8,3,2,4,9,Big Spenders
23056,904,4,1070.48,1,1,2,4,Hibernating
23057,96,9,662.12,4,2,1,7,Regulars
23058,238,11,1219.43,3,3,2,8,Regulars
23059,185,7,2822.8599999999997,3,1,5,9,Big Spenders
23060,3,11,2318.07,5,3,4,12,Loyal
23061,23,10,2622.36,5,3,5,13,Loyal
23062,359,14,1491.4799999999998,2,5,3,10,At Risk
23063,1050,7,378.99,1,1,1,3,Hibernating
23064,278,12,886.12,2,4,2,8,At Risk
23065,130,14,1086.19,4,5,2,11,Loyal
23066,142,7,990.78,4,1,2,7,Regulars
23067,261,15,5131.88,2,5,5,12,At Risk
23068,346,10,3072.8,2,3,5,10,Regulars
23069,119,8,605.26,4,2,1,7,Regulars
23070,18,7,434.93,5,1,1,7,Regulars
23071,160,11,1066.96,3,3,2,8,Regulars
23072,169,10,1154.18,3,3,2,8,Regulars
23073,648,3,425.21999999999997,1,1,1,3,Hibernating
23074,118,13,1319.6,4,4,3,11,Loyal
23075,86,7,2181.81,4,1,4,9,Big Spenders
23076,546,12,1938.25,1,4,4,9,At Risk
23077,253,9,1080.46,2,2,2,6,Hibernating
23078,465,10,3391.17,1,3,5,9,Regulars
23079,29,7,682.5600000000001,5,1,1,7,Regulars
23080,264,7,1199.46,2,1,2,5,Hibernating
23081,20,12,1461.8200000000002,5,4,3,12,Loyal
23082,91,10,1154.21,4,3,2,9,Loyal
23083,98,8,1092.88,4,2,2,8,Regulars
23084,253,10,1018.95,2,3,2,7,Regulars
23085,112,12,754.0,4,4,1,9,Loyal
23086,166,11,829.9100000000001,3,3,1,7,Regulars
23087,183,10,3075.81,3,3,5,11,Big Spenders
23088,48,9,1419.1499999999999,5,2,3,10,Regulars
23089,485,5,1062.92,1,1,2,4,Hibernating
23090,514,14,1621.35,1,5,3,9,At Risk
23091,551,8,780.72,1,2,1,4,Hibernating
23092,76,10,1644.02,4,3,3,10,Loyal
23093,104,7,1756.95,4,1,4,9,Big Spenders
23094,122,16,2270.41,4,5,4,13,Champions
23095,236,8,4495.610000000001,3,2,5,10,Big Spenders
23096,358,9,680.72,2,2,1,5,Hibernating
23097,124,22,2496.6,4,5,4,13,Champions
23098,74,6,468.78,4,1,1,6,Regulars
23099,60,12,1152.62,5,4,2,11,Loyal
23100,929,5,337.37,1,1,1,3,Hibernating
23101,70,3,2780.17,4,1,5,10,Big Spenders
23102,531,12,1802.88,1,4,4,9,At Risk
23103,170,11,1371.83,3,3,3,9,Regulars
23104,225,6,818.3,3,1,1,5,Regulars
23105,246,10,657.17,3,3,1,7,Regulars
23106,366,11,1007.75,2,3,2,7,Regulars
23107,79,11,861.53,4,3,2,9,Loyal
23108,139,8,805.39,4,2,1,7,Regulars
23109,285,9,760.43,2,2,1,5,Hibernating
23110,299,12,1252.15,2,4,3,9,At Risk
23111,495,11,2641.14,1,3,5,9,Regulars
23112,97,16,4053.97,4,5,5,14,Champions
23113,1306,3,114.4,1,1,1,3,Hibernating
23114,75,9,1920.83,4,2,4,10,Big Spenders
23115,117,7,1364.8000000000002,4,1,3,8,Regulars
23116,22,13,2321.47,5,4,4,13,Champions
23117,208,10,1499.95,3,3,3,9,Regulars
23118,297,6,706.7199999999999,2,1,1,4,Hibernating
23119,27,14,2438.6800000000003,5,5,4,14,Champions
23120,577,5,1019.2400000000001,1,1,2,4,Hibernating
23121,19,10,3137.26,5,3,5,13,Loyal
23122,510,10,1008.0699999999999,1,3,2,6,Regulars
23123,505,12,1426.8999999999999,1,4,3,8,At Risk
23124,225,4,334.01,3,1,1,5,Regulars
23125,410,9,594.9,2,2,1,5,Hibernating
23126,138,4,1710.88,4,1,3,8,Regulars
23127,132,10,987.24,4,3,2,9,Loyal
23128,17,10,1013.4,5,3,2,10,Loyal
23129,615,9,3275.68,1,2,5,8,Regulars
23130,830,8,981.9100000000001,1,2,2,5,Hibernating
23131,180,8,3193.7699999999995,3,2,5,10,Big Spenders
23132,194,11,2458.25,3,3,4,10,Big Spenders
23133,768,12,626.4,1,4,1,6,At Risk
23134,484,6,475.62,1,1,1,3,Hibernating
23135,61,10,1700.47,5,3,3,11,Loyal
23136,92,10,3498.09,4,3,5,12,Loyal
23137,221,11,1397.62,3,3,3,9,Regulars
23138,111,13,2794.71,4,4,5,13,Champions
23139,104,8,3709.52,4,2,5,11,Big Spenders
23140,119,17,2221.92,4,5,4,13,Champions
23141,538,12,2061.32,1,4,4,9,At Risk
23142,183,10,4678.47,3,3,5,11,Big Spenders
23143,213,3,260.81,3,1,1,5,Regulars
23144,11,17,4854.91,5,5,5,15,Champions
23145,712,9,1482.89,1,2,3,6,Regulars
23146,7,9,3261.87,5,2,5,12,Big Spenders
23147,209,10,2518.76,3,3,4,10,Big Spenders
23148,122,10,2672.42,4,3,5,12,Loyal
23149,262,10,1876.69,2,3,4,9,Regulars
23150,184,13,888.45,3,4,2,9,Regulars
23151,469,12,452.99,1,4,1,6,At Risk
23152,224,7,763.97,3,1,1,5,Regulars
23153,535,8,584.29,1,2,1,4,Hibernating
23154,204,12,3274.8,3,4,5,12,Big Spenders
23155,287,13,1451.44,2,4,3,9,At Risk
23156,23,15,1407.18,5,5,3,13,Loyal
23157,4,15,4571.75,5,5,5,15,Champions
23158,57,9,1066.1599999999999,5,2,2,9,Regulars
23159,72,8,2140.55,4,2,4,10,Big Spenders
23160,1672,6,1199.48,1,1,2,4,Hibernating
23161,22,10,1449.89,5,3,3,11,Loyal
23162,274,7,2154.2699999999995,2,1,4,7,Regulars
23163,119,8,2592.7799999999997,4,2,5,11,Big Spenders
23164,50,10,1153.7,5,3,2,10,Loyal
23165,718,6,488.52000000000004,1,1,1,3,Hibernating
23166,311,9,1298.05,2,2,3,7,Regulars
23167,267,9,1254.89,2,2,3,7,Regulars
23168,47,6,197.47000000000003,5,1,1,7,Regulars
23169,258,8,1963.55,2,2,4,8,Regulars
23170,63,11,1561.95,5,3,3,11,Loyal
23171,78,9,1586.8400000000001,4,2,3,9,Regulars
23172,29,15,1686.13,5,5,3,13,Loyal
23173,196,5,931.2299999999999,3,1,2,6,Regulars
23174,799,8,3844.1200000000003,1,2,5,8,Regulars
23175,219,11,929.1500000000001,3,3,2,8,Regulars
23176,60,9,1804.06,5,2,4,11,Big Spenders
23177,26,15,2455.4599999999996,5,5,4,14,Champions
23178,402,8,1343.84,2,2,3,7,Regulars
23179,203,10,2344.76,3,3,4,10,Big Spenders
23180,48,15,3377.37,5,5,5,15,Champions
23181,162,9,1013.47,3,2,2,7,Regulars
23182,54,17,2249.31,5,5,4,14,Champions
23183,621,6,2356.26,1,1,4,6,Regulars
23184,27,6,573.01,5,1,1,7,Regulars
23185,396,13,907.23,2,4,2,8,At Risk
23186,662,10,2961.49,1,3,5,9,Regulars
23187,208,10,1508.6799999999998,3,3,3,9,Regulars
23188,629,9,648.27,1,2,1,4,Hibernating
23189,526,6,1071.32,1,1,2,4,Hibernating
23190,510,10,1988.24,1,3,4,8,Regulars
23191,689,13,1504.24,1,4,3,8,At Risk
23192,14,12,1935.94,5,4,4,13,Champions
23193,110,7,466.55999999999995,4,1,1,6,Regulars
23194,229,7,727.65,3,1,1,5,Regulars
23195,29,7,910.9,5,1,2,8,Regulars
23196,264,14,1886.24,2,5,4,11,At Risk
23197,373,5,1077.01,2,1,2,5,Hibernating
23198,650,11,1576.59,1,3,3,7,Regulars
23199,141,11,1129.91,4,3,2,9,Loyal
23200,152,16,2059.25,3,5,4,12,Big Spenders
23201,981,13,2799.17,1,4,5,10,At Risk
23202,58,5,228.14000000000001,5,1,1,7,Regulars
23203,264,13,4107.74,2,4,5,11,At Risk
23204,540,10,1245.31,1,3,3,7,Regulars
23205,116,9,964.26,4,2,2,8,Regulars
23206,48,9,1739.45,5,2,4,11,Big Spenders
23207,261,6,2417.43,2,1,4,7,Regulars
23208,72,13,1796.4199999999998,4,4,4,12,Champions
23209,213,8,918.75,3,2,2,7,Regulars
23210,50,11,4280.7,5,3,5,13,Loyal
23211,274,15,4186.79,2,5,5,12,At Risk
23212,72,8,1301.0700000000002,4,2,3,9,Regulars
23213,136,8,1248.02,4,2,3,9,Regulars
23214,255,11,2017.96,2,3,4,9,Regulars
23215,200,14,1230.6200000000001,3,5,2,10,Regulars
23216,320,14,1742.18,2,5,4,11,At Risk
23217,249,9,771.55,2,2,1,5,Hibernating
23218,38,17,1664.05,5,5,3,13,Loyal
23219,105,9,1637.15,4,2,3,9,Regulars
23220,122,12,1576.83,4,4,3,11,Loyal
23221,25,16,3844.27,5,5,5,15,Champions
23222,109,10,1073.62,4,3,2,9,Loyal
23223,91,15,2357.4300000000003,4,5,4,13,Champions
23224,1107,3,204.73,1,1,1,3,Hibernating
23225,47,9,1449.3200000000002,5,2,3,10,Regulars
23226,526,9,1195.67,1,2,2,5,Hibernating
23227,8,10,1838.5299999999997,5,3,4,12,Loyal
23228,545,8,1118.56,1,2,2,5,Hibernating
23229,34,15,1323.91,5,5,3,13,Loyal
23230,73,11,2122.8,4,3,4,11,Loyal
23231,263,12,854.97,2,4,2,8,At Risk
23232,11,9,1315.54,5,2,3,10,Regulars
23233,425,11,807.15,2,3,1,6,Regulars
23234,102,8,1001.13,4,2,2,8,Regulars
23235,190,9,1791.2400000000002,3,2,4,9,Big Spenders
23236,61,10,2170.56,5,3,4,12,Loyal
23237,14,10,909.0,5,3,2,10,Loyal
23238,49,10,653.8199999999999,5,3,1,9,Loyal
23239,477,9,1483.1299999999999,1,2,3,6,Regulars
23240,307,10,4178.28,2,3,5,10,Regulars
23241,58,6,987.44,5,1,2,8,Regulars
23242,155,13,1530.22,3,4,3,10,Regulars
23243,104,4,3798.99,4,1,5,10,Big Spenders
23244,133,6,720.3,4,1,1,6,Regulars
23245,152,6,1815.81,3,1,4,8,Big Spenders
23246,351,15,4609.89,2,5,5,12,At Risk
23247,149,4,210.5,3,1,1,5,Regulars
23248,252,11,2452.9300000000003,2,3,4,9,Regulars
23249,143,14,1865.24,4,5,4,13,Champions
23250,136,9,1981.8799999999999,4,2,4,10,Big Spenders
23251,529,10,1515.52,1,3,3,7,Regulars
23252,471,12,6277.27,1,4,5,10,At Risk
23253,172,12,962.3199999999999,3,4,2,9,Regulars
23254,434,16,2039.22,2,5,4,11,At Risk
23255,296,10,1181.44,2,3,2,7,Regulars
23256,29,11,1383.87,5,3,3,11,Loyal
23257,40,17,3239.45,5,5,5,15,Champions
23258,766,5,700.74,1,1,1,3,Hibernating
23259,464,7,1078.5900000000001,1,1,2,4,Hibernating
23260,92,8,2080.73,4,2,4,10,Big Spenders
23261,202,11,1287.8799999999999,3,3,3,9,Regulars
23262,139,18,2054.2799999999997,4,5,4,13,Champions
23263,1398,6,1253.77,1,1,3,5,Regulars
23264,21,19,2385.33,5,5,4,14,Champions
23265,747,12,888.78,1,4,2,7,At Risk
23266,154,11,1045.05,3,3,2,8,Regulars
23267,105,7,3908.41,4,1,5,10,Big Spenders
23268,307,6,2307.84,2,1,4,7,Regulars
23269,608,12,4795.780000000001,1,4,5,10,At Risk
23270,24,6,509.76,5,1,1,7,Regulars
23271,345,13,1922.96,2,4,4,10,At Risk
23272,11,15,2747.84,5,5,5,15,Champions
23273,26,7,871.8800000000001,5,1,2,8,Regulars
23274,632,10,962.16,1,3,2,6,Regulars
23275,806,7,766.88,1,1,1,3,Hibernating
23276,25,10,733.58,5,3,1,9,Loyal
23277,180,8,2935.06,3,2,5,10,Big Spenders
23278,951,6,1041.05,1,1,2,4,Hibernating
23279,219,6,971.31,3,1,2,6,Regulars
23280,1,12,1011.4399999999999,5,4,2,11,Loyal
23281,117,7,973.36,4,1,2,7,Regulars
23282,77,12,3553.65,4,4,5,13,Champions
23283,149,9,691.14,3,2,1,6,Regulars
23284,127,16,3649.48,4,5,5,14,Champions
23285,22,12,3000.88,5,4,5,14,Champions
23286,188,6,2617.7400000000002,3,1,5,9,Big Spenders
23287,992,5,371.90999999999997,1,1,1,3,Hibernating
23288,603,9,923.7,1,2,2,5,Hibernating
23289,13,9,2030.56,5,2,4,11,Big Spenders
23290,534,9,877.2,1,2,2,5,Hibernating
23291,162,12,519.77,3,4,1,8,Regulars
23292,219,10,1732.88,3,3,4,10,Big Spenders
23293,130,14,1774.27,4,5,4,13,Champions
23294,96,13,2232.28,4,4,4,12,Champions
23295,513,11,1368.32,1,3,3,7,Regulars
23296,553,5,1467.35,1,1,3,5,Regulars
23297,171,10,1716.8,3,3,3,9,Regulars
23298,225,15,2782.86,3,5,5,13,Big Spenders
23299,32,7,2667.54,5,1,5,11,Big Spenders
23300,89,14,1823.26,4,5,4,13,Champions
23301,357,9,1049.73,2,2,2,6,Hibernating
23302,97,13,917.26,4,4,2,10,Loyal
23303,584,5,1596.96,1,1,3,5,Regulars
23304,972,7,657.6700000000001,1,1,1,3,Hibernating
23305,127,12,986.02,4,4,2,10,Loyal
23306,275,14,5497.96,2,5,5,12,At Risk
23307,295,20,2151.01,2,5,4,11,At Risk
23308,112,10,1165.22,4,3,2,9,Loyal
23309,231,4,482.56,3,1,1,5,Regulars
23310,253,16,2216.2400000000002,2,5,4,11,At Risk
23311,544,10,1571.32,1,3,3,7,Regulars
23312,9,15,1720.98,5,5,3,13,Loyal
23313,7,9,510.72,5,2,1,8,Regulars
23314,40,12,1444.0700000000002,5,4,3,12,Loyal
23315,216,16,5631.98,3,5,5,13,Big Spenders
23316,254,11,1801.3700000000001,2,3,4,9,Regulars
23317,111,9,1400.53,4,2,3,9,Regulars
23318,266,7,278.48,2,1,1,4,Hibernating
23319,216,11,1437.45,3,3,3,9,Regulars
23320,229,15,1300.05,3,5,3,11,Regulars
23321,82,14,2514.19,4,5,4,13,Champions
23322,318,11,647.4,2,3,1,6,Regulars
23323,401,7,1906.98,2,1,4,7,Regulars
23324,277,10,2255.8500000000004,2,3,4,9,Regulars
23325,551,6,567.04,1,1,1,3,Hibernating
23326,330,11,2841.88,2,3,5,10,Regulars
23327,74,11,3776.76,4,3,5,12,Loyal
23328,290,7,2120.11,2,1,4,7,Regulars
23329,95,6,390.64,4,1,1,6,Regulars
23330,493,8,1622.63,1,2,3,6,Regulars
23331,125,6,859.96,4,1,2,7,Regulars
23332,386,6,900.99,2,1,2,5,Hibernating
23333,446,12,2219.59,2,4,4,10,At Risk
23334,276,7,969.49,2,1,2,5,Hibernating
23335,691,9,1563.73,1,2,3,6,Regulars
23336,127,12,975.0699999999999,4,4,2,10,Loyal
23337,54,15,3147.02,5,5,5,15,Champions
23338,773,6,3367.74,1,1,5,7,Regulars
23339,204,10,806.97,3,3,1,7,Regulars
23340,167,4,674.85,3,1,1,5,Regulars
23341,278,7,893.13,2,1,2,5,Hibernating
23342,201,12,1392.29,3,4,3,10,Regulars
23343,143,10,1062.6,4,3,2,9,Loyal
23344,316,14,1583.4,2,5,3,10,At Risk
23345,107,11,1779.8400000000001,4,3,4,11,Loyal
23346,80,13,1533.54,4,4,3,11,Loyal
23347,37,15,2058.73,5,5,4,14,Champions
23348,530,17,2818.98,1,5,5,11,At Risk
23349,114,8,2525.4900000000002,4,2,4,10,Big Spenders
23350,32,2,534.56,5,1,1,7,Regulars
23351,750,8,3805.11,1,2,5,8,Regulars
23352,40,7,2609.8799999999997,5,1,5,11,Big Spenders
23353,443,3,414.18,2,1,1,4,Hibernating
23354,519,5,1977.32,1,1,4,6,Regulars
23355,106,13,3462.32,4,4,5,13,Champions
23356,157,16,1358.3899999999999,3,5,3,11,Regulars
23357,866,10,698.6700000000001,1,3,1,5,Regulars
23358,860,9,757.69,1,2,1,4,Hibernating
23359,275,12,2155.35,2,4,4,10,At Risk
23360,357,12,791.08,2,4,1,7,At Risk
23361,34,11,2663.77,5,3,5,13,Loyal
23362,120,11,925.55,4,3,2,9,Loyal
23363,221,6,2281.1400000000003,3,1,4,8,Big Spenders
23364,65,7,931.3399999999999,5,1,2,8,Regulars
23365,137,13,1906.49,4,4,4,12,Champions
23366,167,9,1332.4,3,2,3,8,Regulars
23367,307,13,4100.36,2,4,5,11,At Risk
23368,302,8,857.11,2,2,2,6,Hibernating
23369,35,17,1301.46,5,5,3,13,Loyal
23370,124,6,788.98,4,1,1,6,Regulars
23371,2704,2,1138.64,1,1,2,4,Hibernating
23372,751,7,1926.94,1,1,4,6,Regulars
23373,237,10,641.83,3,3,1,7,Regulars
23374,346,11,797.21,2,3,1,6,Regulars
23375,143,10,1534.49,4,3,3,10,Loyal
23376,123,12,2079.94,4,4,4,12,Champions
23377,262,12,1382.54,2,4,3,9,At Risk
23378,437,8,767.98,2,2,1,5,Hibernating
23379,421,13,1896.47,2,4,4,10,At Risk
23380,338,10,4347.1,2,3,5,10,Regulars
23381,109,13,751.22,4,4,1,9,Loyal
23382,285,8,1223.63,2,2,2,6,Hibernating
23383,164,7,2947.18,3,1,5,9,Big Spenders
23384,708,8,1763.0900000000001,1,2,4,7,Regulars
23385,364,13,891.99,2,4,2,8,At Risk
23386,305,4,961.81,2,1,2,5,Hibernating
23387,220,14,3300.6800000000003,3,5,5,13,Big Spenders
23388,661,14,1424.6,1,5,3,9,At Risk
23389,428,7,572.35,2,1,1,4,Hibernating
23390,305,17,4137.06,2,5,5,12,At Risk
23391,198,13,4080.7799999999993,3,4,5,12,Big Spenders
23392,35,14,3020.43,5,5,5,15,Champions
23393,551,7,830.8899999999999,1,1,1,3,Hibernating
23394,134,13,1805.7099999999998,4,4,4,12,Champions
23395,439,14,4346.37,2,5,5,12,At Risk
23396,498,9,820.51,1,2,1,4,Hibernating
23397,224,12,2173.49,3,4,4,11,Big Spenders
23398,744,8,743.31,1,2,1,4,Hibernating
23399,390,11,1588.98,2,3,3,8,Regulars
23400,180,9,1463.43,3,2,3,8,Regulars
23401,552,10,1350.02,1,3,3,7,Regulars
23402,263,17,1967.17,2,5,4,11,At Risk
23403,17,6,3279.9599999999996,5,1,5,11,Big Spenders
23404,152,8,1009.06,3,2,2,7,Regulars
23405,107,8,949.9100000000001,4,2,2,8,Regulars
23406,216,12,1476.24,3,4,3,10,Regulars
23407,485,11,1495.51,1,3,3,7,Regulars
23408,192,10,1629.2,3,3,3,9,Regulars
23409,1273,10,3347.1,1,3,5,9,Regulars
23410,18,10,1539.83,5,3,3,11,Loyal
23411,33,13,2518.98,5,4,4,13,Champions
23412,808,7,1195.11,1,1,2,4,Hibernating
23413,110,5,616.34,4,1,1,6,Regulars
23414,252,7,489.80999999999995,2,1,1,4,Hibernating
23415,228,11,1215.8,3,3,2,8,Regulars
23416,287,9,962.22,2,2,2,6,Hibernating
23417,399,9,1252.25,2,2,3,7,Regulars
23418,408,8,678.4399999999999,2,2,1,5,Hibernating
23419,88,7,946.83,4,1,2,7,Regulars
23420,45,10,1761.1399999999999,5,3,4,12,Loyal
23421,421,13,2920.1900000000005,2,4,5,11,At Risk
23422,339,9,2630.0,2,2,5,9,Regulars
23423,353,9,2873.87,2,2,5,9,Regulars
23424,136,11,3871.61,4,3,5,12,Loyal
23425,22,12,1273.63,5,4,3,12,Loyal
23426,53,13,1662.7900000000002,5,4,3,12,Loyal
23427,442,6,511.43,2,1,1,4,Hibernating
23428,92,8,2208.38,4,2,4,10,Big Spenders
23429,204,8,1288.76,3,2,3,8,Regulars
23430,387,15,1621.62,2,5,3,10,At Risk
23431,42,5,2826.87,5,1,5,11,Big Spenders
23432,110,10,1144.04,4,3,2,9,Loyal
23433,554,7,981.5600000000001,1,1,2,4,Hibernating
23434,188,9,674.99,3,2,1,6,Regulars
23435,108,10,1972.88,4,3,4,11,Loyal
23436,96,12,1553.24,4,4,3,11,Loyal
23437,456,11,1735.32,2,3,4,9,Regulars
23438,33,13,1086.17,5,4,2,11,Loyal
23439,204,9,826.14,3,2,1,6,Regulars
23440,21,4,357.61,5,1,1,7,Regulars
23441,938,4,935.8699999999999,1,1,2,4,Hibernating
23442,52,10,2269.95,5,3,4,12,Loyal
23443,190,9,1397.5900000000001,3,2,3,8,Regulars
23444,157,14,4756.4,3,5,5,13,Big Spenders
23445,232,14,2762.44,3,5,5,13,Big Spenders
23446,551,5,619.28,1,1,1,3,Hibernating
23447,577,2,17.44,1,1,1,3,Hibernating
23448,404,9,1108.25,2,2,2,6,Hibernating
23449,318,10,1441.31,2,3,3,8,Regulars
23450,99,12,1245.1100000000001,4,4,3,11,Loyal
23451,131,16,2350.84,4,5,4,13,Champions
23452,51,10,1986.61,5,3,4,12,Loyal
23453,609,13,3582.15,1,4,5,10,At Risk
23454,473,8,1123.83,1,2,2,5,Hibernating
23455,203,8,1272.97,3,2,3,8,Regulars
23456,173,11,1097.8799999999999,3,3,2,8,Regulars
23457,191,7,1152.02,3,1,2,6,Regulars
23458,196,6,1003.14,3,1,2,6,Regulars
23459,291,6,717.94,2,1,1,4,Hibernating
23460,19,14,904.4,5,5,2,12,Loyal
23461,203,10,3308.6600000000003,3,3,5,11,Big Spenders
23462,114,19,4842.4800000000005,4,5,5,14,Champions
23463,539,8,1525.6200000000001,1,2,3,6,Regulars
23464,435,9,685.18,2,2,1,5,Hibernating
23465,839,7,1232.15,1,1,2,4,Hibernating
23466,132,5,849.63,4,1,2,7,Regulars
23467,1307,10,1254.85,1,3,3,7,Regulars
23468,204,13,2918.44,3,4,5,12,Big Spenders
23469,805,10,1104.06,1,3,2,6,Regulars
23470,110,8,862.9100000000001,4,2,2,8,Regulars
23471,73,14,977.5,4,5,2,11,Loyal
23472,654,11,910.61,1,3,2,6,Regulars
23473,227,9,767.99,3,2,1,6,Regulars
23474,271,5,4772.93,2,1,5,8,Regulars
23475,107,10,1447.11,4,3,3,10,Loyal
23476,110,12,1534.46,4,4,3,11,Loyal
23477,166,12,2186.44,3,4,4,11,Big Spenders
23478,120,11,1972.13,4,3,4,11,Loyal
23479,474,9,1471.21,1,2,3,6,Regulars
23480,159,10,4017.9700000000003,3,3,5,11,Big Spenders
23481,358,9,902.91,2,2,2,6,Hibernating
23482,402,9,1099.95,2,2,2,6,Hibernating
23483,440,8,673.77,2,2,1,5,Hibernating
23484,715,14,2096.34,1,5,4,10,At Risk
23485,86,10,1452.95,4,3,3,10,Loyal
23486,11,12,1499.45,5,4,3,12,Loyal
23487,315,10,4026.04,2,3,5,10,Regulars
23488,407,7,477.82,2,1,1,4,Hibernating
23489,180,5,3678.81,3,1,5,9,Big Spenders
23490,202,11,1825.9099999999999,3,3,4,10,Big Spenders
23491,471,13,5161.05,1,4,5,10,At Risk
23492,222,13,2510.1200000000003,3,4,4,11,Big Spenders
23493,2,12,1764.28,5,4,4,13,Champions
23494,262,9,1311.01,2,2,3,7,Regulars
23495,60,19,2350.36,5,5,4,14,Champions
23496,231,11,1016.45,3,3,2,8,Regulars
23497,59,10,1047.0600000000002,5,3,2,10,Loyal
23498,187,12,1835.26,3,4,4,11,Big Spenders
23499,263,13,1733.1100000000001,2,4,4,10,At Risk
23500,253,7,1136.21,2,1,2,5,Hibernating
23501,178,14,2905.7000000000003,3,5,5,13,Big Spenders
23502,204,7,2260.9,3,1,4,8,Big Spenders
23503,136,15,2078.59,4,5,4,13,Champions
23504,76,9,527.12,4,2,1,7,Regulars
23505,590,7,1432.22,1,1,3,5,Regulars
23506,1105,9,1138.68,1,2,2,5,Hibernating
23507,181,9,782.59,3,2,1,6,Regulars
23508,448,13,2388.68,2,4,4,10,At Risk
23509,218,11,2073.1,3,3,4,10,Big Spenders
23510,156,13,1284.22,3,4,3,10,Regulars
23511,828,6,1247.44,1,1,3,5,Regulars
23512,403,11,1854.59,2,3,4,9,Regulars
23513,39,10,2586.03,5,3,5,13,Loyal
23514,22,8,470.58000000000004,5,2,1,8,Regulars
23515,505,6,737.04,1,1,1,3,Hibernating
23516,1008,5,285.24,1,1,1,3,Hibernating
23517,107,12,3008.7000000000003,4,4,5,13,Champions
23518,76,13,3062.9700000000003,4,4,5,13,Champions
23519,444,11,1167.81,2,3,2,7,Regulars
23520,30,9,984.05,5,2,2,9,Regulars
23521,133,4,149.93,4,1,1,6,Regulars
23522,143,17,1319.16,4,5,3,12,Loyal
23523,692,7,680.81,1,1,1,3,Hibernating
23524,604,7,940.35,1,1,2,4,Hibernating
23525,310,12,800.66,2,4,1,7,At Risk
23526,149,7,317.82,3,1,1,5,Regulars
23527,684,14,1890.3899999999999,1,5,4,10,At Risk
23528,353,8,900.11,2,2,2,6,Hibernating
23529,88,16,3322.68,4,5,5,14,Champions
23530,321,14,1662.17,2,5,3,10,At Risk
23531,466,5,311.38,1,1,1,3,Hibernating
23532,29,11,1305.96,5,3,3,11,Loyal
23533,755,7,1087.63,1,1,2,4,Hibernating
23534,79,12,1717.6100000000001,4,4,3,11,Loyal
23535,33,16,7241.09,5,5,5,15,Champions
23536,592,12,2760.4300000000003,1,4,5,10,At Risk
23537,77,9,746.8299999999999,4,2,1,7,Regulars
23538,154,11,1114.9099999999999,3,3,2,8,Regulars
23539,4,9,668.44,5,2,1,8,Regulars
23540,90,13,3430.68,4,4,5,13,Champions
23541,118,8,1662.8100000000002,4,2,3,9,Regulars
23542,376,12,960.6700000000001,2,4,2,8,At Risk
23543,221,13,3830.1,3,4,5,12,Big Spenders
23544,0,12,1463.67,5,4,3,12,Loyal
23545,47,6,1987.85,5,1,4,10,Big Spenders
23546,1,16,1548.86,5,5,3,13,Loyal
23547,539,12,1546.93,1,4,3,8,At Risk
23548,135,9,456.55,4,2,1,7,Regulars
23549,370,15,1160.6100000000001,2,5,2,9,At Risk
23550,189,17,2543.01,3,5,4,12,Big Spenders
23551,492,13,3800.7499999999995,1,4,5,10,At Risk
23552,174,9,4016.99,3,2,5,10,Big Spenders
23553,944,11,1434.6399999999999,1,3,3,7,Regulars
23554,37,7,3993.23,5,1,5,11,Big Spenders
23555,525,10,2309.61,1,3,4,8,Regulars
23556,570,6,698.61,1,1,1,3,Hibernating
23557,881,10,1975.63,1,3,4,8,Regulars
23558,317,7,615.9200000000001,2,1,1,4,Hibernating
23559,202,9,1702.26,3,2,3,8,Regulars
23560,735,9,1106.24,1,2,2,5,Hibernating
23561,581,13,1168.85,1,4,2,7,At Risk
23562,720,10,2103.11,1,3,4,8,Regulars
23563,467,9,996.37,1,2,2,5,Hibernating
23564,15,7,484.83,5,1,1,7,Regulars
23565,392,7,1024.4599999999998,2,1,2,5,Hibernating
23566,441,17,5026.990000000001,2,5,5,12,At Risk
23567,283,15,3033.2599999999998,2,5,5,12,At Risk
23568,289,15,5147.68,2,5,5,12,At Risk
23569,208,6,737.99,3,1,1,5,Regulars
23570,95,11,2057.5099999999998,4,3,4,11,Loyal
23571,30,16,1773.89,5,5,4,14,Champions
23572,395,12,3922.1899999999996,2,4,5,11,At Risk
23573,133,15,4936.070000000001,4,5,5,14,Champions
23574,152,6,500.51,3,1,1,5,Regulars
23575,74,13,1035.2,4,4,2,10,Loyal
23576,338,6,1137.3899999999999,2,1,2,5,Hibernating
23577,523,12,1439.8300000000002,1,4,3,8,At Risk
23578,184,14,1064.26,3,5,2,10,Regulars
23579,172,8,1495.24,3,2,3,8,Regulars
23580,81,21,2272.21,4,5,4,13,Champions
23581,1593,5,486.5999999999999,1,1,1,3,Hibernating
23582,40,10,1880.15,5,3,4,12,Loyal
23583,25,14,2158.7,5,5,4,14,Champions
23584,197,10,1774.6599999999999,3,3,4,10,Big Spenders
23585,616,8,2236.27,1,2,4,7,Regulars
23586,530,8,716.1,1,2,1,4,Hibernating
23587,625,7,574.74,1,1,1,3,Hibernating
23588,168,11,2214.89,3,3,4,10,Big Spenders
23589,63,6,562.57,5,1,1,7,Regulars
23590,1593,8,1348.78,1,2,3,6,Regulars
23591,343,13,1426.85,2,4,3,9,At Risk
23592,46,7,701.28,5,1,1,7,Regulars
23593,7,9,1018.45,5,2,2,9,Regulars
23594,61,20,4902.96,5,5,5,15,Champions
23595,25,12,1353.1799999999998,5,4,3,12,Loyal
23596,378,12,3438.78,2,4,5,11,At Risk
23597,221,10,1213.07,3,3,2,8,Regulars
23598,118,10,3976.0299999999997,4,3,5,12,Loyal
23599,586,6,3082.02,1,1,5,7,Regulars
23600,175,10,2354.66,3,3,4,10,Big Spenders
23601,575,9,1153.95,1,2,2,5,Hibernating
23602,287,9,1299.9,2,2,3,7,Regulars
23603,599,7,808.82,1,1,1,3,Hibernating
23604,318,16,1109.97,2,5,2,9,At Risk
23605,109,13,3306.5099999999998,4,4,5,13,Champions
23606,828,9,1128.81,1,2,2,5,Hibernating
23607,18,11,1867.66,5,3,4,12,Loyal
23608,71,7,2315.73,4,1,4,9,Big Spenders
23609,7,10,1882.3,5,3,4,12,Loyal
23610,104,8,548.6700000000001,4,2,1,7,Regulars
23611,68,11,993.37,4,3,2,9,Loyal
23612,150,12,869.31,3,4,2,9,Regulars
23613,81,9,501.26,4,2,1,7,Regulars
23614,853,6,2846.74,1,1,5,7,Regulars
23615,119,11,1636.3200000000002,4,3,3,10,Loyal
23616,166,7,735.99,3,1,1,5,Regulars
23617,119,13,2078.38,4,4,4,12,Champions
23618,139,11,1874.51,4,3,4,11,Loyal
23619,64,12,1326.94,5,4,3,12,Loyal
23620,202,12,984.2700000000001,3,4,2,9,Regulars
23621,22,13,4195.12,5,4,5,14,Champions
23622,561,9,763.53,1,2,1,4,Hibernating
23623,142,14,2489.15,4,5,4,13,Champions
23624,30,12,1945.95,5,4,4,13,Champions
23625,354,9,1984.3999999999999,2,2,4,8,Regulars
23626,598,11,3156.58,1,3,5,9,Regulars
23627,191,10,1660.29,3,3,3,9,Regulars
23628,798,9,1384.98,1,2,3,6,Regulars
23629,133,8,1157.72,4,2,2,8,Regulars
23630,6,17,2593.08,5,5,5,15,Champions
23631,59,4,403.12,5,1,1,7,Regulars
23632,456,4,324.06,2,1,1,4,Hibernating
23633,60,6,861.46,5,1,2,8,Regulars
23634,66,7,887.5899999999999,4,1,2,7,Regulars
23635,137,10,1231.52,4,3,2,9,Loyal
23636,896,13,1683.96,1,4,3,8,At Risk
23637,348,16,4449.29,2,5,5,12,At Risk
23638,162,8,1943.74,3,2,4,9,Big Spenders
23639,302,14,4518.82,2,5,5,12,At Risk
23640,351,12,3417.73,2,4,5,11,At Risk
23641,180,6,893.21,3,1,2,6,Regulars
23642,443,5,241.73,2,1,1,4,Hibernating
23643,37,15,1249.77,5,5,3,13,Loyal
23644,425,7,1103.37,2,1,2,5,Hibernating
23645,129,12,5150.400000000001,4,4,5,13,Champions
23646,670,12,1110.67,1,4,2,7,At Risk
23647,141,14,4536.02,4,5,5,14,Champions
23648,100,15,1536.6299999999999,4,5,3,12,Loyal
23649,672,12,1067.16,1,4,2,7,At Risk
23650,379,4,914.6299999999999,2,1,2,5,Hibernating
23651,227,11,1695.71,3,3,3,9,Regulars
23652,445,11,3224.16,2,3,5,10,Regulars
23653,88,12,2457.38,4,4,4,12,Champions
23654,1008,11,2495.5699999999997,1,3,4,8,Regulars
23655,95,10,1201.48,4,3,2,9,Loyal
23656,23,6,607.78,5,1,1,7,Regulars
23657,230,7,658.33,3,1,1,5,Regulars
23658,368,8,852.78,2,2,2,6,Hibernating
23659,57,8,1969.22,5,2,4,11,Big Spenders
23660,371,8,1180.21,2,2,2,6,Hibernating
23661,186,9,2500.74,3,2,4,9,Big Spenders
23662,344,10,1363.87,2,3,3,8,Regulars
23663,1296,7,2098.4,1,1,4,6,Regulars
23664,319,7,714.0799999999999,2,1,1,4,Hibernating
23665,19,11,1808.0,5,3,4,12,Loyal
23666,459,16,3762.0499999999997,2,5,5,12,At Risk
23667,65,16,1646.85,5,5,3,13,Loyal
23668,104,12,3897.0,4,4,5,13,Champions
23669,260,6,256.34,2,1,1,4,Hibernating
23670,159,12,923.04,3,4,2,9,Regulars
23671,248,7,516.59,2,1,1,4,Hibernating
23672,259,5,811.3700000000001,2,1,1,4,Hibernating
23673,8,8,1069.67,5,2,2,9,Regulars
23674,128,13,1341.24,4,4,3,11,Loyal
23675,313,15,2655.41,2,5,5,12,At Risk
23676,182,8,451.78,3,2,1,6,Regulars
23677,2081,4,317.2,1,1,1,3,Hibernating
23678,198,19,3245.2,3,5,5,13,Big Spenders
23679,516,7,703.86,1,1,1,3,Hibernating
23680,251,13,1868.33,2,4,4,10,At Risk
23681,174,15,2806.08,3,5,5,13,Big Spenders
23682,99,9,1951.61,4,2,4,10,Big Spenders
23683,23,8,1300.1299999999999,5,2,3,10,Regulars
23684,284,7,3997.22,2,1,5,8,Regulars
23685,463,4,887.09,1,1,2,4,Hibernating
23686,82,18,2781.5299999999997,4,5,5,14,Champions
23687,289,13,2412.2,2,4,4,10,At Risk
23688,382,8,859.01,2,2,2,6,Hibernating
23689,98,7,909.1700000000001,4,1,2,7,Regulars
23690,556,6,1025.3,1,1,2,4,Hibernating
23691,45,13,5433.0199999999995,5,4,5,14,Champions
23692,88,7,722.26,4,1,1,6,Regulars
23693,474,11,755.79,1,3,1,5,Regulars
23694,3,14,3612.7400000000002,5,5,5,15,Champions
23695,33,12,1694.48,5,4,3,12,Loyal
23696,132,7,1287.6000000000001,4,1,3,8,Regulars
23697,685,8,964.9799999999999,1,2,2,5,Hibernating
23698,96,9,1482.88,4,2,3,9,Regulars
23699,447,8,486.24,2,2,1,5,Hibernating
23700,152,10,1476.81,3,3,3,9,Regulars
23701,15,11,1182.63,5,3,2,10,Loyal
23702,508,5,408.22,1,1,1,3,Hibernating
23703,76,14,2350.16,4,5,4,13,Champions
23704,615,7,865.76,1,1,2,4,Hibernating
23705,0,12,3375.09,5,4,5,14,Champions
23706,123,12,3638.35,4,4,5,13,Champions
23707,556,5,359.48,1,1,1,3,Hibernating
23708,111,15,1708.55,4,5,3,12,Loyal
23709,231,13,3562.69,3,4,5,12,Big Spenders
23710,601,7,1435.64,1,1,3,5,Regulars
23711,87,13,4751.3099999999995,4,4,5,13,Champions
23712,1148,7,1073.23,1,1,2,4,Hibernating
23713,313,10,1593.38,2,3,3,8,Regulars
23714,482,13,5620.42,1,4,5,10,At Risk
23715,432,11,854.2,2,3,2,7,Regulars
23716,739,9,752.41,1,2,1,4,Hibernating
23717,1054,3,337.91999999999996,1,1,1,3,Hibernating
23718,164,10,831.54,3,3,1,7,Regulars
23719,151,17,2019.35,3,5,4,12,Big Spenders
23720,125,10,3163.8,4,3,5,12,Loyal
23721,124,14,2136.16,4,5,4,13,Champions
23722,630,9,1046.8,1,2,2,5,Hibernating
23723,195,12,2542.97,3,4,4,11,Big Spenders
23724,104,7,702.16,4,1,1,6,Regulars
23725,752,12,796.4,1,4,1,6,At Risk
23726,82,10,1306.95,4,3,3,10,Loyal
23727,735,8,655.42,1,2,1,4,Hibernating
23728,756,8,1204.13,1,2,2,5,Hibernating
23729,86,9,798.71,4,2,1,7,Regulars
23730,159,10,1508.16,3,3,3,9,Regulars
23731,351,9,886.42,2,2,2,6,Hibernating
23732,723,17,4094.7400000000002,1,5,5,11,At Risk
23733,26,10,1925.6999999999998,5,3,4,12,Loyal
23734,149,15,1364.45,3,5,3,11,Regulars
23735,265,8,1868.82,2,2,4,8,Regulars
23736,43,12,2156.39,5,4,4,13,Champions
23737,324,10,1433.0800000000002,2,3,3,8,Regulars
23738,404,8,542.25,2,2,1,5,Hibernating
23739,219,11,4626.56,3,3,5,11,Big Spenders
23740,237,7,493.23,3,1,1,5,Regulars
23741,302,8,901.77,2,2,2,6,Hibernating
23742,714,10,2562.9,1,3,4,8,Regulars
23743,447,7,882.1,2,1,2,5,Hibernating
23744,81,10,1126.98,4,3,2,9,Loyal
23745,219,7,508.55,3,1,1,5,Regulars
23746,1512,6,1819.0900000000001,1,1,4,6,Regulars
23747,150,7,697.88,3,1,1,5,Regulars
23748,696,8,719.3,1,2,1,4,Hibernating
23749,347,12,1113.72,2,4,2,8,At Risk
23750,47,6,2174.66,5,1,4,10,Big Spenders
23751,576,13,1987.32,1,4,4,9,At Risk
23752,23,11,1076.94,5,3,2,10,Loyal
23753,544,10,4055.56,1,3,5,9,Regulars
23754,47,5,3418.4,5,1,5,11,Big Spenders
23755,38,12,1690.56,5,4,3,12,Loyal
23756,19,12,668.36,5,4,1,10,Loyal
23757,329,7,2557.66,2,1,4,7,Regulars
23758,44,6,749.24,5,1,1,7,Regulars
23759,192,16,3735.76,3,5,5,13,Big Spenders
23760,239,5,446.79,3,1,1,5,Regulars
23761,118,7,549.4300000000001,4,1,1,6,Regulars
23762,497,8,1405.88,1,2,3,6,Regulars
23763,902,8,1473.03,1,2,3,6,Regulars
23764,49,2,79.72999999999999,5,1,1,7,Regulars
23765,179,12,1555.35,3,4,3,10,Regulars
23766,135,11,4223.46,4,3,5,12,Loyal
23767,23,8,936.2700000000001,5,2,2,9,Regulars
23768,161,12,1361.87,3,4,3,10,Regulars
23769,124,11,969.0899999999999,4,3,2,9,Loyal
23770,175,9,1150.66,3,2,2,7,Regulars
23771,625,11,2052.8,1,3,4,8,Regulars
23772,52,14,2945.9400000000005,5,5,5,15,Champions
23773,190,5,539.91,3,1,1,5,Regulars
23774,1041,5,887.51,1,1,2,4,Hibernating
23775,59,11,1589.44,5,3,3,11,Loyal
23776,238,12,4130.4,3,4,5,12,Big Spenders
23777,186,13,1176.14,3,4,2,9,Regulars
23778,186,12,1913.67,3,4,4,11,Big Spenders
23779,432,8,1759.1200000000001,2,2,4,8,Regulars
23780,919,4,314.25,1,1,1,3,Hibernating
23781,331,8,1089.94,2,2,2,6,Hibernating
23782,109,7,2361.27,4,1,4,9,Big Spenders
23783,174,8,763.3900000000001,3,2,1,6,Regulars
23784,156,8,1081.3600000000001,3,2,2,7,Regulars
23785,463,4,550.3,1,1,1,3,Hibernating
23786,174,14,5936.08,3,5,5,13,Big Spenders
23787,14,16,1983.97,5,5,4,14,Champions
23788,331,14,3604.95,2,5,5,12,At Risk
23789,188,7,1033.5,3,1,2,6,Regulars
23790,455,14,3073.89,2,5,5,12,At Risk
23791,460,11,4532.969999999999,1,3,5,9,Regulars
23792,55,8,1421.5900000000001,5,2,3,10,Regulars
23793,366,17,4333.54,2,5,5,12,At Risk
23794,1339,5,306.04999999999995,1,1,1,3,Hibernating
23795,406,14,1189.6,2,5,2,9,At Risk
23796,152,10,4297.07,3,3,5,11,Big Spenders
23797,175,8,880.78,3,2,2,7,Regulars
23798,1442,3,304.55,1,1,1,3,Hibernating
23799,389,6,951.04,2,1,2,5,Hibernating
23800,93,12,2820.12,4,4,5,13,Champions
23801,310,15,3364.6,2,5,5,12,At Risk
23802,224,8,2612.19,3,2,5,10,Big Spenders
23803,174,6,609.0,3,1,1,5,Regulars
23804,378,11,2212.49,2,3,4,9,Regulars
23805,208,9,651.42,3,2,1,6,Regulars
23806,126,9,1058.17,4,2,2,8,Regulars
23807,287,7,1466.07,2,1,3,6,Regulars
23808,315,12,1945.78,2,4,4,10,At Risk
23809,65,11,862.8,5,3,2,10,Loyal
23810,35,9,3847.3,5,2,5,12,Big Spenders
23811,118,12,1416.22,4,4,3,11,Loyal
23812,527,13,2544.95,1,4,4,9,At Risk
23813,481,9,1258.22,1,2,3,6,Regulars
23814,177,7,2005.5100000000002,3,1,4,8,Big Spenders
23815,576,9,995.8,1,2,2,5,Hibernating
23816,456,9,2921.4,2,2,5,9,Regulars
23817,663,5,229.42999999999998,1,1,1,3,Hibernating
23818,223,8,2334.38,3,2,4,9,Big Spenders
23819,158,8,1524.26,3,2,3,8,Regulars
23820,948,5,432.25,1,1,1,3,Hibernating
23821,76,7,510.77,4,1,1,6,Regulars
23822,184,7,789.19,3,1,1,5,Regulars
23823,174,8,1960.34,3,2,4,9,Big Spenders
23824,68,14,3596.24,4,5,5,14,Champions
23825,194,5,762.1099999999999,3,1,1,5,Regulars
23826,179,13,1087.48,3,4,2,9,Regulars
23827,390,9,881.93,2,2,2,6,Hibernating
23828,392,10,1212.74,2,3,2,7,Regulars
23829,237,10,1141.01,3,3,2,8,Regulars
23830,144,14,1334.21,4,5,3,12,Loyal
23831,26,10,1468.1100000000001,5,3,3,11,Loyal
23832,188,9,390.41,3,2,1,6,Regulars
23833,551,7,516.28,1,1,1,3,Hibernating
23834,260,11,364.5,2,3,1,6,Regulars
23835,62,14,1261.33,5,5,3,13,Loyal
23836,393,6,1593.42,2,1,3,6,Regulars
23837,110,7,708.83,4,1,1,6,Regulars
23838,968,9,752.18,1,2,1,4,Hibernating
23839,60,17,3803.4700000000003,5,5,5,15,Champions
23840,1,14,1803.46,5,5,4,14,Champions
23841,495,7,1380.3100000000002,1,1,3,5,Regulars
23842,130,5,3116.32,4,1,5,10,Big Spenders
23843,95,7,1496.5099999999998,4,1,3,8,Regulars
23844,240,12,1378.15,3,4,3,10,Regulars
23845,545,9,668.43,1,2,1,4,Hibernating
23846,385,12,6345.27,2,4,5,11,At Risk
23847,723,10,1287.42,1,3,3,7,Regulars
23848,245,10,1226.72,3,3,2,8,Regulars
23849,384,8,454.58,2,2,1,5,Hibernating
23850,205,13,2167.64,3,4,4,11,Big Spenders
23851,244,9,791.5799999999999,3,2,1,6,Regulars
23852,66,16,4295.37,4,5,5,14,Champions
23853,371,6,713.42,2,1,1,4,Hibernating
23854,10,17,2681.9799999999996,5,5,5,15,Champions
23855,110,12,2442.35,4,4,4,12,Champions
23856,177,17,1473.96,3,5,3,11,Regulars
23857,523,8,2765.56,1,2,5,8,Regulars
23858,133,12,3098.44,4,4,5,13,Champions
23859,233,11,2335.05,3,3,4,10,Big Spenders
23860,522,7,636.23,1,1,1,3,Hibernating
23861,270,15,1841.95,2,5,4,11,At Risk
23862,551,7,765.4,1,1,1,3,Hibernating
23863,296,10,1026.85,2,3,2,7,Regulars
23864,631,6,1455.02,1,1,3,5,Regulars
23865,291,18,8617.15,2,5,5,12,At Risk
23866,698,12,1514.54,1,4,3,8,At Risk
23867,57,7,1287.48,5,1,3,9,Regulars
23868,54,17,1683.08,5,5,3,13,Loyal
23869,142,13,801.01,4,4,1,9,Loyal
23870,279,6,1756.5800000000002,2,1,4,7,Regulars
23871,78,11,940.25,4,3,2,9,Loyal
23872,224,13,3394.62,3,4,5,12,Big Spenders
23873,81,13,1105.15,4,4,2,10,Loyal
23874,137,14,3923.89,4,5,5,14,Champions
23875,317,11,2305.27,2,3,4,9,Regulars
23876,55,15,1956.46,5,5,4,14,Champions
23877,367,6,916.29,2,1,2,5,Hibernating
23878,141,13,2748.72,4,4,5,13,Champions
23879,544,7,720.9,1,1,1,3,Hibernating
23880,476,13,1341.5700000000002,1,4,3,8,At Risk
23881,325,12,4253.62,2,4,5,11,At Risk
23882,611,6,1374.4,1,1,3,5,Regulars
23883,75,12,2481.2400000000002,4,4,4,12,Champions
23884,292,11,1476.25,2,3,3,8,Regulars
23885,132,7,733.27,4,1,1,6,Regulars
23886,99,8,2730.6800000000003,4,2,5,11,Big Spenders
23887,310,13,1889.1100000000001,2,4,4,10,At Risk
23888,65,10,1446.79,5,3,3,11,Loyal
23889,365,9,1180.14,2,2,2,6,Hibernating
23890,169,10,1425.0,3,3,3,9,Regulars
23891,152,11,1249.77,3,3,3,9,Regulars
23892,23,12,1873.62,5,4,4,13,Champions
23893,119,11,601.71,4,3,1,8,Loyal
23894,555,2,763.0799999999999,1,1,1,3,Hibernating
23895,1258,8,1271.5,1,2,3,6,Regulars
23896,5,9,559.17,5,2,1,8,Regulars
23897,178,14,3849.4,3,5,5,13,Big Spenders
23898,327,14,4459.83,2,5,5,12,At Risk
23899,160,12,2058.37,3,4,4,11,Big Spenders
23900,52,16,1864.87,5,5,4,14,Champions
23901,56,18,3628.1600000000003,5,5,5,15,Champions
23902,148,16,3759.27,3,5,5,13,Big Spenders
23903,65,6,913.4300000000001,5,1,2,8,Regulars
23904,174,9,1763.4299999999998,3,2,4,9,Big Spenders
23905,18,16,3590.27,5,5,5,15,Champions
23906,68,13,2394.7599999999998,4,4,4,12,Champions
23907,376,13,3166.6499999999996,2,4,5,11,At Risk
23908,119,9,925.36,4,2,2,8,Regulars
23909,0,8,1713.7,5,2,3,10,Regulars
23910,96,7,692.29,4,1,1,6,Regulars
23911,403,9,3661.1400000000003,2,2,5,9,Regulars
23912,453,7,611.9499999999999,2,1,1,4,Hibernating
23913,45,13,1840.0500000000002,5,4,4,13,Champions
23914,264,18,2529.56,2,5,4,11,At Risk
23915,599,9,2008.04,1,2,4,7,Regulars
23916,68,11,1569.72,4,3,3,10,Loyal
23917,77,11,1154.17,4,3,2,9,Loyal
23918,70,11,746.9,4,3,1,8,Loyal
23919,263,13,1356.77,2,4,3,9,At Risk
23920,30,10,1130.94,5,3,2,10,Loyal
23921,1749,5,940.95,1,1,2,4,Hibernating
23922,8,13,2364.92,5,4,4,13,Champions
23923,30,13,4026.84,5,4,5,14,Champions
23924,116,12,1711.82,4,4,3,11,Loyal
23925,14,12,2298.28,5,4,4,13,Champions
23926,155,13,1103.35,3,4,2,9,Regulars
23927,125,15,1996.2,4,5,4,13,Champions
23928,158,12,7178.46,3,4,5,12,Big Spenders
23929,564,7,441.40999999999997,1,1,1,3,Hibernating
23930,14,13,3514.43,5,4,5,14,Champions
23931,1060,7,600.77,1,1,1,3,Hibernating
23932,148,12,2694.7,3,4,5,12,Big Spenders
23933,1344,3,1073.44,1,1,2,4,Hibernating
23934,51,9,790.03,5,2,1,8,Regulars
23935,151,11,2387.35,3,3,4,10,Big Spenders
23936,101,9,1782.61,4,2,4,10,Big Spenders
23937,206,9,1043.26,3,2,2,7,Regulars
23938,272,9,1610.21,2,2,3,7,Regulars
23939,204,6,513.75,3,1,1,5,Regulars
23940,531,9,962.85,1,2,2,5,Hibernating
23941,7,15,1357.83,5,5,3,13,Loyal
23942,266,16,1052.38,2,5,2,9,At Risk
23943,1275,6,3496.3,1,1,5,7,Regulars
23944,602,9,934.38,1,2,2,5,Hibernating
23945,160,7,709.39,3,1,1,5,Regulars
23946,179,6,1079.82,3,1,2,6,Regulars
23947,190,13,3822.1800000000003,3,4,5,12,Big Spenders
23948,424,9,1243.7,2,2,3,7,Regulars
23949,277,17,2124.83,2,5,4,11,At Risk
23950,40,8,1528.1200000000001,5,2,3,10,Regulars
23951,99,13,1132.69,4,4,2,10,Loyal
23952,213,6,730.36,3,1,1,5,Regulars
23953,502,8,2664.3999999999996,1,2,5,8,Regulars
23954,4,7,805.12,5,1,1,7,Regulars
23955,54,15,1696.19,5,5,3,13,Loyal
23956,158,10,1049.65,3,3,2,8,Regulars
23957,497,10,973.21,1,3,2,6,Regulars
23958,201,12,1915.15,3,4,4,11,Big Spenders
23959,320,10,2947.67,2,3,5,10,Regulars
23960,765,10,1835.52,1,3,4,8,Regulars
23961,115,11,2124.94,4,3,4,11,Loyal
23962,60,12,1450.16,5,4,3,12,Loyal
23963,139,9,2357.4199999999996,4,2,4,10,Big Spenders
23964,232,13,4085.82,3,4,5,12,Big Spenders
23965,60,12,810.1500000000001,5,4,1,10,Loyal
23966,790,9,1344.47,1,2,3,6,Regulars
23967,760,4,660.02,1,1,1,3,Hibernating
23968,3,10,1858.89,5,3,4,12,Loyal
23969,371,10,1756.07,2,3,4,9,Regulars
23970,36,15,1189.85,5,5,2,12,Loyal
23971,512,11,1368.6,1,3,3,7,Regulars
23972,140,10,2031.3200000000002,4,3,4,11,Loyal
23973,61,4,247.63,5,1,1,7,Regulars
23974,975,6,459.12,1,1,1,3,Hibernating
23975,625,9,1348.05,1,2,3,6,Regulars
23976,664,15,3316.21,1,5,5,11,At Risk
23977,17,11,2842.5299999999997,5,3,5,13,Loyal
23978,169,12,3799.85,3,4,5,12,Big Spenders
23979,222,7,1343.7,3,1,3,7,Regulars
23980,50,13,1969.93,5,4,4,13,Champions
23981,158,12,2074.1,3,4,4,11,Big Spenders
23982,70,19,5371.82,4,5,5,14,Champions
23983,149,14,1770.3799999999999,3,5,4,12,Big Spenders
23984,152,8,957.25,3,2,2,7,Regulars
23985,159,12,1290.12,3,4,3,10,Regulars
23986,453,12,2179.8900000000003,2,4,4,10,At Risk
23987,705,13,1515.77,1,4,3,8,At Risk
23988,47,9,1183.54,5,2,2,9,Regulars
23989,213,9,644.14,3,2,1,6,Regulars
23990,535,13,935.96,1,4,2,7,At Risk
23991,415,13,1272.98,2,4,3,9,At Risk
23992,61,10,2198.62,5,3,4,12,Loyal
23993,233,8,593.57,3,2,1,6,Regulars
23994,91,5,661.04,4,1,1,6,Regulars
23995,16,14,1631.16,5,5,3,13,Loyal
23996,108,15,2063.46,4,5,4,13,Champions
23997,65,11,496.17,5,3,1,9,Loyal
23998,371,14,2651.6699999999996,2,5,5,12,At Risk
23999,251,14,4247.21,2,5,5,12,At Risk
24000,71,8,1086.56,4,2,2,8,Regulars
24001,311,12,2069.8,2,4,4,10,At Risk
24002,655,11,1783.38,1,3,4,8,Regulars
24003,167,10,3075.2,3,3,5,11,Big Spenders
24004,209,7,970.3900000000001,3,1,2,6,Regulars
24005,264,11,1301.96,2,3,3,8,Regulars
24006,625,5,426.31,1,1,1,3,Hibernating
24007,635,4,283.72,1,1,1,3,Hibernating
24008,227,6,636.2,3,1,1,5,Regulars
24009,54,11,2408.69,5,3,4,12,Loyal
24010,279,10,6213.08,2,3,5,10,Regulars
24011,83,11,1878.6,4,3,4,11,Loyal
24012,15,12,3379.1800000000003,5,4,5,14,Champions
24013,933,9,944.0699999999999,1,2,2,5,Hibernating
24014,243,10,1398.39,3,3,3,9,Regulars
24015,168,13,1444.14,3,4,3,10,Regulars
24016,89,9,2056.62,4,2,4,10,Big Spenders
24017,933,13,3543.95,1,4,5,10,At Risk
24018,91,10,1983.8700000000001,4,3,4,11,Loyal
24019,408,8,441.17,2,2,1,5,Hibernating
24020,5,12,5972.650000000001,5,4,5,14,Champions
24021,306,6,889.39,2,1,2,5,Hibernating
24022,30,15,2231.89,5,5,4,14,Champions
24023,522,9,2036.3000000000002,1,2,4,7,Regulars
24024,747,5,249.07,1,1,1,3,Hibernating
24025,6,12,1705.9599999999998,5,4,3,12,Loyal
24026,649,8,1333.4099999999999,1,2,3,6,Regulars
24027,707,8,796.0799999999999,1,2,1,4,Hibernating
24028,910,5,732.5,1,1,1,3,Hibernating
24029,249,7,712.75,2,1,1,4,Hibernating
24030,233,11,4089.77,3,3,5,11,Big Spenders
24031,6,8,490.87,5,2,1,8,Regulars
24032,227,10,2837.7799999999997,3,3,5,11,Big Spenders
24033,54,7,2403.52,5,1,4,10,Big Spenders
24034,310,5,416.0,2,1,1,4,Hibernating
24035,122,10,1647.44,4,3,3,10,Loyal
24036,799,7,314.66,1,1,1,3,Hibernating
24037,106,7,2698.64,4,1,5,10,Big Spenders
24038,127,11,1500.51,4,3,3,10,Loyal
24039,467,10,732.97,1,3,1,5,Regulars
24040,561,2,131.91,1,1,1,3,Hibernating
24041,66,16,3443.96,4,5,5,14,Champions
24042,201,14,3232.1,3,5,5,13,Big Spenders
24043,116,11,1146.97,4,3,2,9,Loyal
24044,70,11,2394.46,4,3,4,11,Loyal
24045,830,8,1147.4,1,2,2,5,Hibernating
24046,193,10,2457.8500000000004,3,3,4,10,Big Spenders
24047,195,11,936.9,3,3,2,8,Regulars
24048,823,6,1482.62,1,1,3,5,Regulars
24049,159,9,1378.36,3,2,3,8,Regulars
24050,520,7,1447.02,1,1,3,5,Regulars
24051,57,11,2216.64,5,3,4,12,Loyal
24052,198,9,1132.77,3,2,2,7,Regulars
24053,521,9,2053.41,1,2,4,7,Regulars
24054,337,17,3604.49,2,5,5,12,At Risk
24055,276,5,251.70999999999998,2,1,1,4,Hibernating
24056,32,14,3423.81,5,5,5,15,Champions
24057,64,7,533.91,5,1,1,7,Regulars
24058,58,8,1678.6499999999999,5,2,3,10,Regulars
24059,70,12,2400.12,4,4,4,12,Champions
24060,86,8,954.59,4,2,2,8,Regulars
24061,834,12,3330.35,1,4,5,10,At Risk
24062,29,8,2147.56,5,2,4,11,Big Spenders
24063,125,14,803.01,4,5,1,10,Loyal
24064,241,11,1859.97,3,3,4,10,Big Spenders
24065,108,8,356.49,4,2,1,7,Regulars
24066,1113,6,1143.5800000000002,1,1,2,4,Hibernating
24067,451,6,606.4,2,1,1,4,Hibernating
24068,75,13,2223.88,4,4,4,12,Champions
24069,883,7,1088.31,1,1,2,4,Hibernating
24070,62,15,6845.58,5,5,5,15,Champions
24071,123,10,1262.1499999999999,4,3,3,10,Loyal
24072,10,13,1721.21,5,4,3,12,Loyal
24073,616,6,376.86,1,1,1,3,Hibernating
24074,93,8,1695.4,4,2,3,9,Regulars
24075,540,3,388.63,1,1,1,3,Hibernating
24076,68,15,1855.8799999999999,4,5,4,13,Champions
24077,207,6,461.42,3,1,1,5,Regulars
24078,161,6,436.08,3,1,1,5,Regulars
24079,239,9,1609.48,3,2,3,8,Regulars
24080,121,7,999.53,4,1,2,7,Regulars
24081,251,6,519.07,2,1,1,4,Hibernating
24082,803,5,380.95,1,1,1,3,Hibernating
24083,490,10,1305.45,1,3,3,7,Regulars
24084,40,9,747.72,5,2,1,8,Regulars
24085,209,3,361.23,3,1,1,5,Regulars
24086,201,10,932.8399999999999,3,3,2,8,Regulars
24087,129,10,3061.6499999999996,4,3,5,12,Loyal
24088,39,12,2717.58,5,4,5,14,Champions
24089,83,10,2382.05,4,3,4,11,Loyal
24090,832,11,2856.96,1,3,5,9,Regulars
24091,583,8,1055.19,1,2,2,5,Hibernating
24092,527,11,1365.97,1,3,3,7,Regulars
24093,35,15,1169.11,5,5,2,12,Loyal
24094,353,7,2970.04,2,1,5,8,Regulars
24095,79,12,1066.1399999999999,4,4,2,10,Loyal
24096,965,8,803.48,1,2,1,4,Hibernating
24097,602,9,2135.28,1,2,4,7,Regulars
24098,1265,9,609.44,1,2,1,4,Hibernating
24099,176,7,839.87,3,1,1,5,Regulars
24100,17,8,642.01,5,2,1,8,Regulars
24101,161,9,2238.92,3,2,4,9,Big Spenders
24102,428,13,2847.14,2,4,5,11,At Risk
24103,15,11,2278.69,5,3,4,12,Loyal
24104,54,12,1666.98,5,4,3,12,Loyal
24105,16,9,1780.94,5,2,4,11,Big Spenders
24106,234,15,4220.99,3,5,5,13,Big Spenders
24107,495,6,279.07,1,1,1,3,Hibernating
24108,211,11,3283.74,3,3,5,11,Big Spenders
24109,143,10,2196.44,4,3,4,11,Loyal
24110,247,10,1269.1200000000001,3,3,3,9,Regulars
24111,783,6,471.77,1,1,1,3,Hibernating
24112,420,12,3273.09,2,4,5,11,At Risk
24113,369,8,490.46999999999997,2,2,1,5,Hibernating
24114,28,12,2241.35,5,4,4,13,Champions
24115,644,8,2647.14,1,2,5,8,Regulars
24116,6,6,470.35,5,1,1,7,Regulars
24117,245,13,5724.509999999999,3,4,5,12,Big Spenders
24118,263,8,650.89,2,2,1,5,Hibernating
24119,7,12,1113.58,5,4,2,11,Loyal
24120,427,9,2471.56,2,2,4,8,Regulars
24121,390,11,1451.6100000000001,2,3,3,8,Regulars
24122,7,14,4290.0,5,5,5,15,Champions
24123,470,10,1356.4,1,3,3,7,Regulars
24124,217,8,572.55,3,2,1,6,Regulars
24125,90,10,3859.6800000000003,4,3,5,12,Loyal
24126,335,15,1992.5,2,5,4,11,At Risk
24127,241,12,1207.44,3,4,2,9,Regulars
24128,608,12,2795.5099999999998,1,4,5,10,At Risk
24129,97,13,1902.31,4,4,4,12,Champions
24130,7,15,910.0,5,5,2,12,Loyal
24131,196,6,1149.6699999999998,3,1,2,6,Regulars
24132,153,11,1044.27,3,3,2,8,Regulars
24133,440,10,1559.66,2,3,3,8,Regulars
24134,124,10,709.77,4,3,1,8,Loyal
24135,307,8,650.0,2,2,1,5,Hibernating
24136,184,10,2149.7299999999996,3,3,4,10,Big Spenders
24137,33,16,1594.44,5,5,3,13,Loyal
24138,347,14,3447.5,2,5,5,12,At Risk
24139,39,12,2182.69,5,4,4,13,Champions
24140,64,11,2583.36,5,3,5,13,Loyal
24141,61,11,1087.74,5,3,2,10,Loyal
24142,89,10,1239.79,4,3,2,9,Loyal
24143,203,11,2155.5,3,3,4,10,Big Spenders
24144,82,10,936.15,4,3,2,9,Loyal
24145,2,10,838.87,5,3,1,9,Loyal
24146,239,15,1800.96,3,5,4,12,Big Spenders
24147,386,8,1746.3200000000002,2,2,4,8,Regulars
24148,96,12,1022.9,4,4,2,10,Loyal
24149,589,8,1271.98,1,2,3,6,Regulars
24150,541,18,1701.67,1,5,3,9,At Risk
24151,166,5,1584.0199999999998,3,1,3,7,Regulars
24152,839,13,1435.38,1,4,3,8,At Risk
24153,414,8,915.1100000000001,2,2,2,6,Hibernating
24154,604,8,969.4000000000001,1,2,2,5,Hibernating
24155,106,9,745.37,4,2,1,7,Regulars
24156,356,13,2818.27,2,4,5,11,At Risk
24157,257,4,399.84,2,1,1,4,Hibernating
24158,766,15,4077.5699999999997,1,5,5,11,At Risk
24159,152,13,1925.1299999999999,3,4,4,11,Big Spenders
24160,120,8,1328.31,4,2,3,9,Regulars
24161,38,6,1314.93,5,1,3,9,Regulars
24162,484,9,462.78,1,2,1,4,Hibernating
24163,568,7,781.29,1,1,1,3,Hibernating
24164,140,9,1141.13,4,2,2,8,Regulars
24165,101,14,2261.71,4,5,4,13,Champions
24166,18,11,1149.32,5,3,2,10,Loyal
24167,164,11,2556.0800000000004,3,3,4,10,Big Spenders
24168,98,10,1897.5700000000002,4,3,4,11,Loyal
24169,75,9,1273.03,4,2,3,9,Regulars
24170,460,6,542.34,1,1,1,3,Hibernating
24171,441,12,1269.59,2,4,3,9,At Risk
24172,303,11,4409.12,2,3,5,10,Regulars
24173,607,7,852.6199999999999,1,1,2,4,Hibernating
24174,364,8,592.29,2,2,1,5,Hibernating
24175,91,10,790.51,4,3,1,8,Loyal
24176,363,10,1433.0199999999998,2,3,3,8,Regulars
24177,68,9,1098.21,4,2,2,8,Regulars
24178,130,13,1046.73,4,4,2,10,Loyal
24179,976,2,822.71,1,1,1,3,Hibernating
24180,449,11,2821.12,2,3,5,10,Regulars
24181,37,8,2333.03,5,2,4,11,Big Spenders
24182,400,7,1715.6399999999999,2,1,3,6,Regulars
24183,881,9,1220.1200000000001,1,2,2,5,Hibernating
24184,42,18,7477.21,5,5,5,15,Champions
24185,194,6,847.72,3,1,2,6,Regulars
24186,138,6,616.19,4,1,1,6,Regulars
24187,190,13,1651.1599999999999,3,4,3,10,Regulars
24188,59,7,404.04,5,1,1,7,Regulars
24189,13,11,1630.85,5,3,3,11,Loyal
24190,216,11,1334.2,3,3,3,9,Regulars
24191,196,12,931.64,3,4,2,9,Regulars
24192,1076,4,160.47,1,1,1,3,Hibernating
24193,199,12,1588.97,3,4,3,10,Regulars
24194,88,6,475.03,4,1,1,6,Regulars
24195,217,14,2301.8,3,5,4,12,Big Spenders
24196,194,15,2121.67,3,5,4,12,Big Spenders
24197,261,9,3650.34,2,2,5,9,Regulars
24198,242,13,2147.12,3,4,4,11,Big Spenders
24199,312,13,1279.69,2,4,3,9,At Risk
24200,90,13,2683.68,4,4,5,13,Champions
24201,472,9,1175.96,1,2,2,5,Hibernating
24202,261,6,429.15,2,1,1,4,Hibernating
24203,87,15,4914.340000000001,4,5,5,14,Champions
24204,767,15,1511.77,1,5,3,9,At Risk
24205,149,12,1560.4099999999999,3,4,3,10,Regulars
24206,759,9,1436.24,1,2,3,6,Regulars
24207,303,9,743.0799999999999,2,2,1,5,Hibernating
24208,117,11,962.52,4,3,2,9,Loyal
24209,836,5,722.4100000000001,1,1,1,3,Hibernating
24210,912,9,1565.3400000000004,1,2,3,6,Regulars
24211,18,12,2653.9,5,4,5,14,Champions
24212,464,12,3510.44,1,4,5,10,At Risk
24213,322,10,1113.65,2,3,2,7,Regulars
24214,175,9,1919.98,3,2,4,9,Big Spenders
24215,544,14,1504.57,1,5,3,9,At Risk
24216,157,12,1381.81,3,4,3,10,Regulars
24217,73,9,777.88,4,2,1,7,Regulars
24218,8,5,974.0500000000001,5,1,2,8,Regulars
24219,101,6,2767.0600000000004,4,1,5,10,Big Spenders
24220,97,9,3103.79,4,2,5,11,Big Spenders
24221,385,10,1825.19,2,3,4,9,Regulars
24222,178,12,1860.68,3,4,4,11,Big Spenders
24223,208,10,1251.43,3,3,3,9,Regulars
24224,115,11,1283.0500000000002,4,3,3,10,Loyal
24225,242,11,967.42,3,3,2,8,Regulars
24226,629,5,793.5400000000001,1,1,1,3,Hibernating
24227,174,10,727.9599999999999,3,3,1,7,Regulars
24228,379,8,976.8799999999999,2,2,2,6,Hibernating
24229,260,16,2495.48,2,5,4,11,At Risk
24230,537,8,2336.19,1,2,4,7,Regulars
24231,126,9,651.11,4,2,1,7,Regulars
24232,219,10,1090.1799999999998,3,3,2,8,Regulars
24233,176,9,1292.1299999999999,3,2,3,8,Regulars
24234,83,7,467.63,4,1,1,6,Regulars
24235,64,9,1851.76,5,2,4,11,Big Spenders
24236,24,15,2566.3999999999996,5,5,4,14,Champions
24237,469,15,3533.25,1,5,5,11,At Risk
24238,348,11,902.08,2,3,2,7,Regulars
24239,429,15,3074.93,2,5,5,12,At Risk
24240,201,11,935.7399999999999,3,3,2,8,Regulars
24241,294,7,1662.37,2,1,3,6,Regulars
24242,71,13,1508.96,4,4,3,11,Loyal
24243,172,11,1738.01,3,3,4,10,Big Spenders
24244,518,14,1819.8999999999999,1,5,4,10,At Risk
24245,102,9,1126.99,4,2,2,8,Regulars
24246,400,9,736.25,2,2,1,5,Hibernating
24247,161,8,1201.03,3,2,2,7,Regulars
24248,18,11,1242.15,5,3,3,11,Loyal
24249,126,10,3552.64,4,3,5,12,Loyal
24250,933,6,283.82,1,1,1,3,Hibernating
24251,1557,8,829.1,1,2,1,4,Hibernating
24252,34,9,954.62,5,2,2,9,Regulars
24253,68,15,1667.71,4,5,3,12,Loyal
24254,126,14,5406.93,4,5,5,14,Champions
24255,74,10,1979.16,4,3,4,11,Loyal
24256,495,7,843.85,1,1,1,3,Hibernating
24257,150,7,745.26,3,1,1,5,Regulars
24258,74,6,519.17,4,1,1,6,Regulars
24259,592,6,1652.1599999999999,1,1,3,5,Regulars
24260,65,10,2404.93,5,3,4,12,Loyal
24261,20,15,4334.88,5,5,5,15,Champions
24262,194,12,1495.24,3,4,3,10,Regulars
24263,667,7,1424.04,1,1,3,5,Regulars
24264,185,13,3516.61,3,4,5,12,Big Spenders
24265,608,8,709.62,1,2,1,4,Hibernating
24266,45,14,1498.06,5,5,3,13,Loyal
24267,80,19,4377.14,4,5,5,14,Champions
24268,42,11,2713.9900000000002,5,3,5,13,Loyal
24269,183,17,3296.29,3,5,5,13,Big Spenders
24270,179,14,1338.95,3,5,3,11,Regulars
24271,52,16,1312.76,5,5,3,13,Loyal
24272,293,10,2384.6,2,3,4,9,Regulars
24273,996,9,1026.24,1,2,2,5,Hibernating
24274,418,10,570.8399999999999,2,3,1,6,Regulars
24275,41,13,5406.51,5,4,5,14,Champions
24276,303,9,1848.0,2,2,4,8,Regulars
24277,13,9,685.1700000000001,5,2,1,8,Regulars
24278,1047,9,646.84,1,2,1,4,Hibernating
24279,516,12,2923.96,1,4,5,10,At Risk
24280,48,18,5705.96,5,5,5,15,Champions
24281,247,6,1037.03,3,1,2,6,Regulars
24282,108,20,3183.28,4,5,5,14,Champions
24283,496,16,3649.0600000000004,1,5,5,11,At Risk
24284,546,5,2135.95,1,1,4,6,Regulars
24285,2157,6,834.2599999999999,1,1,1,3,Hibernating
24286,221,11,1491.23,3,3,3,9,Regulars
24287,90,8,1819.67,4,2,4,10,Big Spenders
24288,117,8,589.97,4,2,1,7,Regulars
24289,44,13,5079.96,5,4,5,14,Champions
24290,568,3,227.13,1,1,1,3,Hibernating
24291,817,5,753.86,1,1,1,3,Hibernating
24292,137,16,4799.139999999999,4,5,5,14,Champions
24293,91,8,1737.88,4,2,4,10,Big Spenders
24294,67,10,1750.7700000000002,4,3,4,11,Loyal
24295,809,15,1685.27,1,5,3,9,At Risk
24296,103,12,3158.2999999999997,4,4,5,13,Champions
24297,231,6,551.27,3,1,1,5,Regulars
24298,140,8,1438.34,4,2,3,9,Regulars
24299,7,9,1025.3899999999999,5,2,2,9,Regulars
24300,121,10,1062.79,4,3,2,9,Loyal
24301,185,5,555.8000000000001,3,1,1,5,Regulars
24302,292,11,1162.34,2,3,2,7,Regulars
24303,87,13,1682.9,4,4,3,11,Loyal
24304,119,13,1759.3999999999999,4,4,4,12,Champions
24305,322,9,790.45,2,2,1,5,Hibernating
24306,610,7,309.09,1,1,1,3,Hibernating
24307,92,8,1708.12,4,2,3,9,Regulars
24308,215,10,1496.3200000000002,3,3,3,9,Regulars
24309,752,10,1487.28,1,3,3,7,Regulars
24310,64,13,2871.83,5,4,5,14,Champions
24311,166,7,551.13,3,1,1,5,Regulars
24312,223,12,2976.52,3,4,5,12,Big Spenders
24313,51,10,1524.23,5,3,3,11,Loyal
24314,69,8,647.24,4,2,1,7,Regulars
24315,236,10,1714.6100000000001,3,3,3,9,Regulars
24316,186,10,835.68,3,3,1,7,Regulars
24317,84,13,3881.8599999999997,4,4,5,13,Champions
24318,133,10,1211.42,4,3,2,9,Loyal
24319,208,7,2030.6599999999999,3,1,4,8,Big Spenders
24320,103,13,1989.96,4,4,4,12,Champions
24321,104,9,651.98,4,2,1,7,Regulars
24322,192,9,884.48,3,2,2,7,Regulars
24323,23,15,1748.85,5,5,4,14,Champions
24324,54,6,566.58,5,1,1,7,Regulars
24325,333,9,1099.42,2,2,2,6,Hibernating
24326,59,11,4026.0400000000004,5,3,5,13,Loyal
24327,192,11,1445.8899999999999,3,3,3,9,Regulars
24328,240,12,2050.29,3,4,4,11,Big Spenders
24329,141,13,4730.24,4,4,5,13,Champions
24330,2,11,1353.23,5,3,3,11,Loyal
24331,541,10,1114.77,1,3,2,6,Regulars
24332,554,17,3181.2299999999996,1,5,5,11,At Risk
24333,496,7,396.83,1,1,1,3,Hibernating
24334,60,13,2417.15,5,4,4,13,Champions
24335,305,8,1132.25,2,2,2,6,Hibernating
24336,542,13,1935.3700000000001,1,4,4,9,At Risk
24337,499,14,1318.53,1,5,3,9,At Risk
24338,332,8,900.38,2,2,2,6,Hibernating
24339,38,13,863.0,5,4,2,11,Loyal
24340,310,7,489.32,2,1,1,4,Hibernating
24341,332,9,1566.24,2,2,3,7,Regulars
24342,268,9,718.24,2,2,1,5,Hibernating
24343,815,6,909.6500000000001,1,1,2,4,Hibernating
24344,184,11,4340.76,3,3,5,11,Big Spenders
24345,75,14,1091.98,4,5,2,11,Loyal
24346,155,10,1325.5300000000002,3,3,3,9,Regulars
24347,199,13,1067.24,3,4,2,9,Regulars
24348,3,17,2310.9300000000003,5,5,4,14,Champions
24349,52,13,1363.3400000000001,5,4,3,12,Loyal
24350,272,14,3774.2000000000003,2,5,5,12,At Risk
24351,101,19,1597.66,4,5,3,12,Loyal
24352,315,8,1432.54,2,2,3,7,Regulars
24353,11,14,2730.8199999999997,5,5,5,15,Champions
24354,233,7,2620.95,3,1,5,9,Big Spenders
24355,193,13,5866.45,3,4,5,12,Big Spenders
24356,85,17,2298.91,4,5,4,13,Champions
24357,93,14,2039.47,4,5,4,13,Champions
24358,0,11,1233.84,5,3,2,10,Loyal
24359,120,11,603.1700000000001,4,3,1,8,Loyal
24360,596,10,2230.01,1,3,4,8,Regulars
24361,487,12,1741.51,1,4,4,9,At Risk
24362,154,9,1372.3600000000001,3,2,3,8,Regulars
24363,1321,8,2097.12,1,2,4,7,Regulars
24364,195,8,970.55,3,2,2,7,Regulars
24365,217,11,1029.47,3,3,2,8,Regulars
24366,53,22,3339.73,5,5,5,15,Champions
24367,166,14,1944.5,3,5,4,12,Big Spenders
24368,115,12,4164.26,4,4,5,13,Champions
24369,209,7,994.3600000000001,3,1,2,6,Regulars
24370,915,10,3603.7500000000005,1,3,5,9,Regulars
24371,1363,7,1173.9399999999998,1,1,2,4,Hibernating
24372,84,8,1243.0,4,2,3,9,Regulars
24373,96,15,2007.02,4,5,4,13,Champions
24374,50,13,1661.22,5,4,3,12,Loyal
24375,62,12,674.53,5,4,1,10,Loyal
24376,300,13,2511.2200000000003,2,4,4,10,At Risk
24377,50,10,1395.48,5,3,3,11,Loyal
24378,77,15,2109.1,4,5,4,13,Champions
24379,20,13,1011.78,5,4,2,11,Loyal
24380,513,8,1241.8600000000001,1,2,3,6,Regulars
24381,263,12,1120.32,2,4,2,8,At Risk
24382,1156,4,369.72,1,1,1,3,Hibernating
24383,331,9,873.68,2,2,2,6,Hibernating
24384,928,7,617.65,1,1,1,3,Hibernating
24385,1304,5,484.38,1,1,1,3,Hibernating
24386,277,7,394.65999999999997,2,1,1,4,Hibernating
24387,292,11,3815.67,2,3,5,10,Regulars
24388,48,17,1611.09,5,5,3,13,Loyal
24389,245,9,4851.86,3,2,5,10,Big Spenders
24390,21,13,3120.92,5,4,5,14,Champions
24391,85,13,1243.58,4,4,3,11,Loyal
24392,123,5,316.27,4,1,1,6,Regulars
24393,556,4,275.21,1,1,1,3,Hibernating
24394,507,5,778.3599999999999,1,1,1,3,Hibernating
24395,461,12,1931.45,1,4,4,9,At Risk
24396,278,9,1576.98,2,2,3,7,Regulars
24397,482,8,1022.06,1,2,2,5,Hibernating
24398,217,5,253.44,3,1,1,5,Regulars
24399,94,7,812.52,4,1,1,6,Regulars
24400,457,9,781.71,2,2,1,5,Hibernating
24401,3,8,1873.59,5,2,4,11,Big Spenders
24402,46,9,866.71,5,2,2,9,Regulars
24403,20,13,1528.92,5,4,3,12,Loyal
24404,1057,7,1043.6299999999999,1,1,2,4,Hibernating
24405,816,9,1471.03,1,2,3,6,Regulars
24406,110,8,736.0699999999999,4,2,1,7,Regulars
24407,383,9,1375.89,2,2,3,7,Regulars
24408,93,16,2046.5700000000002,4,5,4,13,Champions
24409,101,10,3102.64,4,3,5,12,Loyal
24410,32,15,2115.52,5,5,4,14,Champions
24411,90,10,1398.3999999999999,4,3,3,10,Loyal
24412,230,12,4209.36,3,4,5,12,Big Spenders
24413,212,13,946.88,3,4,2,9,Regulars
24414,162,10,1394.24,3,3,3,9,Regulars
24415,502,12,1203.61,1,4,2,7,At Risk
24416,186,11,5141.86,3,3,5,11,Big Spenders
24417,311,15,4102.74,2,5,5,12,At Risk
24418,295,13,1929.97,2,4,4,10,At Risk
24419,541,7,978.45,1,1,2,4,Hibernating
24420,50,14,1252.28,5,5,3,13,Loyal
24421,29,11,1401.47,5,3,3,11,Loyal
24422,760,11,1309.02,1,3,3,7,Regulars
24423,250,10,2800.56,2,3,5,10,Regulars
24424,285,8,582.13,2,2,1,5,Hibernating
24425,408,10,574.54,2,3,1,6,Regulars
24426,1,7,532.37,5,1,1,7,Regulars
24427,43,10,4604.21,5,3,5,13,Loyal
24428,2053,5,390.09000000000003,1,1,1,3,Hibernating
24429,151,6,923.41,3,1,2,6,Regulars
24430,286,8,1606.68,2,2,3,7,Regulars
24431,221,11,553.28,3,3,1,7,Regulars
24432,1318,11,762.68,1,3,1,5,Regulars
24433,519,6,1080.35,1,1,2,4,Hibernating
24434,67,12,1253.08,4,4,3,11,Loyal
24435,85,8,3446.87,4,2,5,11,Big Spenders
24436,124,10,930.65,4,3,2,9,Loyal
24437,665,16,2890.71,1,5,5,11,At Risk
24438,272,3,852.1299999999999,2,1,2,5,Hibernating
24439,239,21,5022.09,3,5,5,13,Big Spenders
24440,601,6,1119.4700000000003,1,1,2,4,Hibernating
24441,70,17,3315.8199999999997,4,5,5,14,Champions
24442,32,13,1084.04,5,4,2,11,Loyal
24443,134,17,1196.12,4,5,2,11,Loyal
24444,832,13,1367.75,1,4,3,8,At Risk
24445,646,9,2333.41,1,2,4,7,Regulars
24446,266,10,1456.85,2,3,3,8,Regulars
24447,99,8,1277.32,4,2,3,9,Regulars
24448,220,13,2360.88,3,4,4,11,Big Spenders
24449,574,9,2909.21,1,2,5,8,Regulars
24450,348,9,1096.02,2,2,2,6,Hibernating
24451,52,14,2473.35,5,5,4,14,Champions
24452,984,5,746.9399999999999,1,1,1,3,Hibernating
24453,5,7,1856.11,5,1,4,10,Big Spenders
24454,111,11,1673.8600000000001,4,3,3,10,Loyal
24455,981,7,544.65,1,1,1,3,Hibernating
24456,175,8,2564.44,3,2,4,9,Big Spenders
24457,75,8,1518.73,4,2,3,9,Regulars
24458,154,8,914.35,3,2,2,7,Regulars
24459,51,12,2531.5000000000005,5,4,4,13,Champions
24460,527,4,818.39,1,1,1,3,Hibernating
24461,531,7,1572.19,1,1,3,5,Regulars
24462,618,11,1182.88,1,3,2,6,Regulars
24463,134,11,2123.15,4,3,4,11,Loyal
24464,65,10,2963.99,5,3,5,13,Loyal
24465,185,12,4011.4899999999993,3,4,5,12,Big Spenders
24466,197,11,3430.3199999999997,3,3,5,11,Big Spenders
24467,30,12,1638.06,5,4,3,12,Loyal
24468,607,13,3185.05,1,4,5,10,At Risk
24469,132,15,948.75,4,5,2,11,Loyal
24470,31,11,1117.6299999999999,5,3,2,10,Loyal
24471,867,10,1182.88,1,3,2,6,Regulars
24472,90,11,690.28,4,3,1,8,Loyal
24473,535,10,1308.55,1,3,3,7,Regulars
24474,239,9,1552.17,3,2,3,8,Regulars
24475,310,7,934.05,2,1,2,5,Hibernating
24476,69,18,5045.87,4,5,5,14,Champions
24477,573,9,1192.24,1,2,2,5,Hibernating
24478,193,13,1314.6200000000001,3,4,3,10,Regulars
24479,113,14,2654.77,4,5,5,14,Champions
24480,243,13,2060.8199999999997,3,4,4,11,Big Spenders
24481,357,9,1366.39,2,2,3,7,Regulars
24482,851,9,3015.44,1,2,5,8,Regulars
24483,210,9,1583.22,3,2,3,8,Regulars
24484,42,9,1388.03,5,2,3,10,Regulars
24485,167,12,3486.09,3,4,5,12,Big Spenders
24486,118,9,1424.05,4,2,3,9,Regulars
24487,90,9,1607.9899999999998,4,2,3,9,Regulars
24488,314,14,1069.75,2,5,2,9,At Risk
24489,404,10,1107.7,2,3,2,7,Regulars
24490,195,8,560.03,3,2,1,6,Regulars
24491,511,13,1296.99,1,4,3,8,At Risk
24492,61,12,2199.32,5,4,4,13,Champions
24493,156,14,2670.8,3,5,5,13,Big Spenders
24494,209,11,2467.8199999999997,3,3,4,10,Big Spenders
24495,196,8,921.2399999999999,3,2,2,7,Regulars
24496,147,11,1217.36,4,3,2,9,Loyal
24497,317,11,2223.0099999999998,2,3,4,9,Regulars
24498,211,14,1850.44,3,5,4,12,Big Spenders
24499,31,14,2520.88,5,5,4,14,Champions
24500,106,5,1230.48,4,1,2,7,Regulars
24501,777,11,1154.2,1,3,2,6,Regulars
24502,33,13,1068.16,5,4,2,11,Loyal
24503,691,9,1052.26,1,2,2,5,Hibernating
24504,69,11,1601.02,4,3,3,10,Loyal
24505,255,12,1072.25,2,4,2,8,At Risk
24506,27,13,1893.5,5,4,4,13,Champions
24507,368,10,653.48,2,3,1,6,Regulars
24508,150,10,2185.25,3,3,4,10,Big Spenders
24509,24,12,1157.19,5,4,2,11,Loyal
24510,9,11,743.14,5,3,1,9,Loyal
24511,1437,8,1729.25,1,2,4,7,Regulars
24512,568,9,1230.0,1,2,2,5,Hibernating
24513,368,5,722.72,2,1,1,4,Hibernating
24514,556,7,2286.6000000000004,1,1,4,6,Regulars
24515,372,10,1507.72,2,3,3,8,Regulars
24516,263,16,1218.07,2,5,2,9,At Risk
24517,222,11,2226.68,3,3,4,10,Big Spenders
24518,60,8,2858.8599999999997,5,2,5,12,Big Spenders
24519,17,16,3215.82,5,5,5,15,Champions
24520,269,10,884.71,2,3,2,7,Regulars
24521,162,11,3780.2700000000004,3,3,5,11,Big Spenders
24522,248,10,1222.33,2,3,2,7,Regulars
24523,494,11,1629.68,1,3,3,7,Regulars
24524,442,13,1980.04,2,4,4,10,At Risk
24525,90,11,3765.3500000000004,4,3,5,12,Loyal
24526,93,8,1507.69,4,2,3,9,Regulars
24527,1435,5,1058.0,1,1,2,4,Hibernating
24528,48,13,1581.67,5,4,3,12,Loyal
24529,1231,5,661.6,1,1,1,3,Hibernating
24530,272,10,2396.2799999999997,2,3,4,9,Regulars
24531,806,12,1205.66,1,4,2,7,At Risk
24532,109,14,1931.99,4,5,4,13,Champions
24533,48,7,1034.66,5,1,2,8,Regulars
24534,141,14,2405.0,4,5,4,13,Champions
24535,156,17,1922.5600000000002,3,5,4,12,Big Spenders
24536,27,7,804.49,5,1,1,7,Regulars
24537,715,7,598.97,1,1,1,3,Hibernating
24538,365,13,3829.5,2,4,5,11,At Risk
24539,59,17,1870.92,5,5,4,14,Champions
24540,57,12,2566.08,5,4,4,13,Champions
24541,12,19,3815.87,5,5,5,15,Champions
24542,85,7,538.16,4,1,1,6,Regulars
24543,94,12,3229.49,4,4,5,13,Champions
24544,175,6,804.04,3,1,1,5,Regulars
24545,1268,6,1755.9,1,1,4,6,Regulars
24546,161,8,2168.17,3,2,4,9,Big Spenders
24547,191,9,623.9,3,2,1,6,Regulars
24548,15,10,814.46,5,3,1,9,Loyal
24549,167,13,1719.48,3,4,3,10,Regulars
24550,15,15,2256.56,5,5,4,14,Champions
24551,169,10,1270.6299999999999,3,3,3,9,Regulars
24552,15,14,850.88,5,5,2,12,Loyal
24553,67,10,1185.67,4,3,2,9,Loyal
24554,134,10,1320.43,4,3,3,10,Loyal
24555,1150,7,820.98,1,1,1,3,Hibernating
24556,1537,4,316.31,1,1,1,3,Hibernating
24557,107,8,4125.01,4,2,5,11,Big Spenders
24558,951,7,2546.2999999999997,1,1,4,6,Regulars
24559,2,14,2472.29,5,5,4,14,Champions
24560,14,14,2771.6099999999997,5,5,5,15,Champions
24561,291,8,2985.05,2,2,5,9,Regulars
24562,317,16,2663.5200000000004,2,5,5,12,At Risk
24563,12,3,732.58,5,1,1,7,Regulars
24564,538,6,454.53,1,1,1,3,Hibernating
24565,207,12,3771.94,3,4,5,12,Big Spenders
24566,181,7,3884.5699999999997,3,1,5,9,Big Spenders
24567,31,16,2219.22,5,5,4,14,Champions
24568,124,8,602.23,4,2,1,7,Regulars
24569,304,7,915.11,2,1,2,5,Hibernating
24570,609,9,922.12,1,2,2,5,Hibernating
24571,128,10,1298.34,4,3,3,10,Loyal
24572,73,10,854.16,4,3,2,9,Loyal
24573,239,14,1581.62,3,5,3,11,Regulars
24574,42,7,504.67,5,1,1,7,Regulars
24575,224,16,1913.63,3,5,4,12,Big Spenders
24576,130,7,1449.04,4,1,3,8,Regulars
24577,878,11,3302.96,1,3,5,9,Regulars
24578,523,5,420.4100000000001,1,1,1,3,Hibernating
24579,51,9,1437.99,5,2,3,10,Regulars
24580,370,7,368.56,2,1,1,4,Hibernating
24581,224,8,1060.19,3,2,2,7,Regulars
24582,22,17,4591.98,5,5,5,15,Champions
24583,14,7,847.96,5,1,2,8,Regulars
24584,411,7,490.14000000000004,2,1,1,4,Hibernating
24585,536,7,1917.75,1,1,4,6,Regulars
24586,1666,4,1721.18,1,1,3,5,Regulars
24587,664,9,1357.3600000000001,1,2,3,6,Regulars
24588,7,10,827.28,5,3,1,9,Loyal
24589,85,13,1047.23,4,4,2,10,Loyal
24590,439,9,2692.06,2,2,5,9,Regulars
24591,573,6,1129.96,1,1,2,4,Hibernating
24592,1278,6,840.04,1,1,1,3,Hibernating
24593,135,17,2318.17,4,5,4,13,Champions
24594,211,10,913.87,3,3,2,8,Regulars
24595,202,6,2564.93,3,1,4,8,Big Spenders
24596,551,11,3624.01,1,3,5,9,Regulars
24597,386,6,1067.14,2,1,2,5,Hibernating
24598,279,11,1290.46,2,3,3,8,Regulars
24599,87,8,1320.59,4,2,3,9,Regulars
24600,693,10,4449.86,1,3,5,9,Regulars
24601,499,12,3075.79,1,4,5,10,At Risk
24602,22,13,1172.03,5,4,2,11,Loyal
24603,237,5,1302.78,3,1,3,7,Regulars
24604,146,6,801.06,4,1,1,6,Regulars
24605,529,14,3370.81,1,5,5,11,At Risk
24606,25,10,632.31,5,3,1,9,Loyal
24607,35,10,1236.27,5,3,2,10,Loyal
24608,177,9,1275.42,3,2,3,8,Regulars
24609,266,10,1766.5,2,3,4,9,Regulars
24610,639,9,2566.84,1,2,4,7,Regulars
24611,126,11,1578.81,4,3,3,10,Loyal
24612,44,15,3481.31,5,5,5,15,Champions
24613,71,8,691.8499999999999,4,2,1,7,Regulars
24614,134,8,529.44,4,2,1,7,Regulars
24615,38,11,1644.52,5,3,3,11,Loyal
24616,525,10,2170.93,1,3,4,8,Regulars
24617,168,11,1667.04,3,3,3,9,Regulars
24618,74,12,2067.0600000000004,4,4,4,12,Champions
24619,219,10,1120.23,3,3,2,8,Regulars
24620,243,10,930.16,3,3,2,8,Regulars
24621,331,5,2251.48,2,1,4,7,Regulars
24622,3,14,2708.98,5,5,5,15,Champions
24623,94,7,801.99,4,1,1,6,Regulars
24624,145,7,595.15,4,1,1,6,Regulars
24625,175,18,2537.7200000000003,3,5,4,12,Big Spenders
24626,182,9,973.51,3,2,2,7,Regulars
24627,331,10,1818.96,2,3,4,9,Regulars
24628,741,5,408.79,1,1,1,3,Hibernating
24629,249,8,1982.04,2,2,4,8,Regulars
24630,139,16,2223.53,4,5,4,13,Champions
24631,166,9,798.37,3,2,1,6,Regulars
24632,170,12,1786.4,3,4,4,11,Big Spenders
24633,45,15,3938.1600000000003,5,5,5,15,Champions
24634,301,20,3399.36,2,5,5,12,At Risk
24635,85,15,1761.1200000000001,4,5,4,13,Champions
24636,9,12,3088.05,5,4,5,14,Champions
24637,316,11,1247.23,2,3,3,8,Regulars
24638,85,10,1505.5,4,3,3,10,Loyal
24639,522,13,2704.16,1,4,5,10,At Risk
24640,208,18,1373.46,3,5,3,11,Regulars
24641,902,12,797.94,1,4,1,6,At Risk
24642,126,11,2195.41,4,3,4,11,Loyal
24643,644,9,1244.1,1,2,3,6,Regulars
24644,366,14,2523.25,2,5,4,11,At Risk
24645,497,7,523.75,1,1,1,3,Hibernating
24646,283,9,1193.46,2,2,2,6,Hibernating
24647,1045,6,767.65,1,1,1,3,Hibernating
24648,23,9,1306.74,5,2,3,10,Regulars
24649,332,8,3859.5,2,2,5,9,Regulars
24650,496,14,2071.2,1,5,4,10,At Risk
24651,566,8,445.03,1,2,1,4,Hibernating
24652,164,5,643.21,3,1,1,5,Regulars
24653,75,8,865.76,4,2,2,8,Regulars
24654,678,6,559.48,1,1,1,3,Hibernating
24655,295,13,3856.7500000000005,2,4,5,11,At Risk
24656,199,10,1411.8,3,3,3,9,Regulars
24657,52,11,3117.1000000000004,5,3,5,13,Loyal
24658,249,6,1539.19,2,1,3,6,Regulars
24659,1013,8,1437.3700000000001,1,2,3,6,Regulars
24660,194,15,4907.99,3,5,5,13,Big Spenders
24661,174,9,3225.34,3,2,5,10,Big Spenders
24662,365,16,1955.44,2,5,4,11,At Risk
24663,112,10,1098.01,4,3,2,9,Loyal
24664,84,15,2685.74,4,5,5,14,Champions
24665,195,10,2851.4500000000003,3,3,5,11,Big Spenders
24666,250,6,996.63,2,1,2,5,Hibernating
24667,100,11,3003.26,4,3,5,12,Loyal
24668,291,6,335.57,2,1,1,4,Hibernating
24669,51,8,1467.3600000000001,5,2,3,10,Regulars
24670,518,11,659.46,1,3,1,5,Regulars
24671,517,7,1960.3999999999999,1,1,4,6,Regulars
24672,19,11,1201.0900000000001,5,3,2,10,Loyal
24673,56,9,1098.8400000000001,5,2,2,9,Regulars
24674,783,7,722.0600000000001,1,1,1,3,Hibernating
24675,6,15,1926.13,5,5,4,14,Champions
24676,2,14,4275.860000000001,5,5,5,15,Champions
24677,427,10,1126.51,2,3,2,7,Regulars
24678,42,15,4761.35,5,5,5,15,Champions
24679,84,12,3631.47,4,4,5,13,Champions
24680,396,10,2506.17,2,3,4,9,Regulars
24681,77,16,1447.41,4,5,3,12,Loyal
24682,1073,9,920.66,1,2,2,5,Hibernating
24683,302,11,806.91,2,3,1,6,Regulars
24684,160,9,536.89,3,2,1,6,Regulars
24685,56,8,2215.95,5,2,4,11,Big Spenders
24686,215,11,2713.08,3,3,5,11,Big Spenders
24687,469,11,1132.24,1,3,2,6,Regulars
24688,87,15,3508.49,4,5,5,14,Champions
24689,98,12,1634.78,4,4,3,11,Loyal
24690,257,7,828.3299999999999,2,1,1,4,Hibernating
24691,453,12,1641.1,2,4,3,9,At Risk
24692,237,11,4087.72,3,3,5,11,Big Spenders
24693,574,5,363.34999999999997,1,1,1,3,Hibernating
24694,154,7,621.66,3,1,1,5,Regulars
24695,327,14,1872.17,2,5,4,11,At Risk
24696,65,7,520.35,5,1,1,7,Regulars
24697,224,10,2862.6299999999997,3,3,5,11,Big Spenders
24698,57,15,6867.37,5,5,5,15,Champions
24699,124,6,1535.37,4,1,3,8,Regulars
24700,103,17,2251.49,4,5,4,13,Champions
24701,277,13,551.31,2,4,1,7,At Risk
24702,431,17,2871.38,2,5,5,12,At Risk
24703,81,6,1381.1200000000001,4,1,3,8,Regulars
24704,133,8,1119.19,4,2,2,8,Regulars
24705,400,7,666.28,2,1,1,4,Hibernating
24706,529,8,1027.2,1,2,2,5,Hibernating
24707,164,18,2990.7499999999995,3,5,5,13,Big Spenders
24708,220,7,1348.2800000000002,3,1,3,7,Regulars
24709,571,10,2427.37,1,3,4,8,Regulars
24710,552,15,2393.75,1,5,4,10,At Risk
24711,206,9,1528.9299999999998,3,2,3,8,Regulars
24712,22,10,3836.1,5,3,5,13,Loyal
24713,118,5,1583.86,4,1,3,8,Regulars
24714,42,11,1603.96,5,3,3,11,Loyal
24715,878,11,1938.61,1,3,4,8,Regulars
24716,243,15,4391.22,3,5,5,13,Big Spenders
24717,8,11,2015.48,5,3,4,12,Loyal
24718,535,11,2739.28,1,3,5,9,Regulars
24719,145,12,1762.74,4,4,4,12,Champions
24720,267,12,1285.4799999999998,2,4,3,9,At Risk
24721,522,10,677.97,1,3,1,5,Regulars
24722,274,14,2015.03,2,5,4,11,At Risk
24723,167,6,732.35,3,1,1,5,Regulars
24724,159,14,3036.17,3,5,5,13,Big Spenders
24725,37,6,998.99,5,1,2,8,Regulars
24726,11,8,2570.32,5,2,4,11,Big Spenders
24727,606,5,690.25,1,1,1,3,Hibernating
24728,37,11,2388.77,5,3,4,12,Loyal
24729,638,6,682.73,1,1,1,3,Hibernating
24730,163,6,727.86,3,1,1,5,Regulars
24731,1257,6,866.8599999999999,1,1,2,4,Hibernating
24732,25,15,2586.38,5,5,5,15,Champions
24733,73,10,1635.3899999999999,4,3,3,10,Loyal
24734,791,9,1182.8,1,2,2,5,Hibernating
24735,0,10,1272.99,5,3,3,11,Loyal
24736,37,9,2801.69,5,2,5,12,Big Spenders
24737,266,5,824.43,2,1,1,4,Hibernating
24738,89,9,1063.19,4,2,2,8,Regulars
24739,115,15,4014.7,4,5,5,14,Champions
24740,55,14,1714.44,5,5,3,13,Loyal
24741,70,11,3347.69,4,3,5,12,Loyal
24742,294,13,1458.9299999999998,2,4,3,9,At Risk
24743,99,12,2937.88,4,4,5,13,Champions
24744,167,9,464.6,3,2,1,6,Regulars
24745,193,10,1355.4,3,3,3,9,Regulars
24746,186,10,1039.6200000000001,3,3,2,8,Regulars
24747,49,14,1846.91,5,5,4,14,Champions
24748,537,11,1571.72,1,3,3,7,Regulars
24749,202,12,2780.81,3,4,5,12,Big Spenders
24750,181,9,1564.01,3,2,3,8,Regulars
24751,161,8,3400.0800000000004,3,2,5,10,Big Spenders
24752,428,4,275.64,2,1,1,4,Hibernating
24753,179,13,1434.73,3,4,3,10,Regulars
24754,97,13,1307.31,4,4,3,11,Loyal
24755,155,9,2405.88,3,2,4,9,Big Spenders
24756,1043,10,967.6000000000001,1,3,2,6,Regulars
24757,4,12,928.8100000000001,5,4,2,11,Loyal
24758,238,10,2536.42,3,3,4,10,Big Spenders
24759,263,12,2907.17,2,4,5,11,At Risk
24760,228,10,1742.33,3,3,4,10,Big Spenders
24761,307,10,1099.8899999999999,2,3,2,7,Regulars
24762,1477,5,735.6700000000001,1,1,1,3,Hibernating
24763,203,17,6091.339999999999,3,5,5,13,Big Spenders
24764,262,8,823.91,2,2,1,5,Hibernating
24765,158,15,2673.03,3,5,5,13,Big Spenders
24766,264,10,689.55,2,3,1,6,Regulars
24767,20,12,2051.58,5,4,4,13,Champions
24768,47,15,2132.2599999999998,5,5,4,14,Champions
24769,101,11,940.8299999999999,4,3,2,9,Loyal
24770,47,11,1405.64,5,3,3,11,Loyal
24771,2,11,2574.05,5,3,5,13,Loyal
24772,612,9,416.38,1,2,1,4,Hibernating
24773,848,5,286.17,1,1,1,3,Hibernating
24774,91,7,349.35,4,1,1,6,Regulars
24775,74,10,983.63,4,3,2,9,Loyal
24776,399,5,847.5600000000001,2,1,2,5,Hibernating
24777,259,11,1958.4599999999998,2,3,4,9,Regulars
24778,87,9,710.95,4,2,1,7,Regulars
24779,1075,1,65.17,1,1,1,3,Hibernating
24780,585,7,851.1800000000001,1,1,2,4,Hibernating
24781,514,9,1404.72,1,2,3,6,Regulars
24782,662,8,1016.95,1,2,2,5,Hibernating
24783,133,7,1600.57,4,1,3,8,Regulars
24784,1225,8,419.91999999999996,1,2,1,4,Hibernating
24785,272,4,281.79,2,1,1,4,Hibernating
24786,21,10,2314.25,5,3,4,12,Loyal
24787,12,11,1420.03,5,3,3,11,Loyal
24788,104,9,755.7,4,2,1,7,Regulars
24789,184,16,2730.23,3,5,5,13,Big Spenders
24790,214,6,670.28,3,1,1,5,Regulars
24791,213,14,4141.969999999999,3,5,5,13,Big Spenders
24792,508,12,1758.05,1,4,4,9,At Risk
24793,232,11,1253.43,3,3,3,9,Regulars
24794,206,9,1265.0,3,2,3,8,Regulars
24795,118,13,2420.61,4,4,4,12,Champions
24796,79,13,1378.0400000000002,4,4,3,11,Loyal
24797,707,10,2069.11,1,3,4,8,Regulars
24798,917,9,1537.48,1,2,3,6,Regulars
24799,198,9,679.29,3,2,1,6,Regulars
24800,46,16,5035.03,5,5,5,15,Champions
24801,140,15,1477.54,4,5,3,12,Loyal
24802,92,10,1225.5,4,3,2,9,Loyal
24803,39,8,2836.6800000000003,5,2,5,12,Big Spenders
24804,64,7,2685.49,5,1,5,11,Big Spenders
24805,433,12,3470.8199999999997,2,4,5,11,At Risk
24806,569,5,429.22,1,1,1,3,Hibernating
24807,223,9,2291.88,3,2,4,9,Big Spenders
24808,124,9,1198.53,4,2,2,8,Regulars
24809,452,12,1288.51,2,4,3,9,At Risk
24810,210,10,1235.19,3,3,2,8,Regulars
24811,553,9,2375.87,1,2,4,7,Regulars
24812,82,13,1528.8799999999999,4,4,3,11,Loyal
24813,65,12,2089.3900000000003,5,4,4,13,Champions
24814,386,13,891.85,2,4,2,8,At Risk
24815,24,10,1494.58,5,3,3,11,Loyal
24816,69,7,740.8299999999999,4,1,1,6,Regulars
24817,20,11,1030.79,5,3,2,10,Loyal
24818,150,10,711.0,3,3,1,7,Regulars
24819,5,12,1983.3600000000001,5,4,4,13,Champions
24820,205,14,2934.69,3,5,5,13,Big Spenders
24821,273,10,1804.79,2,3,4,9,Regulars
24822,71,14,3176.4,4,5,5,14,Champions
24823,426,9,1071.29,2,2,2,6,Hibernating
24824,559,8,487.95000000000005,1,2,1,4,Hibernating
24825,19,15,3558.19,5,5,5,15,Champions
24826,677,12,2096.04,1,4,4,9,At Risk
24827,184,12,1089.33,3,4,2,9,Regulars
24828,342,7,550.95,2,1,1,4,Hibernating
24829,375,12,1994.1599999999999,2,4,4,10,At Risk
24830,29,10,1050.85,5,3,2,10,Loyal
24831,174,7,793.86,3,1,1,5,Regulars
24832,165,12,1991.66,3,4,4,11,Big Spenders
24833,346,4,259.82,2,1,1,4,Hibernating
24834,266,14,1932.66,2,5,4,11,At Risk
24835,516,8,1260.6,1,2,3,6,Regulars
24836,49,23,4613.4,5,5,5,15,Champions
24837,303,12,1390.14,2,4,3,9,At Risk
24838,309,5,373.61,2,1,1,4,Hibernating
24839,174,6,742.98,3,1,1,5,Regulars
24840,190,3,208.5,3,1,1,5,Regulars
24841,78,11,2128.27,4,3,4,11,Loyal
24842,585,7,612.8,1,1,1,3,Hibernating
24843,905,11,1561.88,1,3,3,7,Regulars
24844,402,10,1270.14,2,3,3,8,Regulars
24845,306,13,1479.62,2,4,3,9,At Risk
24846,127,10,3392.83,4,3,5,12,Loyal
24847,101,10,1487.32,4,3,3,10,Loyal
24848,199,14,881.98,3,5,2,10,Regulars
24849,1418,9,907.6800000000001,1,2,2,5,Hibernating
24850,180,10,1274.78,3,3,3,9,Regulars
24851,38,6,676.59,5,1,1,7,Regulars
24852,437,7,1974.9699999999998,2,1,4,7,Regulars
24853,1298,5,606.88,1,1,1,3,Hibernating
24854,287,14,2555.57,2,5,4,11,At Risk
24855,105,6,721.4100000000001,4,1,1,6,Regulars
24856,869,8,944.35,1,2,2,5,Hibernating
24857,2,12,3117.13,5,4,5,14,Champions
24858,125,10,655.03,4,3,1,8,Loyal
24859,425,9,1412.53,2,2,3,7,Regulars
24860,238,7,500.71000000000004,3,1,1,5,Regulars
24861,38,13,4232.17,5,4,5,14,Champions
24862,29,15,2867.9700000000003,5,5,5,15,Champions
24863,335,5,548.64,2,1,1,4,Hibernating
24864,11,18,2153.86,5,5,4,14,Champions
24865,171,11,2758.94,3,3,5,11,Big Spenders
24866,564,7,1042.2,1,1,2,4,Hibernating
24867,109,6,497.34999999999997,4,1,1,6,Regulars
24868,117,7,601.97,4,1,1,6,Regulars
24869,85,10,2324.67,4,3,4,11,Loyal
24870,107,15,1174.74,4,5,2,11,Loyal
24871,191,18,3801.65,3,5,5,13,Big Spenders
24872,29,11,3036.01,5,3,5,13,Loyal
24873,114,7,910.18,4,1,2,7,Regulars
24874,129,13,3884.65,4,4,5,13,Champions
24875,58,14,3912.4300000000003,5,5,5,15,Champions
24876,190,8,2134.83,3,2,4,9,Big Spenders
24877,423,10,2915.18,2,3,5,10,Regulars
24878,172,10,1318.72,3,3,3,9,Regulars
24879,46,12,3079.03,5,4,5,14,Champions
24880,1283,7,691.71,1,1,1,3,Hibernating
24881,50,10,2719.1,5,3,5,13,Loyal
24882,278,13,1365.1100000000001,2,4,3,9,At Risk
24883,430,5,948.26,2,1,2,5,Hibernating
24884,454,6,627.5,2,1,1,4,Hibernating
24885,104,10,1150.33,4,3,2,9,Loyal
24886,24,5,660.56,5,1,1,7,Regulars
24887,147,11,971.73,4,3,2,9,Loyal
24888,633,4,288.13,1,1,1,3,Hibernating
24889,210,6,988.46,3,1,2,6,Regulars
24890,113,16,4022.2499999999995,4,5,5,14,Champions
24891,80,9,811.41,4,2,1,7,Regulars
24892,296,10,1772.2199999999998,2,3,4,9,Regulars
24893,237,7,1320.5,3,1,3,7,Regulars
24894,28,12,1269.3,5,4,3,12,Loyal
24895,529,6,707.33,1,1,1,3,Hibernating
24896,744,7,689.2800000000001,1,1,1,3,Hibernating
24897,48,8,2391.77,5,2,4,11,Big Spenders
24898,47,4,880.98,5,1,2,8,Regulars
24899,175,10,1112.8,3,3,2,8,Regulars
24900,213,10,1032.11,3,3,2,8,Regulars
24901,847,10,1002.1700000000001,1,3,2,6,Regulars
24902,496,10,1432.72,1,3,3,7,Regulars
24903,19,15,1366.3700000000001,5,5,3,13,Loyal
24904,630,7,841.91,1,1,1,3,Hibernating
24905,192,5,307.47,3,1,1,5,Regulars
24906,50,14,3278.6,5,5,5,15,Champions
24907,510,8,993.21,1,2,2,5,Hibernating
24908,255,10,1068.7,2,3,2,7,Regulars
24909,97,11,2756.22,4,3,5,12,Loyal
24910,219,13,2105.4700000000003,3,4,4,11,Big Spenders
24911,8,11,1628.32,5,3,3,11,Loyal
24912,579,8,1113.26,1,2,2,5,Hibernating
24913,145,9,739.17,4,2,1,7,Regulars
24914,213,9,1634.0,3,2,3,8,Regulars
24915,164,10,661.46,3,3,1,7,Regulars
24916,35,10,888.38,5,3,2,10,Loyal
24917,255,12,6001.4,2,4,5,11,At Risk
24918,243,11,957.8399999999999,3,3,2,8,Regulars
24919,85,8,1727.74,4,2,4,10,Big Spenders
24920,255,10,3473.8900000000003,2,3,5,10,Regulars
24921,129,13,1389.0,4,4,3,11,Loyal
24922,621,12,1953.1499999999999,1,4,4,9,At Risk
24923,45,8,1594.3600000000001,5,2,3,10,Regulars
24924,330,11,1596.58,2,3,3,8,Regulars
24925,45,10,1393.85,5,3,3,11,Loyal
24926,148,10,1057.6599999999999,3,3,2,8,Regulars
24927,196,13,1430.21,3,4,3,10,Regulars
24928,565,4,255.14,1,1,1,3,Hibernating
24929,267,8,767.1,2,2,1,5,Hibernating
24930,231,10,4256.110000000001,3,3,5,11,Big Spenders
24931,645,6,2394.5,1,1,4,6,Regulars
24932,874,6,1632.8400000000001,1,1,3,5,Regulars
24933,361,7,925.6,2,1,2,5,Hibernating
24934,455,9,1117.87,2,2,2,6,Hibernating
24935,119,9,1450.07,4,2,3,9,Regulars
24936,367,10,1948.29,2,3,4,9,Regulars
24937,244,14,1293.34,3,5,3,11,Regulars
24938,7,11,1450.53,5,3,3,11,Loyal
24939,1336,7,1389.67,1,1,3,5,Regulars
24940,444,7,781.6700000000001,2,1,1,4,Hibernating
24941,22,15,3731.62,5,5,5,15,Champions
24942,59,8,1649.2900000000002,5,2,3,10,Regulars
24943,29,9,1387.35,5,2,3,10,Regulars
24944,48,14,3240.76,5,5,5,15,Champions
24945,31,13,2042.79,5,4,4,13,Champions
24946,296,8,387.82000000000005,2,2,1,5,Hibernating
24947,349,13,2746.93,2,4,5,11,At Risk
24948,86,5,392.63,4,1,1,6,Regulars
24949,639,7,683.62,1,1,1,3,Hibernating
24950,43,7,927.66,5,1,2,8,Regulars
24951,64,7,1474.62,5,1,3,9,Regulars
24952,701,7,2479.19,1,1,4,6,Regulars
24953,144,7,1035.7,4,1,2,7,Regulars
24954,2,6,735.9100000000001,5,1,1,7,Regulars
24955,693,8,928.99,1,2,2,5,Hibernating
24956,54,11,749.63,5,3,1,9,Loyal
24957,67,12,1971.77,4,4,4,12,Champions
24958,1293,7,577.8800000000001,1,1,1,3,Hibernating
24959,139,15,3269.7,4,5,5,14,Champions
24960,119,10,2508.0,4,3,4,11,Loyal
24961,155,4,154.78,3,1,1,5,Regulars
24962,237,18,2925.21,3,5,5,13,Big Spenders
24963,534,4,1057.67,1,1,2,4,Hibernating
24964,377,9,2055.14,2,2,4,8,Regulars
24965,149,14,2292.98,3,5,4,12,Big Spenders
24966,605,12,2686.75,1,4,5,10,At Risk
24967,12,13,1490.21,5,4,3,12,Loyal
24968,452,10,1292.79,2,3,3,8,Regulars
24969,676,10,1254.12,1,3,3,7,Regulars
24970,236,8,558.99,3,2,1,6,Regulars
24971,263,8,2693.94,2,2,5,9,Regulars
24972,376,9,1637.3,2,2,3,7,Regulars
24973,124,5,328.98,4,1,1,6,Regulars
24974,103,19,4155.22,4,5,5,14,Champions
24975,14,10,4377.849999999999,5,3,5,13,Loyal
24976,8,10,1125.8799999999999,5,3,2,10,Loyal
24977,709,5,410.88,1,1,1,3,Hibernating
24978,91,4,512.4300000000001,4,1,1,6,Regulars
24979,1125,5,1085.01,1,1,2,4,Hibernating
24980,50,8,654.0600000000001,5,2,1,8,Regulars
24981,84,17,2826.92,4,5,5,14,Champions
24982,631,4,591.6899999999999,1,1,1,3,Hibernating
24983,85,9,528.1800000000001,4,2,1,7,Regulars
24984,234,8,2130.91,3,2,4,9,Big Spenders
24985,11,14,2168.52,5,5,4,14,Champions
24986,44,9,2211.61,5,2,4,11,Big Spenders
24987,139,12,2981.83,4,4,5,13,Champions
24988,154,10,1512.52,3,3,3,9,Regulars
24989,266,9,2483.49,2,2,4,8,Regulars
24990,455,10,1260.75,2,3,3,8,Regulars
24991,15,14,1439.52,5,5,3,13,Loyal
24992,292,8,1247.54,2,2,3,7,Regulars
24993,76,12,1294.13,4,4,3,11,Loyal
24994,321,6,801.92,2,1,1,4,Hibernating
24995,147,11,3303.7,4,3,5,12,Loyal
24996,357,7,972.8199999999999,2,1,2,5,Hibernating
24997,169,13,1530.59,3,4,3,10,Regulars
24998,515,8,881.42,1,2,2,5,Hibernating
24999,52,7,2271.45,5,1,4,10,Big Spenders
25000,242,11,1680.36,3,3,3,9,Regulars
25001,412,10,1490.8300000000002,2,3,3,8,Regulars
25002,196,8,1232.11,3,2,2,7,Regulars
25003,160,8,2150.63,3,2,4,9,Big Spenders
25004,197,14,3087.06,3,5,5,13,Big Spenders
25005,16,12,2713.03,5,4,5,14,Champions
25006,496,10,1454.82,1,3,3,7,Regulars
25007,186,8,348.33,3,2,1,6,Regulars
25008,26,15,1091.51,5,5,2,12,Loyal
25009,213,12,1063.9,3,4,2,9,Regulars
25010,184,8,2424.74,3,2,4,9,Big Spenders
25011,891,14,3171.2999999999997,1,5,5,11,At Risk
25012,400,8,1512.69,2,2,3,7,Regulars
25013,193,9,1503.54,3,2,3,8,Regulars
25014,188,14,3729.36,3,5,5,13,Big Spenders
25015,692,9,1249.46,1,2,3,6,Regulars
25016,19,9,1406.82,5,2,3,10,Regulars
25017,46,8,761.96,5,2,1,8,Regulars
25018,129,7,337.73,4,1,1,6,Regulars
25019,106,9,3132.29,4,2,5,11,Big Spenders
25020,60,10,1132.56,5,3,2,10,Loyal
25021,184,9,1803.9099999999999,3,2,4,9,Big Spenders
25022,211,11,1836.75,3,3,4,10,Big Spenders
25023,1318,7,916.57,1,1,2,4,Hibernating
25024,226,8,832.4200000000001,3,2,1,6,Regulars
25025,14,14,2129.61,5,5,4,14,Champions
25026,38,14,1325.4299999999998,5,5,3,13,Loyal
25027,262,13,1027.5,2,4,2,8,At Risk
25028,145,11,1879.78,4,3,4,11,Loyal
25029,489,5,524.6700000000001,1,1,1,3,Hibernating
25030,644,9,3538.6499999999996,1,2,5,8,Regulars
25031,268,11,1197.8600000000001,2,3,2,7,Regulars
25032,23,16,3224.52,5,5,5,15,Champions
25033,328,10,2455.31,2,3,4,9,Regulars
25034,196,8,1007.91,3,2,2,7,Regulars
25035,380,9,686.6800000000001,2,2,1,5,Hibernating
25036,136,6,350.96999999999997,4,1,1,6,Regulars
25037,571,5,324.44,1,1,1,3,Hibernating
25038,26,13,3616.42,5,4,5,14,Champions
25039,353,10,3809.74,2,3,5,10,Regulars
25040,36,11,1281.85,5,3,3,11,Loyal
25041,13,8,1195.23,5,2,2,9,Regulars
25042,234,10,1259.5600000000002,3,3,3,9,Regulars
25043,561,9,820.53,1,2,1,4,Hibernating
25044,288,11,1291.71,2,3,3,8,Regulars
25045,14,14,990.4,5,5,2,12,Loyal
25046,11,17,2060.92,5,5,4,14,Champions
25047,254,5,347.58,2,1,1,4,Hibernating
25048,190,12,3574.56,3,4,5,12,Big Spenders
25049,278,4,182.03000000000003,2,1,1,4,Hibernating
25050,42,13,1098.5,5,4,2,11,Loyal
25051,136,13,6131.49,4,4,5,13,Champions
25052,2,8,3140.4500000000003,5,2,5,12,Big Spenders
25053,170,6,923.07,3,1,2,6,Regulars
25054,431,11,1465.51,2,3,3,8,Regulars
25055,234,11,2288.25,3,3,4,10,Big Spenders
25056,47,21,7319.48,5,5,5,15,Champions
25057,30,10,1805.47,5,3,4,12,Loyal
25058,50,13,1406.6,5,4,3,12,Loyal
25059,161,6,1196.49,3,1,2,6,Regulars
25060,113,11,3426.45,4,3,5,12,Loyal
25061,14,14,2711.5,5,5,5,15,Champions
25062,216,17,3840.13,3,5,5,13,Big Spenders
25063,12,9,438.28999999999996,5,2,1,8,Regulars
25064,222,11,3447.16,3,3,5,11,Big Spenders
25065,493,9,666.09,1,2,1,4,Hibernating
25066,34,10,1234.6299999999999,5,3,2,10,Loyal
25067,108,12,5847.37,4,4,5,13,Champions
25068,61,9,1168.03,5,2,2,9,Regulars
25069,195,5,1491.6200000000001,3,1,3,7,Regulars
25070,25,15,988.6100000000001,5,5,2,12,Loyal
25071,163,13,898.51,3,4,2,9,Regulars
25072,129,8,841.0600000000001,4,2,1,7,Regulars
25073,201,10,1343.48,3,3,3,9,Regulars
25074,108,11,471.43,4,3,1,8,Loyal
25075,463,14,6295.05,1,5,5,11,At Risk
25076,33,10,2682.38,5,3,5,13,Loyal
25077,75,14,1745.8500000000001,4,5,4,13,Champions
25078,86,4,614.5099999999999,4,1,1,6,Regulars
25079,36,19,3658.23,5,5,5,15,Champions
25080,440,5,301.16,2,1,1,4,Hibernating
25081,198,9,1188.8500000000001,3,2,2,7,Regulars
25082,370,8,943.8000000000001,2,2,2,6,Hibernating
25083,408,6,2271.75,2,1,4,7,Regulars
25084,1079,7,562.4000000000001,1,1,1,3,Hibernating
25085,136,9,1197.51,4,2,2,8,Regulars
25086,454,10,1020.35,2,3,2,7,Regulars
25087,178,7,1142.93,3,1,2,6,Regulars
25088,62,13,2303.0499999999997,5,4,4,13,Champions
25089,447,8,374.84000000000003,2,2,1,5,Hibernating
25090,240,12,1217.2,3,4,2,9,Regulars
25091,94,17,2947.33,4,5,5,14,Champions
25092,7,12,2784.93,5,4,5,14,Champions
25093,118,16,2525.98,4,5,4,13,Champions
25094,42,11,2606.01,5,3,5,13,Loyal
25095,174,10,856.92,3,3,2,8,Regulars
25096,692,7,758.8900000000001,1,1,1,3,Hibernating
25097,61,11,1648.6499999999999,5,3,3,11,Loyal
25098,26,11,1541.75,5,3,3,11,Loyal
25099,457,7,844.9300000000001,2,1,2,5,Hibernating
25100,245,9,2021.02,3,2,4,9,Big Spenders
25101,599,8,1700.04,1,2,3,6,Regulars
25102,49,10,1460.45,5,3,3,11,Loyal
25103,228,13,1151.57,3,4,2,9,Regulars
25104,565,14,4513.5199999999995,1,5,5,11,At Risk
25105,168,19,2953.0699999999997,3,5,5,13,Big Spenders
25106,365,12,1498.93,2,4,3,9,At Risk
25107,167,10,1175.0,3,3,2,8,Regulars
25108,22,11,1491.8,5,3,3,11,Loyal
25109,161,9,1514.9,3,2,3,8,Regulars
25110,547,7,2560.82,1,1,4,6,Regulars
25111,147,12,1599.8999999999999,4,4,3,11,Loyal
25112,12,7,1436.6399999999999,5,1,3,9,Regulars
25113,29,11,1197.81,5,3,2,10,Loyal
25114,252,9,2079.58,2,2,4,8,Regulars
25115,628,8,3007.48,1,2,5,8,Regulars
25116,183,8,2083.61,3,2,4,9,Big Spenders
25117,177,10,1864.99,3,3,4,10,Big Spenders
25118,477,8,720.01,1,2,1,4,Hibernating
25119,349,14,1666.02,2,5,3,10,At Risk
25120,74,9,934.41,4,2,2,8,Regulars
25121,161,13,1656.6,3,4,3,10,Regulars
25122,5,9,1064.44,5,2,2,9,Regulars
25123,543,14,1626.71,1,5,3,9,At Risk
25124,53,9,889.53,5,2,2,9,Regulars
25125,382,14,3182.0299999999997,2,5,5,12,At Risk
25126,122,9,3398.8100000000004,4,2,5,11,Big Spenders
25127,118,11,726.05,4,3,1,8,Loyal
25128,25,13,5035.7300000000005,5,4,5,14,Champions
25129,154,11,2112.51,3,3,4,10,Big Spenders
25130,82,10,1298.4299999999998,4,3,3,10,Loyal
25131,446,8,630.23,2,2,1,5,Hibernating
25132,946,11,1405.6399999999999,1,3,3,7,Regulars
25133,13,14,5741.11,5,5,5,15,Champions
25134,871,8,1551.2399999999998,1,2,3,6,Regulars
25135,123,11,775.04,4,3,1,8,Loyal
25136,208,11,1327.82,3,3,3,9,Regulars
25137,984,7,3061.0,1,1,5,7,Regulars
25138,72,10,1120.6799999999998,4,3,2,9,Loyal
25139,162,12,3371.48,3,4,5,12,Big Spenders
25140,916,5,497.85999999999996,1,1,1,3,Hibernating
25141,83,6,514.75,4,1,1,6,Regulars
25142,195,5,1414.34,3,1,3,7,Regulars
25143,138,13,2197.46,4,4,4,12,Champions
25144,142,8,3702.07,4,2,5,11,Big Spenders
25145,185,11,2472.64,3,3,4,10,Big Spenders
25146,761,9,905.4100000000001,1,2,2,5,Hibernating
25147,86,13,1115.8999999999999,4,4,2,10,Loyal
25148,247,8,1359.3,3,2,3,8,Regulars
25149,72,8,820.37,4,2,1,7,Regulars
25150,1113,10,1465.5,1,3,3,7,Regulars
25151,553,8,595.37,1,2,1,4,Hibernating
25152,131,4,604.02,4,1,1,6,Regulars
25153,405,9,1091.43,2,2,2,6,Hibernating
25154,348,13,2877.7,2,4,5,11,At Risk
25155,193,8,2206.98,3,2,4,9,Big Spenders
25156,461,9,628.3000000000001,1,2,1,4,Hibernating
25157,892,9,3961.56,1,2,5,8,Regulars
25158,686,13,1576.57,1,4,3,8,At Risk
25159,129,8,3255.34,4,2,5,11,Big Spenders
25160,201,12,1326.07,3,4,3,10,Regulars
25161,179,9,1425.6399999999999,3,2,3,8,Regulars
25162,58,12,2261.6600000000003,5,4,4,13,Champions
25163,48,16,8384.9,5,5,5,15,Champions
25164,56,10,1213.69,5,3,2,10,Loyal
25165,698,9,727.5999999999999,1,2,1,4,Hibernating
25166,165,9,4752.7,3,2,5,10,Big Spenders
25167,135,11,3331.17,4,3,5,12,Loyal
25168,18,10,2147.17,5,3,4,12,Loyal
25169,630,6,1383.04,1,1,3,5,Regulars
25170,92,15,3230.36,4,5,5,14,Champions
25171,201,9,1053.3600000000001,3,2,2,7,Regulars
25172,82,18,3508.68,4,5,5,14,Champions
25173,29,13,2018.3600000000001,5,4,4,13,Champions
25174,15,11,1843.52,5,3,4,12,Loyal
25175,21,9,1391.77,5,2,3,10,Regulars
25176,164,13,2514.69,3,4,4,11,Big Spenders
25177,302,4,1281.84,2,1,3,6,Regulars
25178,17,11,812.99,5,3,1,9,Loyal
25179,72,12,1297.84,4,4,3,11,Loyal
25180,486,11,842.9,1,3,1,5,Regulars
25181,142,16,4125.17,4,5,5,14,Champions
25182,512,14,1276.75,1,5,3,9,At Risk
25183,908,8,749.74,1,2,1,4,Hibernating
25184,333,11,3371.52,2,3,5,10,Regulars
25185,348,13,1483.6799999999998,2,4,3,9,At Risk
25186,154,15,1780.34,3,5,4,12,Big Spenders
25187,310,9,1316.7,2,2,3,7,Regulars
25188,1194,6,885.84,1,1,2,4,Hibernating
25189,311,9,3088.84,2,2,5,9,Regulars
25190,236,11,1629.46,3,3,3,9,Regulars
25191,201,13,3829.34,3,4,5,12,Big Spenders
25192,65,12,1855.37,5,4,4,13,Champions
25193,173,11,2242.82,3,3,4,10,Big Spenders
25194,255,9,1898.4199999999998,2,2,4,8,Regulars
25195,322,13,1827.25,2,4,4,10,At Risk
25196,522,10,2524.41,1,3,4,8,Regulars
25197,308,12,1353.17,2,4,3,9,At Risk
25198,55,16,1067.3899999999999,5,5,2,12,Loyal
25199,186,10,1101.98,3,3,2,8,Regulars
25200,147,10,2795.7599999999998,4,3,5,12,Loyal
25201,365,6,406.64,2,1,1,4,Hibernating
25202,80,12,1839.6599999999999,4,4,4,12,Champions
25203,187,12,1818.78,3,4,4,11,Big Spenders
25204,521,7,1654.24,1,1,3,5,Regulars
25205,1899,7,998.71,1,1,2,4,Hibernating
25206,692,12,700.48,1,4,1,6,At Risk
25207,100,15,1330.75,4,5,3,12,Loyal
25208,43,9,2657.76,5,2,5,12,Big Spenders
25209,32,16,1296.89,5,5,3,13,Loyal
25210,414,10,1735.8200000000002,2,3,4,9,Regulars
25211,170,14,1240.14,3,5,2,10,Regulars
25212,49,8,726.43,5,2,1,8,Regulars
25213,206,8,1596.34,3,2,3,8,Regulars
25214,169,13,2204.59,3,4,4,11,Big Spenders
25215,147,12,1785.3500000000001,4,4,4,12,Champions
25216,279,9,550.44,2,2,1,5,Hibernating
25217,72,10,647.8,4,3,1,8,Loyal
25218,64,9,679.61,5,2,1,8,Regulars
25219,15,15,3753.8799999999997,5,5,5,15,Champions
25220,26,10,1169.06,5,3,2,10,Loyal
25221,84,12,4116.25,4,4,5,13,Champions
25222,87,13,1889.64,4,4,4,12,Champions
25223,85,9,1387.48,4,2,3,9,Regulars
25224,223,8,3444.07,3,2,5,10,Big Spenders
25225,1359,5,1169.87,1,1,2,4,Hibernating
25226,74,6,2313.69,4,1,4,9,Big Spenders
25227,99,9,1903.23,4,2,4,10,Big Spenders
25228,296,12,1229.95,2,4,2,8,At Risk
25229,135,12,1522.44,4,4,3,11,Loyal
25230,246,9,403.21999999999997,3,2,1,6,Regulars
25231,303,11,3032.17,2,3,5,10,Regulars
25232,530,7,1141.21,1,1,2,4,Hibernating
25233,142,10,1562.01,4,3,3,10,Loyal
25234,234,15,1418.48,3,5,3,11,Regulars
25235,50,6,856.37,5,1,2,8,Regulars
25236,116,13,1723.91,4,4,3,11,Loyal
25237,11,12,3018.04,5,4,5,14,Champions
25238,14,8,550.5600000000001,5,2,1,8,Regulars
25239,243,9,2238.85,3,2,4,9,Big Spenders
25240,627,6,734.29,1,1,1,3,Hibernating
25241,71,11,2008.4899999999998,4,3,4,11,Loyal
25242,541,13,970.06,1,4,2,7,At Risk
25243,110,14,3310.95,4,5,5,14,Champions
25244,344,9,593.4599999999999,2,2,1,5,Hibernating
25245,484,11,2156.0,1,3,4,8,Regulars
25246,344,10,890.77,2,3,2,7,Regulars
25247,522,8,995.14,1,2,2,5,Hibernating
25248,174,14,4277.52,3,5,5,13,Big Spenders
25249,502,10,1130.48,1,3,2,6,Regulars
25250,708,10,1525.02,1,3,3,7,Regulars
25251,38,8,1515.52,5,2,3,10,Regulars
25252,135,7,1164.77,4,1,2,7,Regulars
25253,294,4,1925.05,2,1,4,7,Regulars
25254,542,16,4428.08,1,5,5,11,At Risk
25255,336,9,960.43,2,2,2,6,Hibernating
25256,14,10,1777.29,5,3,4,12,Loyal
25257,14,12,2950.1099999999997,5,4,5,14,Champions
25258,168,12,3739.38,3,4,5,12,Big Spenders
25259,164,11,786.13,3,3,1,7,Regulars
25260,400,9,1233.1399999999999,2,2,2,6,Hibernating
25261,775,6,348.82,1,1,1,3,Hibernating
25262,2,14,1654.03,5,5,3,13,Loyal
25263,544,5,1149.9099999999999,1,1,2,4,Hibernating
25264,101,12,1945.25,4,4,4,12,Champions
25265,641,6,256.51,1,1,1,3,Hibernating
25266,502,8,2690.06,1,2,5,8,Regulars
25267,31,13,3676.7699999999995,5,4,5,14,Champions
25268,94,9,1313.34,4,2,3,9,Regulars
25269,23,21,3572.09,5,5,5,15,Champions
25270,90,15,2326.42,4,5,4,13,Champions
25271,319,9,1342.8600000000001,2,2,3,7,Regulars
25272,375,9,996.27,2,2,2,6,Hibernating
25273,60,12,969.28,5,4,2,11,Loyal
25274,38,6,1311.69,5,1,3,9,Regulars
25275,574,9,1992.78,1,2,4,7,Regulars
25276,21,8,721.4,5,2,1,8,Regulars
25277,816,6,506.26,1,1,1,3,Hibernating
25278,62,11,4313.43,5,3,5,13,Loyal
25279,659,9,2006.15,1,2,4,7,Regulars
25280,93,15,8948.51,4,5,5,14,Champions
25281,251,15,1554.07,2,5,3,10,At Risk
25282,277,3,986.42,2,1,2,5,Hibernating
25283,593,12,1697.8400000000001,1,4,3,8,At Risk
25284,47,12,4253.96,5,4,5,14,Champions
25285,94,11,1184.82,4,3,2,9,Loyal
25286,136,11,1954.93,4,3,4,11,Loyal
25287,394,9,913.11,2,2,2,6,Hibernating
25288,227,8,1347.32,3,2,3,8,Regulars
25289,196,5,740.53,3,1,1,5,Regulars
25290,151,5,853.32,3,1,2,6,Regulars
25291,37,15,2331.75,5,5,4,14,Champions
25292,412,12,1520.86,2,4,3,9,At Risk
25293,179,12,3360.25,3,4,5,12,Big Spenders
25294,300,12,1935.52,2,4,4,10,At Risk
25295,1011,5,1137.39,1,1,2,4,Hibernating
25296,107,14,1685.75,4,5,3,12,Loyal
25297,335,4,157.17999999999998,2,1,1,4,Hibernating
25298,661,12,1679.21,1,4,3,8,At Risk
25299,43,11,1151.17,5,3,2,10,Loyal
25300,129,11,4409.77,4,3,5,12,Loyal
25301,172,10,1205.17,3,3,2,8,Regulars
25302,120,11,3328.0699999999997,4,3,5,12,Loyal
25303,24,10,781.38,5,3,1,9,Loyal
25304,346,10,5644.96,2,3,5,10,Regulars
25305,324,11,1319.2,2,3,3,8,Regulars
25306,25,9,751.0,5,2,1,8,Regulars
25307,81,10,2013.28,4,3,4,11,Loyal
25308,38,13,2653.94,5,4,5,14,Champions
25309,809,7,642.55,1,1,1,3,Hibernating
25310,104,7,639.46,4,1,1,6,Regulars
25311,1251,11,2726.5299999999997,1,3,5,9,Regulars
25312,314,6,675.01,2,1,1,4,Hibernating
25313,213,7,925.58,3,1,2,6,Regulars
25314,502,14,1536.07,1,5,3,9,At Risk
25315,98,12,2973.62,4,4,5,13,Champions
25316,352,13,778.92,2,4,1,7,At Risk
25317,207,8,1751.34,3,2,4,9,Big Spenders
25318,137,13,2062.02,4,4,4,12,Champions
25319,1541,6,649.04,1,1,1,3,Hibernating
25320,326,10,1989.46,2,3,4,9,Regulars
25321,76,10,1419.7600000000002,4,3,3,10,Loyal
25322,76,13,1265.6200000000001,4,4,3,11,Loyal
25323,117,15,4848.16,4,5,5,14,Champions
25324,231,11,2626.18,3,3,5,11,Big Spenders
25325,1188,8,1697.72,1,2,3,6,Regulars
25326,143,10,1324.46,4,3,3,10,Loyal
25327,90,18,1701.98,4,5,3,12,Loyal
25328,295,11,3143.2,2,3,5,10,Regulars
25329,826,7,3665.34,1,1,5,7,Regulars
25330,83,7,3188.2900000000004,4,1,5,10,Big Spenders
25331,541,9,1468.54,1,2,3,6,Regulars
25332,225,11,2042.7,3,3,4,10,Big Spenders
25333,99,5,1583.19,4,1,3,8,Regulars
25334,1177,9,1404.21,1,2,3,6,Regulars
25335,697,11,2196.84,1,3,4,8,Regulars
25336,54,11,1613.6799999999998,5,3,3,11,Loyal
25337,184,4,608.4200000000001,3,1,1,5,Regulars
25338,150,6,1724.0299999999997,3,1,3,7,Regulars
25339,220,13,4142.68,3,4,5,12,Big Spenders
25340,108,4,973.54,4,1,2,7,Regulars
25341,160,10,1017.1999999999999,3,3,2,8,Regulars
25342,75,10,2042.42,4,3,4,11,Loyal
25343,35,10,1071.44,5,3,2,10,Loyal
25344,724,15,1135.44,1,5,2,8,At Risk
25345,13,14,1971.8300000000002,5,5,4,14,Champions
25346,110,9,1374.5600000000002,4,2,3,9,Regulars
25347,212,12,2691.5099999999998,3,4,5,12,Big Spenders
25348,246,9,863.4,3,2,2,7,Regulars
25349,470,16,1615.16,1,5,3,9,At Risk
25350,210,19,2905.0699999999997,3,5,5,13,Big Spenders
25351,300,13,6223.29,2,4,5,11,At Risk
25352,424,6,1204.27,2,1,2,5,Hibernating
25353,175,8,874.86,3,2,2,7,Regulars
25354,153,12,4423.12,3,4,5,12,Big Spenders
25355,189,6,1741.1100000000004,3,1,4,8,Big Spenders
25356,52,11,779.9300000000001,5,3,1,9,Loyal
25357,538,18,1622.75,1,5,3,9,At Risk
25358,238,7,604.87,3,1,1,5,Regulars
25359,71,23,5040.42,4,5,5,14,Champions
25360,386,11,1462.72,2,3,3,8,Regulars
25361,601,11,1929.52,1,3,4,8,Regulars
25362,48,7,2775.71,5,1,5,11,Big Spenders
25363,401,6,589.23,2,1,1,4,Hibernating
25364,741,15,1352.05,1,5,3,9,At Risk
25365,548,7,572.6700000000001,1,1,1,3,Hibernating
25366,713,13,3397.12,1,4,5,10,At Risk
25367,168,15,2824.01,3,5,5,13,Big Spenders
25368,161,8,511.99,3,2,1,6,Regulars
25369,202,12,2220.29,3,4,4,11,Big Spenders
25370,42,9,2206.25,5,2,4,11,Big Spenders
25371,111,5,529.1,4,1,1,6,Regulars
25372,190,16,4125.3,3,5,5,13,Big Spenders
25373,47,11,932.52,5,3,2,10,Loyal
25374,279,17,4434.88,2,5,5,12,At Risk
25375,2,5,1011.87,5,1,2,8,Regulars
25376,395,12,2341.67,2,4,4,10,At Risk
25377,690,11,1238.35,1,3,2,6,Regulars
25378,42,8,646.11,5,2,1,8,Regulars
25379,377,11,1704.0600000000002,2,3,3,8,Regulars
25380,786,5,1313.84,1,1,3,5,Regulars
25381,440,9,666.04,2,2,1,5,Hibernating
25382,9,10,2636.28,5,3,5,13,Loyal
25383,396,8,1694.92,2,2,3,7,Regulars
25384,2,11,1655.55,5,3,3,11,Loyal
25385,23,11,1283.05,5,3,3,11,Loyal
25386,378,8,2352.27,2,2,4,8,Regulars
25387,246,19,2608.31,3,5,5,13,Big Spenders
25388,78,9,342.34000000000003,4,2,1,7,Regulars
25389,227,7,937.57,3,1,2,6,Regulars
25390,91,5,1352.82,4,1,3,8,Regulars
25391,1578,5,932.44,1,1,2,4,Hibernating
25392,219,9,934.5799999999999,3,2,2,7,Regulars
25393,97,9,914.8300000000002,4,2,2,8,Regulars
25394,507,12,1184.01,1,4,2,7,At Risk
25395,202,11,1406.07,3,3,3,9,Regulars
25396,164,13,3477.9,3,4,5,12,Big Spenders
25397,186,6,3935.29,3,1,5,9,Big Spenders
25398,41,15,4381.31,5,5,5,15,Champions
25399,201,10,782.9300000000001,3,3,1,7,Regulars
25400,18,10,785.5600000000001,5,3,1,9,Loyal
25401,81,11,2964.19,4,3,5,12,Loyal
25402,1317,5,751.83,1,1,1,3,Hibernating
25403,182,8,1002.25,3,2,2,7,Regulars
25404,158,12,2646.33,3,4,5,12,Big Spenders
25405,132,6,3030.99,4,1,5,10,Big Spenders
25406,125,11,904.12,4,3,2,9,Loyal
25407,234,11,1533.13,3,3,3,9,Regulars
25408,1206,4,535.13,1,1,1,3,Hibernating
25409,53,13,2710.68,5,4,5,14,Champions
25410,1001,3,460.66999999999996,1,1,1,3,Hibernating
25411,64,13,1467.1000000000001,5,4,3,12,Loyal
25412,84,7,333.71,4,1,1,6,Regulars
25413,88,7,1658.75,4,1,3,8,Regulars
25414,213,12,1641.33,3,4,3,10,Regulars
25415,147,9,2378.98,4,2,4,10,Big Spenders
25416,139,10,1357.05,4,3,3,10,Loyal
25417,665,8,961.71,1,2,2,5,Hibernating
25418,189,11,3559.6699999999996,3,3,5,11,Big Spenders
25419,476,9,1846.4,1,2,4,7,Regulars
25420,213,11,1104.06,3,3,2,8,Regulars
25421,39,6,323.43000000000006,5,1,1,7,Regulars
25422,159,16,2526.61,3,5,4,12,Big Spenders
25423,156,10,1151.39,3,3,2,8,Regulars
25424,418,13,2179.21,2,4,4,10,At Risk
25425,197,14,1979.99,3,5,4,12,Big Spenders
25426,136,12,3727.23,4,4,5,13,Champions
25427,148,11,1374.65,3,3,3,9,Regulars
25428,155,13,1511.4,3,4,3,10,Regulars
25429,265,6,2031.67,2,1,4,7,Regulars
25430,13,14,1320.02,5,5,3,13,Loyal
25431,301,14,1456.81,2,5,3,10,At Risk
25432,35,9,729.63,5,2,1,8,Regulars
25433,164,10,3142.38,3,3,5,11,Big Spenders
25434,331,9,1555.75,2,2,3,7,Regulars
25435,247,11,1244.52,3,3,3,9,Regulars
25436,264,11,2394.01,2,3,4,9,Regulars
25437,110,9,684.21,4,2,1,7,Regulars
25438,373,12,4001.42,2,4,5,11,At Risk
25439,27,10,2696.91,5,3,5,13,Loyal
25440,879,7,1125.3,1,1,2,4,Hibernating
25441,502,12,1053.2,1,4,2,7,At Risk
25442,245,11,1601.55,3,3,3,9,Regulars
25443,646,5,490.65999999999997,1,1,1,3,Hibernating
25444,230,4,840.2,3,1,1,5,Regulars
25445,891,6,386.0,1,1,1,3,Hibernating
25446,697,16,2135.34,1,5,4,10,At Risk
25447,186,15,1585.47,3,5,3,11,Regulars
25448,106,8,1112.23,4,2,2,8,Regulars
25449,138,6,1198.87,4,1,2,7,Regulars
25450,228,9,1510.6,3,2,3,8,Regulars
25451,16,9,1128.24,5,2,2,9,Regulars
25452,128,12,2556.49,4,4,4,12,Champions
25453,78,15,2618.58,4,5,5,14,Champions
25454,132,16,3303.3,4,5,5,14,Champions
25455,61,11,932.9200000000001,5,3,2,10,Loyal
25456,103,11,796.5699999999999,4,3,1,8,Loyal
25457,50,9,549.93,5,2,1,8,Regulars
25458,287,14,4634.28,2,5,5,12,At Risk
25459,71,11,1506.2,4,3,3,10,Loyal
25460,35,14,2128.92,5,5,4,14,Champions
25461,41,9,1832.43,5,2,4,11,Big Spenders
25462,8,10,674.1,5,3,1,9,Loyal
25463,174,9,1095.04,3,2,2,7,Regulars
25464,23,12,2360.51,5,4,4,13,Champions
25465,273,8,1520.21,2,2,3,7,Regulars
25466,249,8,959.1299999999999,2,2,2,6,Hibernating
25467,79,12,3675.32,4,4,5,13,Champions
25468,3,13,982.5699999999999,5,4,2,11,Loyal
25469,60,13,1783.2,5,4,4,13,Champions
25470,175,7,1543.91,3,1,3,7,Regulars
25471,445,7,1939.8200000000002,2,1,4,7,Regulars
25472,568,16,4584.39,1,5,5,11,At Risk
25473,343,13,1938.67,2,4,4,10,At Risk
25474,0,16,2775.87,5,5,5,15,Champions
25475,153,6,1703.41,3,1,3,7,Regulars
25476,75,6,990.1399999999999,4,1,2,7,Regulars
25477,63,7,793.63,5,1,1,7,Regulars
25478,278,6,416.45,2,1,1,4,Hibernating
25479,154,10,569.9300000000001,3,3,1,7,Regulars
25480,761,11,1298.38,1,3,3,7,Regulars
25481,7,12,2507.37,5,4,4,13,Champions
25482,48,8,1181.54,5,2,2,9,Regulars
25483,279,15,2209.84,2,5,4,11,At Risk
25484,89,8,1470.42,4,2,3,9,Regulars
25485,92,15,2680.8599999999997,4,5,5,14,Champions
25486,55,7,786.0799999999999,5,1,1,7,Regulars
25487,70,14,3538.26,4,5,5,14,Champions
25488,23,16,2672.77,5,5,5,15,Champions
25489,589,6,1228.69,1,1,2,4,Hibernating
25490,109,8,928.85,4,2,2,8,Regulars
25491,1110,8,895.9599999999999,1,2,2,5,Hibernating
25492,535,10,1932.39,1,3,4,8,Regulars
25493,143,14,2289.29,4,5,4,13,Champions
25494,219,5,411.78999999999996,3,1,1,5,Regulars
25495,394,5,791.3900000000001,2,1,1,4,Hibernating
25496,616,10,1344.27,1,3,3,7,Regulars
25497,47,9,1647.8700000000001,5,2,3,10,Regulars
25498,1264,6,463.78999999999996,1,1,1,3,Hibernating
25499,26,16,2407.62,5,5,4,14,Champions
25500,155,6,832.3199999999999,3,1,1,5,Regulars
25501,176,10,2796.73,3,3,5,11,Big Spenders
25502,351,8,922.53,2,2,2,6,Hibernating
25503,8,12,1075.15,5,4,2,11,Loyal
25504,122,10,2998.52,4,3,5,12,Loyal
25505,285,11,1303.99,2,3,3,8,Regulars
25506,33,9,890.3299999999999,5,2,2,9,Regulars
25507,281,9,687.97,2,2,1,5,Hibernating
25508,267,8,1137.5800000000002,2,2,2,6,Hibernating
25509,295,13,3739.07,2,4,5,11,At Risk
25510,710,9,1186.8700000000001,1,2,2,5,Hibernating
25511,264,9,950.23,2,2,2,6,Hibernating
25512,50,7,1109.4,5,1,2,8,Regulars
25513,297,15,2349.15,2,5,4,11,At Risk
25514,201,14,4484.38,3,5,5,13,Big Spenders
25515,351,6,1283.91,2,1,3,6,Regulars
25516,84,9,4134.639999999999,4,2,5,11,Big Spenders
25517,52,7,1041.49,5,1,2,8,Regulars
25518,139,15,1490.97,4,5,3,12,Loyal
25519,278,16,2270.36,2,5,4,11,At Risk
25520,417,10,969.74,2,3,2,7,Regulars
25521,158,9,1219.68,3,2,2,7,Regulars
25522,747,5,650.76,1,1,1,3,Hibernating
25523,46,8,579.92,5,2,1,8,Regulars
25524,692,9,862.31,1,2,2,5,Hibernating
25525,118,9,2291.97,4,2,4,10,Big Spenders
25526,63,17,3058.8700000000003,5,5,5,15,Champions
25527,405,3,247.04,2,1,1,4,Hibernating
25528,520,8,2044.64,1,2,4,7,Regulars
25529,225,11,1650.04,3,3,3,9,Regulars
25530,174,5,541.83,3,1,1,5,Regulars
25531,201,6,1130.5900000000001,3,1,2,6,Regulars
25532,66,16,2777.29,4,5,5,14,Champions
25533,148,7,470.86,3,1,1,5,Regulars
25534,354,11,1635.8899999999999,2,3,3,8,Regulars
25535,278,7,590.03,2,1,1,4,Hibernating
25536,13,6,486.03999999999996,5,1,1,7,Regulars
25537,58,9,799.9300000000001,5,2,1,8,Regulars
25538,882,9,2975.1200000000003,1,2,5,8,Regulars
25539,154,13,2071.22,3,4,4,11,Big Spenders
25540,341,8,1330.8500000000001,2,2,3,7,Regulars
25541,71,11,1412.45,4,3,3,10,Loyal
25542,356,12,1638.1100000000001,2,4,3,9,At Risk
25543,237,10,2091.4500000000003,3,3,4,10,Big Spenders
25544,3,6,523.88,5,1,1,7,Regulars
25545,55,8,737.22,5,2,1,8,Regulars
25546,255,11,1373.83,2,3,3,8,Regulars
25547,90,12,1118.71,4,4,2,10,Loyal
25548,55,13,2567.73,5,4,4,13,Champions
25549,531,13,3200.41,1,4,5,10,At Risk
25550,130,10,2743.11,4,3,5,12,Loyal
25551,15,7,287.48,5,1,1,7,Regulars
25552,313,7,3204.24,2,1,5,8,Regulars
25553,310,10,3082.93,2,3,5,10,Regulars
25554,49,8,980.58,5,2,2,9,Regulars
25555,153,6,1080.53,3,1,2,6,Regulars
25556,622,8,570.9,1,2,1,4,Hibernating
25557,528,13,2395.4,1,4,4,9,At Risk
25558,22,11,2269.6,5,3,4,12,Loyal
25559,54,13,971.1800000000001,5,4,2,11,Loyal
25560,152,16,1699.19,3,5,3,11,Regulars
25561,163,11,4085.3,3,3,5,11,Big Spenders
25562,201,9,1983.25,3,2,4,9,Big Spenders
25563,322,9,894.16,2,2,2,6,Hibernating
25564,50,7,944.96,5,1,2,8,Regulars
25565,318,9,639.14,2,2,1,5,Hibernating
25566,260,8,2518.0099999999998,2,2,4,8,Regulars
25567,637,12,4320.49,1,4,5,10,At Risk
25568,82,9,3587.2200000000003,4,2,5,11,Big Spenders
25569,210,12,4570.22,3,4,5,12,Big Spenders
25570,186,12,2237.15,3,4,4,11,Big Spenders
25571,281,4,546.4,2,1,1,4,Hibernating
25572,120,17,1679.25,4,5,3,12,Loyal
25573,93,10,1096.19,4,3,2,9,Loyal
25574,590,7,883.05,1,1,2,4,Hibernating
25575,128,14,1472.58,4,5,3,12,Loyal
25576,5,14,2151.99,5,5,4,14,Champions
25577,175,14,4193.66,3,5,5,13,Big Spenders
25578,59,11,2538.86,5,3,4,12,Loyal
25579,127,11,1586.8200000000002,4,3,3,10,Loyal
25580,180,12,2175.17,3,4,4,11,Big Spenders
25581,372,7,483.47,2,1,1,4,Hibernating
25582,104,11,1037.01,4,3,2,9,Loyal
25583,373,5,678.1,2,1,1,4,Hibernating
25584,321,11,1829.41,2,3,4,9,Regulars
25585,244,15,6377.59,3,5,5,13,Big Spenders
25586,220,6,631.41,3,1,1,5,Regulars
25587,591,4,1022.9100000000001,1,1,2,4,Hibernating
25588,156,10,899.25,3,3,2,8,Regulars
25589,369,11,1061.5900000000001,2,3,2,7,Regulars
25590,113,17,2446.44,4,5,4,13,Champions
25591,307,11,1008.63,2,3,2,7,Regulars
25592,28,19,5392.85,5,5,5,15,Champions
25593,42,12,4911.16,5,4,5,14,Champions
25594,153,11,1011.24,3,3,2,8,Regulars
25595,788,9,839.53,1,2,1,4,Hibernating
25596,166,8,758.3499999999999,3,2,1,6,Regulars
25597,84,14,3478.23,4,5,5,14,Champions
25598,107,6,3899.0799999999995,4,1,5,10,Big Spenders
25599,61,9,694.79,5,2,1,8,Regulars
25600,99,14,1158.79,4,5,2,11,Loyal
25601,7,19,1754.9,5,5,4,14,Champions
25602,111,8,1880.81,4,2,4,10,Big Spenders
25603,56,17,3331.04,5,5,5,15,Champions
25604,54,10,958.02,5,3,2,10,Loyal
25605,20,11,2235.49,5,3,4,12,Loyal
25606,211,9,613.1,3,2,1,6,Regulars
25607,139,5,853.7099999999999,4,1,2,7,Regulars
25608,175,7,546.8199999999999,3,1,1,5,Regulars
25609,231,10,1293.25,3,3,3,9,Regulars
25610,156,12,4523.1,3,4,5,12,Big Spenders
25611,639,7,1738.3899999999999,1,1,4,6,Regulars
25612,187,8,1175.88,3,2,2,7,Regulars
25613,141,11,1677.09,4,3,3,10,Loyal
25614,112,9,2249.32,4,2,4,10,Big Spenders
25615,396,16,2219.37,2,5,4,11,At Risk
25616,28,14,2370.39,5,5,4,14,Champions
25617,347,13,2032.0600000000002,2,4,4,10,At Risk
25618,171,13,1269.31,3,4,3,10,Regulars
25619,42,9,2084.5,5,2,4,11,Big Spenders
25620,253,7,419.87,2,1,1,4,Hibernating
25621,305,7,659.09,2,1,1,4,Hibernating
25622,651,9,680.98,1,2,1,4,Hibernating
25623,1147,6,801.5200000000001,1,1,1,3,Hibernating
25624,124,7,827.46,4,1,1,6,Regulars
25625,384,4,732.5799999999999,2,1,1,4,Hibernating
25626,190,8,1740.09,3,2,4,9,Big Spenders
25627,346,6,697.6,2,1,1,4,Hibernating
25628,345,11,1457.44,2,3,3,8,Regulars
25629,319,8,802.96,2,2,1,5,Hibernating
25630,196,9,1166.09,3,2,2,7,Regulars
25631,15,9,1000.51,5,2,2,9,Regulars
25632,489,9,2843.8999999999996,1,2,5,8,Regulars
25633,82,9,3192.4800000000005,4,2,5,11,Big Spenders
25634,111,10,3648.6,4,3,5,12,Loyal
25635,218,10,1858.8600000000001,3,3,4,10,Big Spenders
25636,222,12,967.96,3,4,2,9,Regulars
25637,157,9,1337.35,3,2,3,8,Regulars
25638,285,13,4076.48,2,4,5,11,At Risk
25639,945,13,2510.4300000000003,1,4,4,9,At Risk
25640,158,4,301.0,3,1,1,5,Regulars
25641,20,11,2432.82,5,3,4,12,Loyal
25642,21,6,1546.52,5,1,3,9,Regulars
25643,82,9,1330.34,4,2,3,9,Regulars
25644,103,13,1005.1,4,4,2,10,Loyal
25645,50,8,3613.78,5,2,5,12,Big Spenders
25646,71,10,3098.9399999999996,4,3,5,12,Loyal
25647,124,12,1413.1100000000001,4,4,3,11,Loyal
25648,383,11,3703.0299999999997,2,3,5,10,Regulars
25649,122,20,2990.94,4,5,5,14,Champions
25650,105,10,1722.1599999999999,4,3,3,10,Loyal
25651,48,10,1131.08,5,3,2,10,Loyal
25652,84,7,1546.92,4,1,3,8,Regulars
25653,74,9,1840.7,4,2,4,10,Big Spenders
25654,372,4,197.79000000000002,2,1,1,4,Hibernating
25655,83,8,3188.1000000000004,4,2,5,11,Big Spenders
25656,220,16,1723.49,3,5,3,11,Regulars
25657,147,12,1135.36,4,4,2,10,Loyal
25658,547,7,203.27999999999997,1,1,1,3,Hibernating
25659,46,10,1824.47,5,3,4,12,Loyal
25660,1279,7,1382.82,1,1,3,5,Regulars
25661,1664,6,800.79,1,1,1,3,Hibernating
25662,485,15,3753.43,1,5,5,11,At Risk
25663,180,8,2604.37,3,2,5,10,Big Spenders
25664,21,11,1127.3700000000001,5,3,2,10,Loyal
25665,711,12,3343.34,1,4,5,10,At Risk
25666,140,7,539.0,4,1,1,6,Regulars
25667,861,11,1641.8400000000001,1,3,3,7,Regulars
25668,6,9,1049.73,5,2,2,9,Regulars
25669,257,12,1206.96,2,4,2,8,At Risk
25670,175,8,709.48,3,2,1,6,Regulars
25671,37,15,2175.37,5,5,4,14,Champions
25672,644,9,2142.85,1,2,4,7,Regulars
25673,385,6,901.1300000000001,2,1,2,5,Hibernating
25674,268,9,626.49,2,2,1,5,Hibernating
25675,29,13,2931.2599999999998,5,4,5,14,Champions
25676,154,8,875.7,3,2,2,7,Regulars
25677,213,10,2705.5,3,3,5,11,Big Spenders
25678,546,13,3351.3599999999997,1,4,5,10,At Risk
25679,25,13,1417.51,5,4,3,12,Loyal
25680,100,10,955.02,4,3,2,9,Loyal
25681,375,8,2824.14,2,2,5,9,Regulars
25682,146,12,1477.47,4,4,3,11,Loyal
25683,22,17,2050.73,5,5,4,14,Champions
25684,60,10,3027.22,5,3,5,13,Loyal
25685,522,6,1288.53,1,1,3,5,Regulars
25686,287,11,1745.8100000000002,2,3,4,9,Regulars
25687,57,14,915.53,5,5,2,12,Loyal
25688,186,8,826.61,3,2,1,6,Regulars
25689,444,7,418.2,2,1,1,4,Hibernating
25690,79,3,531.3100000000001,4,1,1,6,Regulars
25691,604,10,2724.61,1,3,5,9,Regulars
25692,373,5,885.4200000000001,2,1,2,5,Hibernating
25693,85,13,3925.5499999999997,4,4,5,13,Champions
25694,1230,7,403.54,1,1,1,3,Hibernating
25695,290,6,540.3199999999999,2,1,1,4,Hibernating
25696,527,8,577.67,1,2,1,4,Hibernating
25697,145,14,972.84,4,5,2,11,Loyal
25698,225,17,1906.67,3,5,4,12,Big Spenders
25699,81,11,626.17,4,3,1,8,Loyal
25700,287,9,912.4599999999999,2,2,2,6,Hibernating
25701,104,12,3179.27,4,4,5,13,Champions
25702,162,6,763.72,3,1,1,5,Regulars
25703,123,14,5035.26,4,5,5,14,Champions
25704,183,12,2917.99,3,4,5,12,Big Spenders
25705,143,12,3538.2,4,4,5,13,Champions
25706,779,7,506.87,1,1,1,3,Hibernating
25707,93,8,6107.98,4,2,5,11,Big Spenders
25708,5,7,432.29,5,1,1,7,Regulars
25709,503,10,4624.07,1,3,5,9,Regulars
25710,390,13,4017.0299999999997,2,4,5,11,At Risk
25711,219,10,623.35,3,3,1,7,Regulars
25712,175,14,2693.11,3,5,5,13,Big Spenders
25713,83,21,4416.12,4,5,5,14,Champions
25714,490,6,503.38,1,1,1,3,Hibernating
25715,42,15,2301.38,5,5,4,14,Champions
25716,53,6,816.44,5,1,1,7,Regulars
25717,327,8,937.8,2,2,2,6,Hibernating
25718,34,11,1408.3400000000001,5,3,3,11,Loyal
25719,589,13,2091.23,1,4,4,9,At Risk
25720,45,11,4961.98,5,3,5,13,Loyal
25721,103,10,4437.9,4,3,5,12,Loyal
25722,95,8,1137.15,4,2,2,8,Regulars
25723,560,8,828.9,1,2,1,4,Hibernating
25724,133,13,5789.86,4,4,5,13,Champions
25725,825,6,593.5699999999999,1,1,1,3,Hibernating
25726,21,9,1221.24,5,2,2,9,Regulars
25727,39,14,4222.6900000000005,5,5,5,15,Champions
25728,706,7,643.5,1,1,1,3,Hibernating
25729,662,6,1054.03,1,1,2,4,Hibernating
25730,8,9,946.4,5,2,2,9,Regulars
25731,647,14,6023.68,1,5,5,11,At Risk
25732,780,10,2789.9700000000003,1,3,5,9,Regulars
25733,823,7,2047.92,1,1,4,6,Regulars
25734,189,13,3463.93,3,4,5,12,Big Spenders
25735,271,13,1254.71,2,4,3,9,At Risk
25736,207,10,2436.72,3,3,4,10,Big Spenders
25737,35,12,1244.01,5,4,3,12,Loyal
25738,853,4,930.9300000000001,1,1,2,4,Hibernating
25739,309,17,1617.2,2,5,3,10,At Risk
25740,185,7,1195.03,3,1,2,6,Regulars
25741,31,18,2296.9500000000003,5,5,4,14,Champions
25742,231,8,1409.69,3,2,3,8,Regulars
25743,294,10,1298.97,2,3,3,8,Regulars
25744,5,10,1115.75,5,3,2,10,Loyal
25745,24,11,906.8199999999999,5,3,2,10,Loyal
25746,439,8,686.78,2,2,1,5,Hibernating
25747,383,10,2219.4900000000002,2,3,4,9,Regulars
25748,6,4,1044.92,5,1,2,8,Regulars
25749,550,4,250.69,1,1,1,3,Hibernating
25750,143,12,4618.7699999999995,4,4,5,13,Champions
25751,148,12,1074.75,3,4,2,9,Regulars
25752,117,13,960.77,4,4,2,10,Loyal
25753,135,10,916.86,4,3,2,9,Loyal
25754,2,12,2940.44,5,4,5,14,Champions
25755,468,11,1190.17,1,3,2,6,Regulars
25756,637,9,823.63,1,2,1,4,Hibernating
25757,172,15,1612.26,3,5,3,11,Regulars
25758,432,5,464.7,2,1,1,4,Hibernating
25759,128,14,1960.05,4,5,4,13,Champions
25760,308,15,1215.31,2,5,2,9,At Risk
25761,436,11,761.16,2,3,1,6,Regulars
25762,610,5,551.2299999999999,1,1,1,3,Hibernating
25763,419,12,1457.8000000000002,2,4,3,9,At Risk
25764,107,10,3065.5299999999997,4,3,5,12,Loyal
25765,394,5,890.22,2,1,2,5,Hibernating
25766,73,10,1470.22,4,3,3,10,Loyal
25767,31,12,1805.4599999999998,5,4,4,13,Champions
25768,396,13,2431.6,2,4,4,10,At Risk
25769,82,11,1479.22,4,3,3,10,Loyal
25770,202,4,634.09,3,1,1,5,Regulars
25771,273,12,1877.17,2,4,4,10,At Risk
25772,1078,4,371.42999999999995,1,1,1,3,Hibernating
25773,170,11,1986.02,3,3,4,10,Big Spenders
25774,159,11,1055.82,3,3,2,8,Regulars
25775,662,6,2712.5099999999998,1,1,5,7,Regulars
25776,297,12,1901.0800000000002,2,4,4,10,At Risk
25777,329,11,2621.5,2,3,5,10,Regulars
25778,237,12,2002.19,3,4,4,11,Big Spenders
25779,132,8,933.94,4,2,2,8,Regulars
25780,85,7,1924.88,4,1,4,9,Big Spenders
25781,76,15,1646.01,4,5,3,12,Loyal
25782,670,5,598.38,1,1,1,3,Hibernating
25783,55,1,66.46,5,1,1,7,Regulars
25784,55,10,1743.1,5,3,4,12,Loyal
25785,369,11,759.9200000000001,2,3,1,6,Regulars
25786,110,15,1338.91,4,5,3,12,Loyal
25787,328,12,1023.75,2,4,2,8,At Risk
25788,111,11,1521.96,4,3,3,10,Loyal
25789,152,7,717.59,3,1,1,5,Regulars
25790,440,13,1889.1699999999998,2,4,4,10,At Risk
25791,6,11,2217.73,5,3,4,12,Loyal
25792,129,11,1636.6000000000001,4,3,3,10,Loyal
25793,183,15,1815.11,3,5,4,12,Big Spenders
25794,156,10,2593.36,3,3,5,11,Big Spenders
25795,651,6,575.78,1,1,1,3,Hibernating
25796,45,15,4920.06,5,5,5,15,Champions
25797,64,12,1274.58,5,4,3,12,Loyal
25798,321,9,1409.78,2,2,3,7,Regulars
25799,169,14,2845.12,3,5,5,13,Big Spenders
25800,67,13,1708.25,4,4,3,11,Loyal
25801,203,9,875.86,3,2,2,7,Regulars
25802,307,16,1639.28,2,5,3,10,At Risk
25803,193,7,473.24,3,1,1,5,Regulars
25804,332,16,1346.87,2,5,3,10,At Risk
25805,111,11,1105.84,4,3,2,9,Loyal
25806,297,14,2044.1300000000003,2,5,4,11,At Risk
25807,28,11,4175.87,5,3,5,13,Loyal
25808,648,7,1421.8899999999999,1,1,3,5,Regulars
25809,382,7,1312.87,2,1,3,6,Regulars
25810,46,10,1103.07,5,3,2,10,Loyal
25811,105,8,2272.6600000000003,4,2,4,10,Big Spenders
25812,186,15,1630.87,3,5,3,11,Regulars
25813,448,14,1610.62,2,5,3,10,At Risk
25814,7,12,1369.19,5,4,3,12,Loyal
25815,227,11,2162.34,3,3,4,10,Big Spenders
25816,76,9,772.6899999999999,4,2,1,7,Regulars
25817,308,11,2301.39,2,3,4,9,Regulars
25818,126,6,1120.85,4,1,2,7,Regulars
25819,53,12,1633.21,5,4,3,12,Loyal
25820,284,12,3945.6,2,4,5,11,At Risk
25821,39,7,1925.59,5,1,4,10,Big Spenders
25822,39,13,1774.7800000000002,5,4,4,13,Champions
25823,764,7,268.52,1,1,1,3,Hibernating
25824,110,7,626.42,4,1,1,6,Regulars
25825,131,9,1191.3799999999999,4,2,2,8,Regulars
25826,75,8,682.3100000000001,4,2,1,7,Regulars
25827,85,13,2462.22,4,4,4,12,Champions
25828,202,5,902.95,3,1,2,6,Regulars
25829,58,11,1282.15,5,3,3,11,Loyal
25830,347,10,929.91,2,3,2,7,Regulars
25831,93,11,2640.21,4,3,5,12,Loyal
25832,1261,8,706.11,1,2,1,4,Hibernating
25833,57,10,791.74,5,3,1,9,Loyal
25834,79,13,3680.88,4,4,5,13,Champions
25835,167,10,893.97,3,3,2,8,Regulars
25836,177,7,1133.8899999999999,3,1,2,6,Regulars
25837,956,9,541.87,1,2,1,4,Hibernating
25838,11,4,2564.88,5,1,4,10,Big Spenders
25839,195,11,1739.02,3,3,4,10,Big Spenders
25840,260,8,1070.3600000000001,2,2,2,6,Hibernating
25841,453,13,2648.11,2,4,5,11,At Risk
25842,47,11,1505.15,5,3,3,11,Loyal
25843,232,14,1195.26,3,5,2,10,Regulars
25844,463,9,923.97,1,2,2,5,Hibernating
25845,87,11,829.77,4,3,1,8,Loyal
25846,188,13,1372.85,3,4,3,10,Regulars
25847,828,7,1663.8400000000001,1,1,3,5,Regulars
25848,282,9,1098.18,2,2,2,6,Hibernating
25849,20,5,260.48,5,1,1,7,Regulars
25850,131,9,913.91,4,2,2,8,Regulars
25851,465,13,1710.02,1,4,3,8,At Risk
25852,461,12,2994.37,1,4,5,10,At Risk
25853,5,9,1436.07,5,2,3,10,Regulars
25854,115,13,1854.56,4,4,4,12,Champions
25855,261,9,1177.74,2,2,2,6,Hibernating
25856,179,11,1189.96,3,3,2,8,Regulars
25857,728,11,950.64,1,3,2,6,Regulars
25858,18,10,1246.57,5,3,3,11,Loyal
25859,161,13,1709.9700000000003,3,4,3,10,Regulars
25860,110,17,2782.32,4,5,5,14,Champions
25861,179,7,873.75,3,1,2,6,Regulars
25862,548,11,1377.6200000000001,1,3,3,7,Regulars
25863,206,7,623.4200000000001,3,1,1,5,Regulars
25864,312,6,2111.38,2,1,4,7,Regulars
25865,9,12,1737.44,5,4,4,13,Champions
25866,552,8,2167.66,1,2,4,7,Regulars
25867,182,8,637.03,3,2,1,6,Regulars
25868,89,11,1101.28,4,3,2,9,Loyal
25869,355,9,1065.53,2,2,2,6,Hibernating
25870,218,14,1450.16,3,5,3,11,Regulars
25871,69,4,1525.19,4,1,3,8,Regulars
25872,245,11,1321.59,3,3,3,9,Regulars
25873,524,8,852.97,1,2,2,5,Hibernating
25874,167,9,566.2,3,2,1,6,Regulars
25875,277,6,356.09,2,1,1,4,Hibernating
25876,279,5,1432.64,2,1,3,6,Regulars
25877,127,15,1038.36,4,5,2,11,Loyal
25878,122,8,692.7299999999999,4,2,1,7,Regulars
25879,79,13,2886.58,4,4,5,13,Champions
25880,182,10,1683.0,3,3,3,9,Regulars
25881,348,10,1012.91,2,3,2,7,Regulars
25882,1005,10,7476.84,1,3,5,9,Regulars
25883,141,9,2434.66,4,2,4,10,Big Spenders
25884,140,11,780.4300000000001,4,3,1,8,Loyal
25885,164,12,987.48,3,4,2,9,Regulars
25886,132,12,1258.26,4,4,3,11,Loyal
25887,422,11,2466.32,2,3,4,9,Regulars
25888,131,9,1414.37,4,2,3,9,Regulars
25889,900,8,4260.01,1,2,5,8,Regulars
25890,318,17,4629.5599999999995,2,5,5,12,At Risk
25891,284,9,656.94,2,2,1,5,Hibernating
25892,70,16,1201.44,4,5,2,11,Loyal
25893,483,9,940.7,1,2,2,5,Hibernating
25894,675,2,169.94,1,1,1,3,Hibernating
25895,217,11,1586.01,3,3,3,9,Regulars
25896,682,11,2830.05,1,3,5,9,Regulars
25897,605,7,563.24,1,1,1,3,Hibernating
25898,1225,8,488.2,1,2,1,4,Hibernating
25899,59,14,3664.36,5,5,5,15,Champions
25900,268,15,3384.3199999999997,2,5,5,12,At Risk
25901,1206,3,595.4300000000001,1,1,1,3,Hibernating
25902,3,13,2529.2200000000003,5,4,4,13,Champions
25903,1130,7,550.12,1,1,1,3,Hibernating
25904,243,10,964.53,3,3,2,8,Regulars
25905,26,6,576.46,5,1,1,7,Regulars
25906,87,9,1101.93,4,2,2,8,Regulars
25907,433,7,2555.8500000000004,2,1,4,7,Regulars
25908,1,10,1265.6900000000003,5,3,3,11,Loyal
25909,140,3,354.96,4,1,1,6,Regulars
25910,101,11,869.22,4,3,2,9,Loyal
25911,110,10,842.21,4,3,1,8,Loyal
25912,490,11,2722.4700000000003,1,3,5,9,Regulars
25913,453,5,270.44,2,1,1,4,Hibernating
25914,245,10,1891.9,3,3,4,10,Big Spenders
25915,130,14,2343.2200000000003,4,5,4,13,Champions
25916,104,14,3035.48,4,5,5,14,Champions
25917,880,7,370.93,1,1,1,3,Hibernating
25918,96,11,1392.8700000000001,4,3,3,10,Loyal
25919,521,12,1575.96,1,4,3,8,At Risk
25920,261,11,1229.51,2,3,2,7,Regulars
25921,211,9,1216.83,3,2,2,7,Regulars
25922,647,7,331.09,1,1,1,3,Hibernating
25923,529,8,2032.0700000000002,1,2,4,7,Regulars
25924,173,9,2537.49,3,2,4,9,Big Spenders
25925,187,17,3294.8,3,5,5,13,Big Spenders
25926,643,6,648.56,1,1,1,3,Hibernating
25927,209,11,3111.34,3,3,5,11,Big Spenders
25928,221,12,2863.17,3,4,5,12,Big Spenders
25929,390,13,1899.87,2,4,4,10,At Risk
25930,143,15,2567.6400000000003,4,5,4,13,Champions
25931,864,11,1527.33,1,3,3,7,Regulars
25932,181,8,2415.86,3,2,4,9,Big Spenders
25933,85,3,255.14999999999998,4,1,1,6,Regulars
25934,158,15,3538.0699999999997,3,5,5,13,Big Spenders
25935,20,13,3546.02,5,4,5,14,Champions
25936,109,11,2289.37,4,3,4,11,Loyal
25937,391,10,1051.15,2,3,2,7,Regulars
25938,362,13,2541.43,2,4,4,10,At Risk
25939,18,9,1855.1599999999999,5,2,4,11,Big Spenders
25940,80,11,990.46,4,3,2,9,Loyal
25941,156,5,608.47,3,1,1,5,Regulars
25942,507,13,1673.33,1,4,3,8,At Risk
25943,623,10,2042.1,1,3,4,8,Regulars
25944,52,8,3489.59,5,2,5,12,Big Spenders
25945,185,13,931.6400000000001,3,4,2,9,Regulars
25946,564,8,1654.0900000000001,1,2,3,6,Regulars
25947,214,17,3026.23,3,5,5,13,Big Spenders
25948,326,8,671.65,2,2,1,5,Hibernating
25949,81,11,866.3,4,3,2,9,Loyal
25950,18,12,1270.53,5,4,3,12,Loyal
25951,126,12,1591.27,4,4,3,11,Loyal
25952,771,8,1569.09,1,2,3,6,Regulars
25953,1020,6,1395.77,1,1,3,5,Regulars
25954,566,12,2727.4,1,4,5,10,At Risk
25955,457,10,1334.65,2,3,3,8,Regulars
25956,629,5,453.09,1,1,1,3,Hibernating
25957,35,16,3702.71,5,5,5,15,Champions
25958,10,9,1261.53,5,2,3,10,Regulars
25959,229,8,805.97,3,2,1,6,Regulars
25960,11,6,865.76,5,1,2,8,Regulars
25961,14,17,1586.76,5,5,3,13,Loyal
25962,161,12,3607.73,3,4,5,12,Big Spenders
25963,66,10,1568.39,4,3,3,10,Loyal
25964,901,7,2460.38,1,1,4,6,Regulars
25965,95,11,4149.87,4,3,5,12,Loyal
25966,126,6,655.64,4,1,1,6,Regulars
25967,241,7,836.36,3,1,1,5,Regulars
25968,44,11,3948.81,5,3,5,13,Loyal
25969,203,6,2958.9900000000002,3,1,5,9,Big Spenders
25970,77,10,2611.9399999999996,4,3,5,12,Loyal
25971,50,10,1425.1100000000001,5,3,3,11,Loyal
25972,99,12,1749.5800000000002,4,4,4,12,Champions
25973,135,8,1095.83,4,2,2,8,Regulars
25974,265,11,1374.27,2,3,3,8,Regulars
25975,66,8,1909.9,4,2,4,10,Big Spenders
25976,732,10,1508.45,1,3,3,7,Regulars
25977,110,12,865.52,4,4,2,10,Loyal
25978,68,7,550.62,4,1,1,6,Regulars
25979,483,8,432.3,1,2,1,4,Hibernating
25980,20,8,1398.93,5,2,3,10,Regulars
25981,54,13,2255.2200000000003,5,4,4,13,Champions
25982,108,12,2621.85,4,4,5,13,Champions
25983,71,10,704.7,4,3,1,8,Loyal
25984,110,14,3886.67,4,5,5,14,Champions
25985,1,9,1553.8999999999999,5,2,3,10,Regulars
25986,31,14,1205.08,5,5,2,12,Loyal
25987,291,10,1973.75,2,3,4,9,Regulars
25988,146,12,767.86,4,4,1,9,Loyal
25989,134,13,1525.49,4,4,3,11,Loyal
25990,193,14,1530.96,3,5,3,11,Regulars
25991,267,9,1331.91,2,2,3,7,Regulars
25992,3,6,1719.13,5,1,3,9,Regulars
25993,2,15,2652.36,5,5,5,15,Champions
25994,171,7,2065.91,3,1,4,8,Big Spenders
25995,78,9,1039.53,4,2,2,8,Regulars
25996,801,9,1003.0,1,2,2,5,Hibernating
25997,133,5,712.13,4,1,1,6,Regulars
25998,81,7,671.4000000000001,4,1,1,6,Regulars
25999,18,13,5245.83,5,4,5,14,Champions
26000,256,9,2476.01,2,2,4,8,Regulars
26001,49,4,283.09000000000003,5,1,1,7,Regulars
26002,944,9,701.98,1,2,1,4,Hibernating
26003,261,13,1280.68,2,4,3,9,At Risk
26004,288,8,1241.52,2,2,3,7,Regulars
26005,180,11,1184.0,3,3,2,8,Regulars
26006,177,11,1923.17,3,3,4,10,Big Spenders
26007,331,15,1270.86,2,5,3,10,At Risk
26008,346,12,2262.81,2,4,4,10,At Risk
26009,297,11,774.12,2,3,1,6,Regulars
26010,310,11,2108.9599999999996,2,3,4,9,Regulars
26011,393,12,1685.8600000000001,2,4,3,9,At Risk
26012,197,9,1514.84,3,2,3,8,Regulars
26013,207,13,1322.47,3,4,3,10,Regulars
26014,132,7,3194.9599999999996,4,1,5,10,Big Spenders
26015,863,7,314.66,1,1,1,3,Hibernating
26016,192,9,1448.6000000000001,3,2,3,8,Regulars
26017,877,14,1869.17,1,5,4,10,At Risk
26018,186,9,1200.53,3,2,2,7,Regulars
26019,401,8,1398.0,2,2,3,7,Regulars
26020,46,13,2160.95,5,4,4,13,Champions
26021,112,6,760.55,4,1,1,6,Regulars
26022,360,8,3392.9,2,2,5,9,Regulars
26023,71,11,2003.5700000000002,4,3,4,11,Loyal
26024,558,9,2954.02,1,2,5,8,Regulars
26025,314,11,1614.2,2,3,3,8,Regulars
26026,9,10,1824.83,5,3,4,12,Loyal
26027,42,13,1031.72,5,4,2,11,Loyal
26028,69,7,1756.29,4,1,4,9,Big Spenders
26029,147,15,1685.01,4,5,3,12,Loyal
26030,175,10,3154.1400000000003,3,3,5,11,Big Spenders
26031,184,7,3981.23,3,1,5,9,Big Spenders
26032,200,11,1706.6499999999999,3,3,3,9,Regulars
26033,74,10,1079.7,4,3,2,9,Loyal
26034,9,5,607.09,5,1,1,7,Regulars
26035,350,10,1643.17,2,3,3,8,Regulars
26036,445,11,749.1800000000001,2,3,1,6,Regulars
26037,653,11,979.92,1,3,2,6,Regulars
26038,201,7,2357.6,3,1,4,8,Big Spenders
26039,338,10,603.86,2,3,1,6,Regulars
26040,85,14,1937.49,4,5,4,13,Champions
26041,475,9,1038.46,1,2,2,5,Hibernating
26042,57,16,1437.65,5,5,3,13,Loyal
26043,8,10,867.58,5,3,2,10,Loyal
26044,1020,3,242.44,1,1,1,3,Hibernating
26045,154,6,1256.38,3,1,3,7,Regulars
26046,37,11,3133.74,5,3,5,13,Loyal
26047,530,7,614.4300000000001,1,1,1,3,Hibernating
26048,148,11,3012.14,3,3,5,11,Big Spenders
26049,378,10,2847.98,2,3,5,10,Regulars
26050,12,12,3256.52,5,4,5,14,Champions
26051,146,13,1772.9,4,4,4,12,Champions
26052,65,11,904.0,5,3,2,10,Loyal
26053,984,6,621.45,1,1,1,3,Hibernating
26054,228,9,2704.06,3,2,5,10,Big Spenders
26055,34,9,1730.6599999999999,5,2,4,11,Big Spenders
26056,135,13,3851.49,4,4,5,13,Champions
26057,556,10,2005.18,1,3,4,8,Regulars
26058,102,8,905.27,4,2,2,8,Regulars
26059,27,17,4591.29,5,5,5,15,Champions
26060,2,8,1636.43,5,2,3,10,Regulars
26061,122,13,2540.28,4,4,4,12,Champions
26062,5,10,1338.71,5,3,3,11,Loyal
26063,119,10,1346.27,4,3,3,10,Loyal
26064,17,14,1542.69,5,5,3,13,Loyal
26065,169,9,641.86,3,2,1,6,Regulars
26066,124,12,1193.92,4,4,2,10,Loyal
26067,286,15,5780.06,2,5,5,12,At Risk
26068,287,13,4541.01,2,4,5,11,At Risk
26069,493,9,1359.3200000000002,1,2,3,6,Regulars
26070,682,10,2549.08,1,3,4,8,Regulars
26071,123,9,1197.01,4,2,2,8,Regulars
26072,7,10,1105.32,5,3,2,10,Loyal
26073,75,8,2455.1600000000003,4,2,4,10,Big Spenders
26074,475,10,1115.96,1,3,2,6,Regulars
26075,871,8,1001.98,1,2,2,5,Hibernating
26076,93,9,6088.86,4,2,5,11,Big Spenders
26077,601,14,2327.86,1,5,4,10,At Risk
26078,21,14,3638.06,5,5,5,15,Champions
26079,165,10,1439.66,3,3,3,9,Regulars
26080,487,13,947.6199999999999,1,4,2,7,At Risk
26081,126,11,4690.38,4,3,5,12,Loyal
26082,224,10,2322.03,3,3,4,10,Big Spenders
26083,549,8,1849.74,1,2,4,7,Regulars
26084,228,12,2123.44,3,4,4,11,Big Spenders
26085,101,18,3558.56,4,5,5,14,Champions
26086,329,14,3721.55,2,5,5,12,At Risk
26087,93,15,3761.5,4,5,5,14,Champions
26088,230,13,1155.12,3,4,2,9,Regulars
26089,351,11,1568.94,2,3,3,8,Regulars
26090,246,10,1406.34,3,3,3,9,Regulars
26091,11,6,362.9,5,1,1,7,Regulars
26092,360,13,1912.6,2,4,4,10,At Risk
26093,282,10,1609.27,2,3,3,8,Regulars
26094,525,9,1380.3999999999999,1,2,3,6,Regulars
26095,149,12,985.24,3,4,2,9,Regulars
26096,153,15,2532.01,3,5,4,12,Big Spenders
26097,184,8,1258.39,3,2,3,8,Regulars
26098,36,9,1257.64,5,2,3,10,Regulars
26099,26,12,2187.14,5,4,4,13,Champions
26100,206,12,1451.25,3,4,3,10,Regulars
26101,107,11,2479.8199999999997,4,3,4,11,Loyal
26102,1035,9,2487.48,1,2,4,7,Regulars
26103,318,13,1138.47,2,4,2,8,At Risk
26104,152,9,1361.46,3,2,3,8,Regulars
26105,343,13,1494.42,2,4,3,9,At Risk
26106,116,15,2121.5,4,5,4,13,Champions
26107,50,9,867.26,5,2,2,9,Regulars
26108,89,12,3997.85,4,4,5,13,Champions
26109,40,10,2689.23,5,3,5,13,Loyal
26110,26,10,1089.97,5,3,2,10,Loyal
26111,280,6,3908.3999999999996,2,1,5,8,Regulars
26112,1128,6,672.37,1,1,1,3,Hibernating
26113,305,17,2624.21,2,5,5,12,At Risk
26114,75,14,1595.17,4,5,3,12,Loyal
26115,174,11,989.57,3,3,2,8,Regulars
26116,318,5,2627.68,2,1,5,8,Regulars
26117,224,9,2572.44,3,2,4,9,Big Spenders
26118,560,9,860.41,1,2,2,5,Hibernating
26119,162,11,3504.23,3,3,5,11,Big Spenders
26120,140,10,2024.4399999999998,4,3,4,11,Loyal
26121,99,11,1078.76,4,3,2,9,Loyal
26122,51,16,3287.6800000000003,5,5,5,15,Champions
26123,16,12,1252.3,5,4,3,12,Loyal
26124,345,14,1107.55,2,5,2,9,At Risk
26125,405,14,4047.86,2,5,5,12,At Risk
26126,261,15,3367.9,2,5,5,12,At Risk
26127,318,12,1204.07,2,4,2,8,At Risk
26128,23,14,3238.9900000000002,5,5,5,15,Champions
26129,95,7,519.94,4,1,1,6,Regulars
26130,786,6,941.92,1,1,2,4,Hibernating
26131,195,10,1458.19,3,3,3,9,Regulars
26132,84,12,5343.57,4,4,5,13,Champions
26133,90,11,898.7,4,3,2,9,Loyal
26134,438,5,661.8100000000001,2,1,1,4,Hibernating
26135,97,15,2074.25,4,5,4,13,Champions
26136,4,5,1593.6,5,1,3,9,Regulars
26137,39,11,1372.4,5,3,3,11,Loyal
26138,149,4,568.18,3,1,1,5,Regulars
26139,244,14,1579.18,3,5,3,11,Regulars
26140,69,13,1538.33,4,4,3,11,Loyal
26141,302,11,2587.0699999999997,2,3,5,10,Regulars
26142,142,9,1713.5600000000002,4,2,3,9,Regulars
26143,200,10,1457.32,3,3,3,9,Regulars
26144,8,16,1588.22,5,5,3,13,Loyal
26145,194,11,981.21,3,3,2,8,Regulars
26146,87,8,1536.96,4,2,3,9,Regulars
26147,11,9,2033.29,5,2,4,11,Big Spenders
26148,50,11,1101.69,5,3,2,10,Loyal
26149,785,12,1533.1499999999999,1,4,3,8,At Risk
26150,111,8,887.73,4,2,2,8,Regulars
26151,363,9,1918.6299999999999,2,2,4,8,Regulars
26152,191,10,1073.69,3,3,2,8,Regulars
26153,420,12,1845.95,2,4,4,10,At Risk
26154,502,13,2165.79,1,4,4,9,At Risk
26155,51,6,1079.5900000000001,5,1,2,8,Regulars
26156,121,9,1241.8,4,2,3,9,Regulars
26157,517,5,458.08,1,1,1,3,Hibernating
26158,39,12,949.67,5,4,2,11,Loyal
26159,99,12,2699.84,4,4,5,13,Champions
26160,160,17,4466.509999999999,3,5,5,13,Big Spenders
26161,176,9,5187.99,3,2,5,10,Big Spenders
26162,365,10,1569.31,2,3,3,8,Regulars
26163,559,12,3550.48,1,4,5,10,At Risk
26164,887,12,3849.13,1,4,5,10,At Risk
26165,254,13,1634.84,2,4,3,9,At Risk
26166,161,11,1851.71,3,3,4,10,Big Spenders
26167,343,6,649.09,2,1,1,4,Hibernating
26168,109,7,3040.13,4,1,5,10,Big Spenders
26169,21,11,2851.21,5,3,5,13,Loyal
26170,494,11,2540.6,1,3,4,8,Regulars
26171,93,8,690.65,4,2,1,7,Regulars
26172,39,10,1148.72,5,3,2,10,Loyal
26173,209,8,1349.01,3,2,3,8,Regulars
26174,116,10,1643.31,4,3,3,10,Loyal
26175,40,11,3075.52,5,3,5,13,Loyal
26176,45,10,769.21,5,3,1,9,Loyal
26177,880,10,3549.0099999999998,1,3,5,9,Regulars
26178,1502,10,1185.54,1,3,2,6,Regulars
26179,269,9,744.51,2,2,1,5,Hibernating
26180,39,11,1764.77,5,3,4,12,Loyal
26181,139,10,2847.42,4,3,5,12,Loyal
26182,150,12,4502.68,3,4,5,12,Big Spenders
26183,132,5,832.38,4,1,1,6,Regulars
26184,54,10,2197.29,5,3,4,12,Loyal
26185,8,14,3830.54,5,5,5,15,Champions
26186,375,9,1266.92,2,2,3,7,Regulars
26187,287,14,2290.43,2,5,4,11,At Risk
26188,51,15,1905.52,5,5,4,14,Champions
26189,230,12,1113.95,3,4,2,9,Regulars
26190,97,8,696.69,4,2,1,7,Regulars
26191,25,7,1122.83,5,1,2,8,Regulars
26192,620,10,1257.69,1,3,3,7,Regulars
26193,94,13,1435.21,4,4,3,11,Loyal
26194,205,11,3872.4400000000005,3,3,5,11,Big Spenders
26195,193,12,3130.63,3,4,5,12,Big Spenders
26196,59,12,2299.96,5,4,4,13,Champions
26197,112,11,3684.66,4,3,5,12,Loyal
26198,206,9,1168.0900000000001,3,2,2,7,Regulars
26199,25,15,1281.15,5,5,3,13,Loyal
26200,90,10,1514.32,4,3,3,10,Loyal
26201,21,13,1599.93,5,4,3,12,Loyal
26202,201,11,1395.3400000000001,3,3,3,9,Regulars
26203,302,8,564.1899999999999,2,2,1,5,Hibernating
26204,119,12,4602.0,4,4,5,13,Champions
26205,82,11,3326.78,4,3,5,12,Loyal
26206,133,12,1019.28,4,4,2,10,Loyal
26207,47,12,2637.91,5,4,5,14,Champions
26208,221,11,2114.96,3,3,4,10,Big Spenders
26209,74,13,7042.05,4,4,5,13,Champions
26210,851,9,1035.3500000000001,1,2,2,5,Hibernating
26211,399,3,510.10999999999996,2,1,1,4,Hibernating
26212,32,14,4226.05,5,5,5,15,Champions
26213,36,10,923.48,5,3,2,10,Loyal
26214,60,10,967.89,5,3,2,10,Loyal
26215,192,9,742.4399999999999,3,2,1,6,Regulars
26216,195,8,1158.69,3,2,2,7,Regulars
26217,924,11,1023.13,1,3,2,6,Regulars
26218,207,13,1586.3999999999999,3,4,3,10,Regulars
26219,550,11,1355.31,1,3,3,7,Regulars
26220,468,5,1261.81,1,1,3,5,Regulars
26221,1069,6,1019.84,1,1,2,4,Hibernating
26222,971,4,1101.03,1,1,2,4,Hibernating
26223,110,10,1216.09,4,3,2,9,Loyal
26224,53,6,603.83,5,1,1,7,Regulars
26225,250,12,2117.24,2,4,4,10,At Risk
26226,176,4,2670.62,3,1,5,9,Big Spenders
26227,228,12,1309.53,3,4,3,10,Regulars
26228,581,9,959.83,1,2,2,5,Hibernating
26229,304,19,4502.2,2,5,5,12,At Risk
26230,229,12,3110.44,3,4,5,12,Big Spenders
26231,389,7,539.22,2,1,1,4,Hibernating
26232,469,10,1567.28,1,3,3,7,Regulars
26233,1,14,3678.44,5,5,5,15,Champions
26234,327,12,2575.6400000000003,2,4,5,11,At Risk
26235,34,9,4162.71,5,2,5,12,Big Spenders
26236,279,14,3042.57,2,5,5,12,At Risk
26237,720,7,1646.56,1,1,3,5,Regulars
26238,561,6,501.12,1,1,1,3,Hibernating
26239,761,12,2065.52,1,4,4,9,At Risk
26240,428,7,1472.46,2,1,3,6,Regulars
26241,160,11,1575.3899999999999,3,3,3,9,Regulars
26242,262,8,532.1,2,2,1,5,Hibernating
26243,44,9,660.9300000000001,5,2,1,8,Regulars
26244,423,10,1427.27,2,3,3,8,Regulars
26245,376,8,2331.41,2,2,4,8,Regulars
26246,21,10,1780.1,5,3,4,12,Loyal
26247,104,10,1532.17,4,3,3,10,Loyal
26248,182,12,822.55,3,4,1,8,Regulars
26249,265,11,1761.46,2,3,4,9,Regulars
26250,198,11,1995.1999999999998,3,3,4,10,Big Spenders
26251,164,10,857.8100000000001,3,3,2,8,Regulars
26252,10,13,1491.05,5,4,3,12,Loyal
26253,435,7,1158.99,2,1,2,5,Hibernating
26254,484,5,428.18,1,1,1,3,Hibernating
26255,254,9,473.43,2,2,1,5,Hibernating
26256,258,6,271.3,2,1,1,4,Hibernating
26257,120,8,778.1800000000001,4,2,1,7,Regulars
26258,854,7,490.69,1,1,1,3,Hibernating
26259,54,10,638.55,5,3,1,9,Loyal
26260,196,10,2875.64,3,3,5,11,Big Spenders
26261,29,15,2138.37,5,5,4,14,Champions
26262,203,10,2496.69,3,3,4,10,Big Spenders
26263,134,12,1360.06,4,4,3,11,Loyal
26264,592,11,5433.39,1,3,5,9,Regulars
26265,302,13,3624.83,2,4,5,11,At Risk
26266,71,10,1632.0500000000002,4,3,3,10,Loyal
26267,592,8,1841.48,1,2,4,7,Regulars
26268,105,10,1340.4,4,3,3,10,Loyal
26269,124,14,4399.51,4,5,5,14,Champions
26270,63,16,4280.599999999999,5,5,5,15,Champions
26271,6,13,2275.09,5,4,4,13,Champions
26272,281,4,587.26,2,1,1,4,Hibernating
26273,87,15,2948.43,4,5,5,14,Champions
26274,166,10,778.06,3,3,1,7,Regulars
26275,224,10,1520.8400000000001,3,3,3,9,Regulars
26276,459,8,1817.2,2,2,4,8,Regulars
26277,333,18,2064.7,2,5,4,11,At Risk
26278,264,13,1654.66,2,4,3,9,At Risk
26279,251,9,2586.24,2,2,5,9,Regulars
26280,1706,3,313.53,1,1,1,3,Hibernating
26281,43,12,5281.599999999999,5,4,5,14,Champions
26282,514,11,923.55,1,3,2,6,Regulars
26283,38,17,3135.31,5,5,5,15,Champions
26284,403,10,4515.28,2,3,5,10,Regulars
26285,292,8,520.59,2,2,1,5,Hibernating
26286,314,8,977.34,2,2,2,6,Hibernating
26287,126,9,827.0600000000001,4,2,1,7,Regulars
26288,3,14,2470.64,5,5,4,14,Champions
26289,208,12,1399.96,3,4,3,10,Regulars
26290,225,10,815.7,3,3,1,7,Regulars
26291,207,8,893.77,3,2,2,7,Regulars
26292,182,11,986.95,3,3,2,8,Regulars
26293,283,12,1356.99,2,4,3,9,At Risk
26294,47,10,1889.33,5,3,4,12,Loyal
26295,225,11,1820.85,3,3,4,10,Big Spenders
26296,508,12,3662.54,1,4,5,10,At Risk
26297,24,10,1069.9,5,3,2,10,Loyal
26298,786,10,2619.59,1,3,5,9,Regulars
26299,182,11,1106.69,3,3,2,8,Regulars
26300,436,6,1140.9299999999998,2,1,2,5,Hibernating
26301,467,12,1756.16,1,4,4,9,At Risk
26302,23,9,1840.5800000000002,5,2,4,11,Big Spenders
26303,569,7,357.91,1,1,1,3,Hibernating
26304,158,14,2734.1800000000003,3,5,5,13,Big Spenders
26305,384,10,1003.45,2,3,2,7,Regulars
26306,313,12,3117.8,2,4,5,11,At Risk
26307,511,7,1222.6,1,1,2,4,Hibernating
26308,139,11,928.97,4,3,2,9,Loyal
26309,11,9,896.5,5,2,2,9,Regulars
26310,718,15,1368.96,1,5,3,9,At Risk
26311,96,10,4712.89,4,3,5,12,Loyal
26312,820,11,1499.88,1,3,3,7,Regulars
26313,85,8,826.3199999999999,4,2,1,7,Regulars
26314,468,9,1209.97,1,2,2,5,Hibernating
26315,103,10,1697.69,4,3,3,10,Loyal
26316,742,10,2305.66,1,3,4,8,Regulars
26317,527,13,3655.96,1,4,5,10,At Risk
26318,104,6,792.52,4,1,1,6,Regulars
26319,295,9,983.5699999999999,2,2,2,6,Hibernating
26320,186,9,1463.12,3,2,3,8,Regulars
26321,174,7,4383.1,3,1,5,9,Big Spenders
26322,165,7,398.54,3,1,1,5,Regulars
26323,141,12,1561.11,4,4,3,11,Loyal
26324,142,12,3285.25,4,4,5,13,Champions
26325,90,13,1139.42,4,4,2,10,Loyal
26326,165,12,1003.52,3,4,2,9,Regulars
26327,214,14,2319.03,3,5,4,12,Big Spenders
26328,407,12,6206.92,2,4,5,11,At Risk
26329,350,14,1871.69,2,5,4,11,At Risk
26330,55,9,969.01,5,2,2,9,Regulars
26331,320,4,213.49,2,1,1,4,Hibernating
26332,19,6,836.86,5,1,1,7,Regulars
26333,1,10,1478.77,5,3,3,11,Loyal
26334,247,10,1540.24,3,3,3,9,Regulars
26335,430,5,945.33,2,1,2,5,Hibernating
26336,3,15,1180.04,5,5,2,12,Loyal
26337,224,4,266.06,3,1,1,5,Regulars
26338,333,12,1623.75,2,4,3,9,At Risk
26339,49,13,3059.88,5,4,5,14,Champions
26340,85,10,833.1899999999999,4,3,1,8,Loyal
26341,98,8,2424.69,4,2,4,10,Big Spenders
26342,92,14,2037.81,4,5,4,13,Champions
26343,243,12,2682.09,3,4,5,12,Big Spenders
26344,78,10,630.81,4,3,1,8,Loyal
26345,93,6,1027.67,4,1,2,7,Regulars
26346,110,8,1210.35,4,2,2,8,Regulars
26347,213,14,2568.6499999999996,3,5,4,12,Big Spenders
26348,6,13,2688.27,5,4,5,14,Champions
26349,211,6,2250.57,3,1,4,8,Big Spenders
26350,567,9,475.83000000000004,1,2,1,4,Hibernating
26351,123,14,1535.77,4,5,3,12,Loyal
26352,1268,7,1282.69,1,1,3,5,Regulars
26353,284,12,2705.92,2,4,5,11,At Risk
26354,223,6,1088.62,3,1,2,6,Regulars
26355,56,10,2037.53,5,3,4,12,Loyal
26356,95,8,992.51,4,2,2,8,Regulars
26357,174,13,853.16,3,4,2,9,Regulars
26358,138,13,1609.37,4,4,3,11,Loyal
26359,369,7,1046.84,2,1,2,5,Hibernating
26360,45,13,2160.53,5,4,4,13,Champions
26361,176,9,958.62,3,2,2,7,Regulars
26362,898,7,2366.52,1,1,4,6,Regulars
26363,124,12,3537.23,4,4,5,13,Champions
26364,87,6,588.0699999999999,4,1,1,6,Regulars
26365,263,11,1868.91,2,3,4,9,Regulars
26366,155,15,3192.23,3,5,5,13,Big Spenders
26367,593,10,952.73,1,3,2,6,Regulars
26368,16,6,744.12,5,1,1,7,Regulars
26369,248,9,1139.19,2,2,2,6,Hibernating
26370,355,12,3030.74,2,4,5,11,At Risk
26371,144,7,1142.3600000000001,4,1,2,7,Regulars
26372,344,11,1007.96,2,3,2,7,Regulars
26373,555,10,1878.0300000000002,1,3,4,8,Regulars
26374,103,8,544.77,4,2,1,7,Regulars
26375,60,13,1471.15,5,4,3,12,Loyal
26376,149,11,1535.69,3,3,3,9,Regulars
26377,7,7,647.69,5,1,1,7,Regulars
26378,465,14,2740.4399999999996,1,5,5,11,At Risk
26379,44,15,2469.88,5,5,4,14,Champions
26380,102,11,989.33,4,3,2,9,Loyal
26381,239,10,1941.25,3,3,4,10,Big Spenders
26382,307,7,357.53999999999996,2,1,1,4,Hibernating
26383,407,8,446.96000000000004,2,2,1,5,Hibernating
26384,589,7,2657.15,1,1,5,7,Regulars
26385,215,7,1064.6,3,1,2,6,Regulars
26386,69,19,3405.24,4,5,5,14,Champions
26387,96,6,1096.33,4,1,2,7,Regulars
26388,97,12,1584.4699999999998,4,4,3,11,Loyal
26389,23,14,2004.3899999999999,5,5,4,14,Champions
26390,27,14,1303.8,5,5,3,13,Loyal
26391,100,15,1650.23,4,5,3,12,Loyal
26392,0,15,3317.27,5,5,5,15,Champions
26393,140,12,882.8199999999999,4,4,2,10,Loyal
26394,159,11,5002.360000000001,3,3,5,11,Big Spenders
26395,182,15,4410.97,3,5,5,13,Big Spenders
26396,599,11,1634.98,1,3,3,7,Regulars
26397,483,10,707.49,1,3,1,5,Regulars
26398,299,7,968.82,2,1,2,5,Hibernating
26399,524,8,1316.77,1,2,3,6,Regulars
26400,109,7,873.9300000000001,4,1,2,7,Regulars
26401,489,9,1148.0,1,2,2,5,Hibernating
26402,301,7,1188.28,2,1,2,5,Hibernating
26403,33,9,750.51,5,2,1,8,Regulars
26404,445,12,3095.62,2,4,5,11,At Risk
26405,351,8,1447.22,2,2,3,7,Regulars
26406,33,19,2886.77,5,5,5,15,Champions
26407,453,7,468.83,2,1,1,4,Hibernating
26408,79,8,1213.8,4,2,2,8,Regulars
26409,143,7,1239.08,4,1,2,7,Regulars
26410,296,9,463.39000000000004,2,2,1,5,Hibernating
26411,31,14,3151.4900000000002,5,5,5,15,Champions
26412,67,14,730.34,4,5,1,10,Loyal
26413,654,11,1173.12,1,3,2,6,Regulars
26414,304,7,776.96,2,1,1,4,Hibernating
26415,733,9,1357.61,1,2,3,6,Regulars
26416,90,5,1038.77,4,1,2,7,Regulars
26417,1016,8,391.27,1,2,1,4,Hibernating
26418,432,15,1947.8899999999999,2,5,4,11,At Risk
26419,171,13,1917.98,3,4,4,11,Big Spenders
26420,567,14,908.08,1,5,2,8,At Risk
26421,165,7,687.76,3,1,1,5,Regulars
26422,886,6,713.5600000000001,1,1,1,3,Hibernating
26423,1046,7,1918.5400000000002,1,1,4,6,Regulars
26424,546,11,1700.6899999999998,1,3,3,7,Regulars
26425,224,12,1125.51,3,4,2,9,Regulars
26426,1,13,1772.29,5,4,4,13,Champions
26427,627,11,1529.71,1,3,3,7,Regulars
26428,38,11,1409.1599999999999,5,3,3,11,Loyal
26429,272,6,1341.11,2,1,3,6,Regulars
26430,1179,5,574.38,1,1,1,3,Hibernating
26431,123,12,914.95,4,4,2,10,Loyal
26432,303,9,1242.4,2,2,3,7,Regulars
26433,159,10,1477.98,3,3,3,9,Regulars
26434,238,11,3462.09,3,3,5,11,Big Spenders
26435,58,13,2424.7599999999998,5,4,4,13,Champions
26436,101,13,2401.15,4,4,4,12,Champions
26437,120,11,1104.85,4,3,2,9,Loyal
26438,34,8,796.81,5,2,1,8,Regulars
26439,804,13,3105.05,1,4,5,10,At Risk
26440,47,7,853.21,5,1,2,8,Regulars
26441,44,11,2660.33,5,3,5,13,Loyal
26442,234,10,445.62,3,3,1,7,Regulars
26443,590,9,1215.6,1,2,2,5,Hibernating
26444,344,13,1446.64,2,4,3,9,At Risk
26445,97,6,541.36,4,1,1,6,Regulars
26446,2,11,5339.110000000001,5,3,5,13,Loyal
26447,72,4,502.29999999999995,4,1,1,6,Regulars
26448,104,10,1109.78,4,3,2,9,Loyal
26449,93,10,741.62,4,3,1,8,Loyal
26450,47,8,403.61,5,2,1,8,Regulars
26451,411,8,2371.83,2,2,4,8,Regulars
26452,144,9,830.3000000000001,4,2,1,7,Regulars
26453,316,8,558.44,2,2,1,5,Hibernating
26454,639,6,1287.37,1,1,3,5,Regulars
26455,118,7,538.62,4,1,1,6,Regulars
26456,802,11,2765.4,1,3,5,9,Regulars
26457,209,15,2467.21,3,5,4,12,Big Spenders
26458,228,7,1588.2400000000002,3,1,3,7,Regulars
26459,82,17,4422.16,4,5,5,14,Champions
26460,343,10,2251.7599999999998,2,3,4,9,Regulars
26461,76,17,1717.9,4,5,3,12,Loyal
26462,151,13,1059.36,3,4,2,9,Regulars
26463,191,19,2463.3700000000003,3,5,4,12,Big Spenders
26464,571,13,1185.26,1,4,2,7,At Risk
26465,730,13,988.6999999999999,1,4,2,7,At Risk
26466,101,7,1093.96,4,1,2,7,Regulars
26467,1164,8,2026.1399999999999,1,2,4,7,Regulars
26468,129,9,3077.61,4,2,5,11,Big Spenders
26469,94,13,2517.98,4,4,4,12,Champions
26470,996,7,1719.25,1,1,3,5,Regulars
26471,461,9,1304.3799999999999,1,2,3,6,Regulars
26472,105,9,1126.71,4,2,2,8,Regulars
26473,379,16,4686.63,2,5,5,12,At Risk
26474,32,20,4066.5,5,5,5,15,Champions
26475,321,7,335.13,2,1,1,4,Hibernating
26476,739,12,4987.05,1,4,5,10,At Risk
26477,128,10,1489.74,4,3,3,10,Loyal
26478,232,7,1013.2,3,1,2,6,Regulars
26479,0,10,950.21,5,3,2,10,Loyal
26480,78,11,2575.23,4,3,5,12,Loyal
26481,428,10,4536.49,2,3,5,10,Regulars
26482,39,11,1278.6499999999999,5,3,3,11,Loyal
26483,197,11,3089.12,3,3,5,11,Big Spenders
26484,502,7,1910.78,1,1,4,6,Regulars
26485,197,9,2440.4500000000003,3,2,4,9,Big Spenders
26486,320,4,844.0500000000001,2,1,1,4,Hibernating
26487,82,5,334.04,4,1,1,6,Regulars
26488,662,11,1349.8,1,3,3,7,Regulars
26489,115,17,1857.9099999999999,4,5,4,13,Champions
26490,1023,10,2722.8500000000004,1,3,5,9,Regulars
26491,739,13,1964.27,1,4,4,9,At Risk
26492,827,3,116.41999999999999,1,1,1,3,Hibernating
26493,28,9,3386.63,5,2,5,12,Big Spenders
26494,594,8,823.4100000000001,1,2,1,4,Hibernating
26495,1773,5,2044.17,1,1,4,6,Regulars
26496,193,11,1136.3200000000002,3,3,2,8,Regulars
26497,868,7,1171.03,1,1,2,4,Hibernating
26498,128,12,3056.44,4,4,5,13,Champions
26499,1009,8,1503.51,1,2,3,6,Regulars
26500,452,10,1094.02,2,3,2,7,Regulars
26501,313,11,1122.42,2,3,2,7,Regulars
26502,115,11,1534.39,4,3,3,10,Loyal
26503,521,7,1930.43,1,1,4,6,Regulars
26504,914,6,1015.93,1,1,2,4,Hibernating
26505,564,11,1052.06,1,3,2,6,Regulars
26506,698,5,1593.31,1,1,3,5,Regulars
26507,381,11,2121.35,2,3,4,9,Regulars
26508,145,9,1233.96,4,2,2,8,Regulars
26509,834,7,3284.8199999999997,1,1,5,7,Regulars
26510,703,7,850.41,1,1,2,4,Hibernating
26511,792,10,1216.76,1,3,2,6,Regulars
26512,38,15,1411.23,5,5,3,13,Loyal
26513,403,11,1102.19,2,3,2,7,Regulars
26514,209,19,2753.1,3,5,5,13,Big Spenders
26515,765,4,343.46999999999997,1,1,1,3,Hibernating
26516,40,14,1264.67,5,5,3,13,Loyal
26517,42,15,2846.04,5,5,5,15,Champions
26518,132,17,6018.86,4,5,5,14,Champions
26519,422,6,1349.79,2,1,3,6,Regulars
26520,438,12,2697.64,2,4,5,11,At Risk
26521,503,15,4967.59,1,5,5,11,At Risk
26522,207,10,946.29,3,3,2,8,Regulars
26523,28,10,4818.85,5,3,5,13,Loyal
26524,304,10,1614.9,2,3,3,8,Regulars
26525,6,10,1127.7,5,3,2,10,Loyal
26526,338,10,1531.98,2,3,3,8,Regulars
26527,298,8,1458.13,2,2,3,7,Regulars
26528,5,13,1986.5599999999997,5,4,4,13,Champions
26529,173,10,1348.05,3,3,3,9,Regulars
26530,32,13,2147.42,5,4,4,13,Champions
26531,116,15,2995.4300000000003,4,5,5,14,Champions
26532,61,15,2516.1800000000003,5,5,4,14,Champions
26533,74,18,3675.95,4,5,5,14,Champions
26534,36,12,1725.2600000000002,5,4,4,13,Champions
26535,100,11,1595.19,4,3,3,10,Loyal
26536,610,7,755.49,1,1,1,3,Hibernating
26537,30,13,1447.95,5,4,3,12,Loyal
26538,41,10,1693.26,5,3,3,11,Loyal
26539,157,12,4527.84,3,4,5,12,Big Spenders
26540,0,11,1144.4499999999998,5,3,2,10,Loyal
26541,6,7,924.52,5,1,2,8,Regulars
26542,34,9,518.51,5,2,1,8,Regulars
26543,35,9,2633.0299999999997,5,2,5,12,Big Spenders
26544,534,7,483.35,1,1,1,3,Hibernating
26545,14,9,1481.49,5,2,3,10,Regulars
26546,186,12,3966.07,3,4,5,12,Big Spenders
26547,545,8,785.5799999999999,1,2,1,4,Hibernating
26548,154,11,1861.06,3,3,4,10,Big Spenders
26549,48,16,2429.58,5,5,4,14,Champions
26550,28,8,858.28,5,2,2,9,Regulars
26551,128,11,1684.73,4,3,3,10,Loyal
26552,681,7,926.5799999999999,1,1,2,4,Hibernating
26553,53,15,2573.43,5,5,4,14,Champions
26554,15,9,531.03,5,2,1,8,Regulars
26555,211,12,4331.92,3,4,5,12,Big Spenders
26556,497,11,3096.9,1,3,5,9,Regulars
26557,132,11,864.8,4,3,2,9,Loyal
26558,576,10,2525.18,1,3,4,8,Regulars
26559,91,11,2757.61,4,3,5,12,Loyal
26560,120,10,727.45,4,3,1,8,Loyal
26561,201,9,1173.5,3,2,2,7,Regulars
26562,696,16,2940.9900000000002,1,5,5,11,At Risk
26563,386,11,2129.84,2,3,4,9,Regulars
26564,65,10,1022.4799999999999,5,3,2,10,Loyal
26565,84,14,3228.02,4,5,5,14,Champions
26566,99,10,679.6899999999999,4,3,1,8,Loyal
26567,151,7,456.75,3,1,1,5,Regulars
26568,236,9,1045.4,3,2,2,7,Regulars
26569,337,10,2516.4,2,3,4,9,Regulars
26570,108,9,1220.17,4,2,2,8,Regulars
26571,17,12,2480.4700000000003,5,4,4,13,Champions
26572,12,16,4385.4800000000005,5,5,5,15,Champions
26573,530,11,1777.5,1,3,4,8,Regulars
26574,29,11,4656.53,5,3,5,13,Loyal
26575,134,9,802.39,4,2,1,7,Regulars
26576,138,15,4299.19,4,5,5,14,Champions
26577,156,9,3494.58,3,2,5,10,Big Spenders
26578,50,14,2532.19,5,5,4,14,Champions
26579,11,10,2602.8,5,3,5,13,Loyal
26580,42,11,1503.22,5,3,3,11,Loyal
26581,127,15,5544.01,4,5,5,14,Champions
26582,48,7,1301.1299999999999,5,1,3,9,Regulars
26583,104,10,1250.41,4,3,3,10,Loyal
26584,236,7,822.54,3,1,1,5,Regulars
26585,24,7,1499.24,5,1,3,9,Regulars
26586,1164,7,1464.46,1,1,3,5,Regulars
26587,266,9,705.76,2,2,1,5,Hibernating
26588,30,13,3687.62,5,4,5,14,Champions
26589,74,12,2169.47,4,4,4,12,Champions
26590,253,13,1117.52,2,4,2,8,At Risk
26591,5,11,1409.51,5,3,3,11,Loyal
26592,74,15,2126.5,4,5,4,13,Champions
26593,78,16,2216.7200000000003,4,5,4,13,Champions
26594,231,9,2380.83,3,2,4,9,Big Spenders
26595,263,5,1114.1100000000001,2,1,2,5,Hibernating
26596,45,12,4440.95,5,4,5,14,Champions
26597,8,13,1509.16,5,4,3,12,Loyal
26598,579,9,1050.12,1,2,2,5,Hibernating
26599,23,17,4354.58,5,5,5,15,Champions
26600,95,8,506.22,4,2,1,7,Regulars
26601,76,12,1313.67,4,4,3,11,Loyal
26602,48,8,843.98,5,2,1,8,Regulars
26603,963,7,1605.8,1,1,3,5,Regulars
26604,397,7,1559.05,2,1,3,6,Regulars
26605,879,9,1115.52,1,2,2,5,Hibernating
26606,56,13,1798.39,5,4,4,13,Champions
26607,276,6,1168.58,2,1,2,5,Hibernating
26608,87,9,789.01,4,2,1,7,Regulars
26609,798,12,2529.98,1,4,4,9,At Risk
26610,420,9,1505.9,2,2,3,7,Regulars
26611,156,11,1508.49,3,3,3,9,Regulars
26612,1059,5,1740.7099999999996,1,1,4,6,Regulars
26613,115,17,1351.76,4,5,3,12,Loyal
26614,20,11,2441.1,5,3,4,12,Loyal
26615,797,4,405.17,1,1,1,3,Hibernating
26616,382,5,2229.92,2,1,4,7,Regulars
26617,925,7,451.44,1,1,1,3,Hibernating
26618,149,11,1432.17,3,3,3,9,Regulars
26619,681,7,544.7,1,1,1,3,Hibernating
26620,180,8,647.85,3,2,1,6,Regulars
26621,65,10,1288.67,5,3,3,11,Loyal
26622,236,10,832.0799999999999,3,3,1,7,Regulars
26623,72,13,1682.98,4,4,3,11,Loyal
26624,156,9,580.43,3,2,1,6,Regulars
26625,231,10,836.6600000000001,3,3,1,7,Regulars
26626,887,11,2678.96,1,3,5,9,Regulars
26627,345,6,1161.0,2,1,2,5,Hibernating
26628,174,11,1998.7,3,3,4,10,Big Spenders
26629,310,13,3369.1699999999996,2,4,5,11,At Risk
26630,892,9,958.02,1,2,2,5,Hibernating
26631,33,12,3177.12,5,4,5,14,Champions
26632,42,13,1457.51,5,4,3,12,Loyal
26633,196,6,477.39000000000004,3,1,1,5,Regulars
26634,324,11,2802.69,2,3,5,10,Regulars
26635,217,14,2300.5299999999997,3,5,4,12,Big Spenders
26636,447,13,3226.07,2,4,5,11,At Risk
26637,497,7,456.62,1,1,1,3,Hibernating
26638,462,9,1483.07,1,2,3,6,Regulars
26639,1203,4,1013.1600000000001,1,1,2,4,Hibernating
26640,30,5,658.14,5,1,1,7,Regulars
26641,887,8,506.32000000000005,1,2,1,4,Hibernating
26642,75,14,1625.21,4,5,3,12,Loyal
26643,38,9,820.26,5,2,1,8,Regulars
26644,320,3,137.93,2,1,1,4,Hibernating
26645,79,10,1259.07,4,3,3,10,Loyal
26646,64,17,2053.56,5,5,4,14,Champions
26647,126,14,3525.67,4,5,5,14,Champions
26648,931,13,4974.8099999999995,1,4,5,10,At Risk
26649,123,15,1469.9299999999998,4,5,3,12,Loyal
26650,936,6,2605.5699999999997,1,1,5,7,Regulars
26651,268,13,1669.23,2,4,3,9,At Risk
26652,197,6,757.87,3,1,1,5,Regulars
26653,6,8,699.96,5,2,1,8,Regulars
26654,292,12,1950.66,2,4,4,10,At Risk
26655,391,6,860.48,2,1,2,5,Hibernating
26656,33,13,3654.6200000000003,5,4,5,14,Champions
26657,8,17,3949.95,5,5,5,15,Champions
26658,42,16,2684.88,5,5,5,15,Champions
26659,253,9,1191.89,2,2,2,6,Hibernating
26660,16,17,2567.4,5,5,4,14,Champions
26661,33,13,898.5699999999999,5,4,2,11,Loyal
26662,117,13,1534.85,4,4,3,11,Loyal
26663,232,9,1761.3,3,2,4,9,Big Spenders
26664,679,10,1156.77,1,3,2,6,Regulars
26665,249,12,667.34,2,4,1,7,At Risk
26666,480,7,666.0799999999999,1,1,1,3,Hibernating
26667,99,8,1075.66,4,2,2,8,Regulars
26668,56,7,680.0500000000001,5,1,1,7,Regulars
26669,358,9,1128.79,2,2,2,6,Hibernating
26670,189,12,2045.3700000000001,3,4,4,11,Big Spenders
26671,130,10,983.6899999999999,4,3,2,9,Loyal
26672,111,7,1186.25,4,1,2,7,Regulars
26673,298,10,2026.3899999999999,2,3,4,9,Regulars
26674,50,17,1410.51,5,5,3,13,Loyal
26675,531,4,596.88,1,1,1,3,Hibernating
26676,53,13,1023.37,5,4,2,11,Loyal
26677,196,8,1026.05,3,2,2,7,Regulars
26678,132,6,350.31,4,1,1,6,Regulars
26679,101,12,2226.0,4,4,4,12,Champions
26680,127,14,2559.7,4,5,4,13,Champions
26681,263,11,1858.21,2,3,4,9,Regulars
26682,251,11,1417.13,2,3,3,8,Regulars
26683,108,16,1474.41,4,5,3,12,Loyal
26684,530,5,892.84,1,1,2,4,Hibernating
26685,845,4,322.87,1,1,1,3,Hibernating
26686,456,14,2682.9,2,5,5,12,At Risk
26687,292,9,1468.5900000000001,2,2,3,7,Regulars
26688,543,14,2392.19,1,5,4,10,At Risk
26689,929,7,854.62,1,1,2,4,Hibernating
26690,112,8,3220.28,4,2,5,11,Big Spenders
26691,51,8,1371.94,5,2,3,10,Regulars
26692,438,6,377.48,2,1,1,4,Hibernating
26693,556,21,2953.3,1,5,5,11,At Risk
26694,367,10,1404.17,2,3,3,8,Regulars
26695,69,11,1019.5699999999999,4,3,2,9,Loyal
26696,831,15,5236.03,1,5,5,11,At Risk
26697,269,8,1030.98,2,2,2,6,Hibernating
26698,306,8,701.15,2,2,1,5,Hibernating
26699,577,10,2608.0699999999997,1,3,5,9,Regulars
26700,23,11,922.49,5,3,2,10,Loyal
26701,61,14,2477.75,5,5,4,14,Champions
26702,750,5,1460.56,1,1,3,5,Regulars
26703,30,7,670.47,5,1,1,7,Regulars
26704,489,7,753.73,1,1,1,3,Hibernating
26705,1349,4,347.06,1,1,1,3,Hibernating
26706,81,10,2288.86,4,3,4,11,Loyal
26707,106,19,1472.5,4,5,3,12,Loyal
26708,398,6,762.2099999999999,2,1,1,4,Hibernating
26709,207,14,1306.11,3,5,3,11,Regulars
26710,56,9,3016.61,5,2,5,12,Big Spenders
26711,15,7,1725.57,5,1,4,10,Big Spenders
26712,385,8,646.7,2,2,1,5,Hibernating
26713,64,9,1027.76,5,2,2,9,Regulars
26714,239,15,2478.69,3,5,4,12,Big Spenders
26715,32,7,809.05,5,1,1,7,Regulars
26716,815,5,180.76999999999998,1,1,1,3,Hibernating
26717,73,15,3177.79,4,5,5,14,Champions
26718,392,11,4006.14,2,3,5,10,Regulars
26719,180,7,1030.77,3,1,2,6,Regulars
26720,274,4,1535.72,2,1,3,6,Regulars
26721,92,17,1782.3200000000002,4,5,4,13,Champions
26722,432,12,1986.27,2,4,4,10,At Risk
26723,91,5,458.2,4,1,1,6,Regulars
26724,21,12,1855.83,5,4,4,13,Champions
26725,919,7,1387.1399999999999,1,1,3,5,Regulars
26726,41,12,1759.6200000000001,5,4,4,13,Champions
26727,546,5,719.46,1,1,1,3,Hibernating
26728,162,4,221.0,3,1,1,5,Regulars
26729,215,12,1157.04,3,4,2,9,Regulars
26730,261,9,1177.86,2,2,2,6,Hibernating
26731,491,8,1361.64,1,2,3,6,Regulars
26732,135,9,2598.8,4,2,5,11,Big Spenders
26733,236,14,3811.26,3,5,5,13,Big Spenders
26734,338,9,950.96,2,2,2,6,Hibernating
26735,99,11,1229.0,4,3,2,9,Loyal
26736,178,13,3848.13,3,4,5,12,Big Spenders
26737,135,12,815.23,4,4,1,9,Loyal
26738,243,8,1351.69,3,2,3,8,Regulars
26739,266,5,122.17000000000002,2,1,1,4,Hibernating
26740,118,15,1473.94,4,5,3,12,Loyal
26741,121,6,660.04,4,1,1,6,Regulars
26742,400,12,1108.66,2,4,2,8,At Risk
26743,192,15,1221.42,3,5,2,10,Regulars
26744,583,4,245.44,1,1,1,3,Hibernating
26745,34,11,1399.2,5,3,3,11,Loyal
26746,296,11,2625.5699999999997,2,3,5,10,Regulars
26747,204,6,588.11,3,1,1,5,Regulars
26748,193,10,1332.48,3,3,3,9,Regulars
26749,124,11,691.62,4,3,1,8,Loyal
26750,252,11,1010.74,2,3,2,7,Regulars
26751,630,9,1257.52,1,2,3,6,Regulars
26752,235,8,473.92,3,2,1,6,Regulars
26753,354,14,4379.79,2,5,5,12,At Risk
26754,455,9,1328.6299999999999,2,2,3,7,Regulars
26755,20,9,923.5,5,2,2,9,Regulars
26756,211,9,1564.63,3,2,3,8,Regulars
26757,152,13,3726.25,3,4,5,12,Big Spenders
26758,84,12,3884.54,4,4,5,13,Champions
26759,174,9,710.7,3,2,1,6,Regulars
26760,85,11,1799.6499999999999,4,3,4,11,Loyal
26761,33,5,1698.33,5,1,3,9,Regulars
26762,265,7,715.78,2,1,1,4,Hibernating
26763,126,14,2601.26,4,5,5,14,Champions
26764,290,10,1295.04,2,3,3,8,Regulars
26765,8,7,1146.28,5,1,2,8,Regulars
26766,129,12,1007.09,4,4,2,10,Loyal
26767,94,15,2902.92,4,5,5,14,Champions
26768,283,11,4164.45,2,3,5,10,Regulars
26769,477,12,3257.3999999999996,1,4,5,10,At Risk
26770,39,15,2549.27,5,5,4,14,Champions
26771,161,8,645.5600000000001,3,2,1,6,Regulars
26772,208,9,1414.0500000000002,3,2,3,8,Regulars
26773,161,7,497.93,3,1,1,5,Regulars
26774,69,12,1283.62,4,4,3,11,Loyal
26775,286,9,1758.1599999999999,2,2,4,8,Regulars
26776,469,10,474.61,1,3,1,5,Regulars
26777,464,9,1017.1999999999999,1,2,2,5,Hibernating
26778,563,7,614.75,1,1,1,3,Hibernating
26779,272,11,1009.5,2,3,2,7,Regulars
26780,193,7,778.3800000000001,3,1,1,5,Regulars
26781,234,13,934.73,3,4,2,9,Regulars
26782,485,14,2187.17,1,5,4,10,At Risk
26783,286,7,848.5600000000001,2,1,2,5,Hibernating
26784,111,9,507.99,4,2,1,7,Regulars
26785,200,8,694.62,3,2,1,6,Regulars
26786,903,5,744.5899999999999,1,1,1,3,Hibernating
26787,152,5,549.8,3,1,1,5,Regulars
26788,626,9,1885.5,1,2,4,7,Regulars
26789,332,7,873.8100000000001,2,1,2,5,Hibernating
26790,490,7,2236.81,1,1,4,6,Regulars
26791,87,13,1767.7,4,4,4,12,Champions
26792,894,8,1583.64,1,2,3,6,Regulars
26793,8,9,2694.41,5,2,5,12,Big Spenders
26794,209,16,2592.3599999999997,3,5,5,13,Big Spenders
26795,36,11,4174.84,5,3,5,13,Loyal
26796,127,11,1815.1299999999999,4,3,4,11,Loyal
26797,288,10,1288.53,2,3,3,8,Regulars
26798,3,14,2453.65,5,5,4,14,Champions
26799,622,10,999.77,1,3,2,6,Regulars
26800,13,14,1542.9,5,5,3,13,Loyal
26801,67,14,1152.12,4,5,2,11,Loyal
26802,299,9,1626.3200000000002,2,2,3,7,Regulars
26803,50,10,7454.14,5,3,5,13,Loyal
26804,208,22,1799.44,3,5,4,12,Big Spenders
26805,1041,3,526.28,1,1,1,3,Hibernating
26806,181,8,1053.1,3,2,2,7,Regulars
26807,589,8,838.25,1,2,1,4,Hibernating
26808,0,11,1625.5,5,3,3,11,Loyal
26809,926,8,782.53,1,2,1,4,Hibernating
26810,313,9,1411.83,2,2,3,7,Regulars
26811,197,8,1115.83,3,2,2,7,Regulars
26812,472,11,2073.9,1,3,4,8,Regulars
26813,36,7,541.33,5,1,1,7,Regulars
26814,513,11,5790.4,1,3,5,9,Regulars
26815,365,7,1269.23,2,1,3,6,Regulars
26816,512,7,909.0699999999999,1,1,2,4,Hibernating
26817,83,9,1404.5900000000001,4,2,3,9,Regulars
26818,187,16,1263.71,3,5,3,11,Regulars
26819,220,17,2663.99,3,5,5,13,Big Spenders
26820,19,6,1675.72,5,1,3,9,Regulars
26821,18,15,2035.5,5,5,4,14,Champions
26822,922,6,493.6,1,1,1,3,Hibernating
26823,510,13,1010.1600000000001,1,4,2,7,At Risk
26824,420,14,1441.3899999999999,2,5,3,10,At Risk
26825,586,13,1538.71,1,4,3,8,At Risk
26826,113,7,512.48,4,1,1,6,Regulars
26827,388,8,1439.73,2,2,3,7,Regulars
26828,269,14,3308.77,2,5,5,12,At Risk
26829,290,10,1121.49,2,3,2,7,Regulars
26830,58,19,2100.04,5,5,4,14,Champions
26831,391,7,1350.59,2,1,3,6,Regulars
26832,225,11,1012.03,3,3,2,8,Regulars
26833,286,11,593.48,2,3,1,6,Regulars
26834,88,9,920.92,4,2,2,8,Regulars
26835,833,10,1924.01,1,3,4,8,Regulars
26836,28,10,1430.22,5,3,3,11,Loyal
26837,178,12,1169.14,3,4,2,9,Regulars
26838,108,11,1688.17,4,3,3,10,Loyal
26839,81,13,1930.14,4,4,4,12,Champions
26840,67,13,1326.69,4,4,3,11,Loyal
26841,297,13,1107.85,2,4,2,8,At Risk
26842,21,15,1380.7800000000002,5,5,3,13,Loyal
26843,167,11,1986.46,3,3,4,10,Big Spenders
26844,392,10,1416.45,2,3,3,8,Regulars
26845,171,12,2794.2799999999997,3,4,5,12,Big Spenders
26846,563,4,864.45,1,1,2,4,Hibernating
26847,161,13,1726.8899999999999,3,4,4,11,Big Spenders
26848,123,11,2386.54,4,3,4,11,Loyal
26849,177,5,3080.1,3,1,5,9,Big Spenders
26850,482,10,3131.34,1,3,5,9,Regulars
26851,105,11,1898.5700000000002,4,3,4,11,Loyal
26852,379,4,1702.1499999999999,2,1,3,6,Regulars
26853,279,11,1520.69,2,3,3,8,Regulars
26854,530,5,398.32,1,1,1,3,Hibernating
26855,349,10,809.01,2,3,1,6,Regulars
26856,525,7,2192.63,1,1,4,6,Regulars
26857,52,13,3101.58,5,4,5,14,Champions
26858,165,10,1819.42,3,3,4,10,Big Spenders
26859,719,14,1159.2,1,5,2,8,At Risk
26860,188,10,649.47,3,3,1,7,Regulars
26861,50,6,1542.37,5,1,3,9,Regulars
26862,852,8,645.46,1,2,1,4,Hibernating
26863,268,10,3762.9100000000003,2,3,5,10,Regulars
26864,892,5,419.31000000000006,1,1,1,3,Hibernating
26865,201,7,985.52,3,1,2,6,Regulars
26866,58,6,1149.14,5,1,2,8,Regulars
26867,210,12,1252.38,3,4,3,10,Regulars
26868,448,9,1624.5900000000001,2,2,3,7,Regulars
26869,14,8,903.81,5,2,2,9,Regulars
26870,752,6,963.16,1,1,2,4,Hibernating
26871,57,13,2969.34,5,4,5,14,Champions
26872,1,9,1066.65,5,2,2,9,Regulars
26873,442,10,1189.24,2,3,2,7,Regulars
26874,365,12,1307.76,2,4,3,9,At Risk
26875,108,16,1390.22,4,5,3,12,Loyal
26876,26,7,1943.8100000000002,5,1,4,10,Big Spenders
26877,364,11,2165.85,2,3,4,9,Regulars
26878,915,14,2000.3200000000002,1,5,4,10,At Risk
26879,163,15,1684.52,3,5,3,11,Regulars
26880,166,11,1182.47,3,3,2,8,Regulars
26881,248,9,1167.42,2,2,2,6,Hibernating
26882,127,7,1469.09,4,1,3,8,Regulars
26883,20,12,3571.1200000000003,5,4,5,14,Champions
26884,75,14,3737.41,4,5,5,14,Champions
26885,21,13,3851.21,5,4,5,14,Champions
26886,55,9,1289.35,5,2,3,10,Regulars
26887,713,7,1722.04,1,1,3,5,Regulars
26888,210,14,1304.66,3,5,3,11,Regulars
26889,488,11,2416.92,1,3,4,8,Regulars
26890,188,13,959.0799999999999,3,4,2,9,Regulars
26891,505,9,1110.99,1,2,2,5,Hibernating
26892,17,11,837.3,5,3,1,9,Loyal
26893,162,8,768.38,3,2,1,6,Regulars
26894,896,5,376.1,1,1,1,3,Hibernating
26895,56,15,1550.22,5,5,3,13,Loyal
26896,388,10,846.75,2,3,2,7,Regulars
26897,114,9,1135.17,4,2,2,8,Regulars
26898,90,7,669.98,4,1,1,6,Regulars
26899,48,8,885.3,5,2,2,9,Regulars
26900,236,6,491.2,3,1,1,5,Regulars
26901,14,9,2497.0699999999997,5,2,4,11,Big Spenders
26902,196,7,548.33,3,1,1,5,Regulars
26903,433,8,836.48,2,2,1,5,Hibernating
26904,467,12,1500.58,1,4,3,8,At Risk
26905,461,4,129.75,1,1,1,3,Hibernating
26906,498,10,1198.15,1,3,2,6,Regulars
26907,122,11,1483.99,4,3,3,10,Loyal
26908,76,12,2373.21,4,4,4,12,Champions
26909,34,14,7376.860000000001,5,5,5,15,Champions
26910,201,9,927.35,3,2,2,7,Regulars
26911,378,11,830.98,2,3,1,6,Regulars
26912,89,11,2477.68,4,3,4,11,Loyal
26913,180,14,2296.02,3,5,4,12,Big Spenders
26914,120,11,1751.45,4,3,4,11,Loyal
26915,913,3,1381.46,1,1,3,5,Regulars
26916,298,11,2087.7400000000002,2,3,4,9,Regulars
26917,58,8,925.19,5,2,2,9,Regulars
26918,39,11,3909.53,5,3,5,13,Loyal
26919,246,9,1639.6,3,2,3,8,Regulars
26920,28,15,2207.44,5,5,4,14,Champions
26921,48,12,1338.3700000000001,5,4,3,12,Loyal
26922,227,14,1063.62,3,5,2,10,Regulars
26923,97,12,1232.95,4,4,2,10,Loyal
26924,421,8,664.88,2,2,1,5,Hibernating
26925,165,10,1689.7099999999998,3,3,3,9,Regulars
26926,625,10,1686.16,1,3,3,7,Regulars
26927,305,10,1119.05,2,3,2,7,Regulars
26928,133,10,785.52,4,3,1,8,Loyal
26929,307,13,3533.83,2,4,5,11,At Risk
26930,617,11,2221.67,1,3,4,8,Regulars
26931,47,11,1090.96,5,3,2,10,Loyal
26932,195,12,781.77,3,4,1,8,Regulars
26933,45,9,1829.58,5,2,4,11,Big Spenders
26934,9,10,2747.72,5,3,5,13,Loyal
26935,528,18,4597.64,1,5,5,11,At Risk
26936,265,9,698.2,2,2,1,5,Hibernating
26937,226,12,1564.81,3,4,3,10,Regulars
26938,148,11,1097.97,3,3,2,8,Regulars
26939,233,15,4384.73,3,5,5,13,Big Spenders
26940,93,10,4329.389999999999,4,3,5,12,Loyal
26941,487,8,1303.47,1,2,3,6,Regulars
26942,124,10,1637.26,4,3,3,10,Loyal
26943,347,11,2998.83,2,3,5,10,Regulars
26944,1249,12,1106.6499999999999,1,4,2,7,At Risk
26945,241,9,786.69,3,2,1,6,Regulars
26946,420,9,1220.21,2,2,2,6,Hibernating
26947,594,16,1422.9,1,5,3,9,At Risk
26948,926,7,700.92,1,1,1,3,Hibernating
26949,34,10,1705.6399999999999,5,3,3,11,Loyal
26950,611,3,444.70000000000005,1,1,1,3,Hibernating
26951,114,12,1637.45,4,4,3,11,Loyal
26952,17,13,1200.35,5,4,2,11,Loyal
26953,62,11,3911.4900000000002,5,3,5,13,Loyal
26954,178,10,5032.93,3,3,5,11,Big Spenders
26955,26,12,2618.5299999999997,5,4,5,14,Champions
26956,171,7,1416.93,3,1,3,7,Regulars
26957,487,12,1107.3799999999999,1,4,2,7,At Risk
26958,284,5,552.3199999999999,2,1,1,4,Hibernating
26959,222,11,2450.53,3,3,4,10,Big Spenders
26960,126,8,1070.44,4,2,2,8,Regulars
26961,169,11,1474.1,3,3,3,9,Regulars
26962,206,15,3746.7000000000003,3,5,5,13,Big Spenders
26963,391,10,2949.63,2,3,5,10,Regulars
26964,127,13,1962.11,4,4,4,12,Champions
26965,274,11,985.9399999999999,2,3,2,7,Regulars
26966,707,9,1765.8899999999999,1,2,4,7,Regulars
26967,239,10,1151.38,3,3,2,8,Regulars
26968,50,7,780.96,5,1,1,7,Regulars
26969,481,13,1597.12,1,4,3,8,At Risk
26970,69,15,1633.3600000000001,4,5,3,12,Loyal
26971,1,16,3453.8900000000003,5,5,5,15,Champions
26972,127,15,2162.69,4,5,4,13,Champions
26973,171,9,1496.78,3,2,3,8,Regulars
26974,463,14,4255.59,1,5,5,11,At Risk
26975,213,14,1574.53,3,5,3,11,Regulars
26976,816,12,1130.49,1,4,2,7,At Risk
26977,174,11,2806.04,3,3,5,11,Big Spenders
26978,226,10,1451.74,3,3,3,9,Regulars
26979,143,13,1675.37,4,4,3,11,Loyal
26980,74,10,656.2099999999999,4,3,1,8,Loyal
26981,60,10,1625.43,5,3,3,11,Loyal
26982,1,13,2286.02,5,4,4,13,Champions
26983,69,14,3310.73,4,5,5,14,Champions
26984,604,9,838.5,1,2,1,4,Hibernating
26985,237,9,2284.99,3,2,4,9,Big Spenders
26986,338,13,5750.0,2,4,5,11,At Risk
26987,98,14,3762.03,4,5,5,14,Champions
26988,365,10,1535.1599999999999,2,3,3,8,Regulars
26989,109,9,1268.35,4,2,3,9,Regulars
26990,60,7,1186.26,5,1,2,8,Regulars
26991,435,14,1936.66,2,5,4,11,At Risk
26992,233,15,1763.73,3,5,4,12,Big Spenders
26993,149,14,1435.3,3,5,3,11,Regulars
26994,638,11,1735.9899999999998,1,3,4,8,Regulars
26995,123,11,3009.9100000000003,4,3,5,12,Loyal
26996,205,8,731.47,3,2,1,6,Regulars
26997,338,16,3027.03,2,5,5,12,At Risk
26998,121,8,1874.77,4,2,4,10,Big Spenders
26999,6,8,892.28,5,2,2,9,Regulars
27000,315,11,1341.13,2,3,3,8,Regulars
27001,46,9,903.85,5,2,2,9,Regulars
27002,588,7,535.6,1,1,1,3,Hibernating
27003,82,12,2266.59,4,4,4,12,Champions
27004,0,12,1470.83,5,4,3,12,Loyal
27005,418,13,3285.7200000000003,2,4,5,11,At Risk
27006,507,10,970.51,1,3,2,6,Regulars
27007,1087,4,1031.12,1,1,2,4,Hibernating
27008,210,11,2570.45,3,3,4,10,Big Spenders
27009,446,16,2992.44,2,5,5,12,At Risk
27010,120,8,1188.92,4,2,2,8,Regulars
27011,103,13,2600.68,4,4,5,13,Champions
27012,28,10,2135.89,5,3,4,12,Loyal
27013,50,12,2957.0999999999995,5,4,5,14,Champions
27014,243,9,2975.47,3,2,5,10,Big Spenders
27015,42,10,2498.06,5,3,4,12,Loyal
27016,196,15,6380.099999999999,3,5,5,13,Big Spenders
27017,475,11,1042.19,1,3,2,6,Regulars
27018,426,9,772.79,2,2,1,5,Hibernating
27019,128,13,2597.73,4,4,5,13,Champions
27020,299,10,897.59,2,3,2,7,Regulars
27021,523,14,2344.26,1,5,4,10,At Risk
27022,708,8,3330.21,1,2,5,8,Regulars
27023,91,16,2446.1,4,5,4,13,Champions
27024,445,13,784.8,2,4,1,7,At Risk
27025,214,12,567.8,3,4,1,8,Regulars
27026,259,11,2634.1,2,3,5,10,Regulars
27027,83,9,702.88,4,2,1,7,Regulars
27028,498,5,894.39,1,1,2,4,Hibernating
27029,1624,2,275.83,1,1,1,3,Hibernating
27030,338,7,976.23,2,1,2,5,Hibernating
27031,401,11,881.81,2,3,2,7,Regulars
27032,33,10,2024.7300000000002,5,3,4,12,Loyal
27033,160,4,251.89,3,1,1,5,Regulars
27034,386,13,1988.14,2,4,4,10,At Risk
27035,17,12,1607.45,5,4,3,12,Loyal
27036,313,11,1509.01,2,3,3,8,Regulars
27037,131,9,872.83,4,2,2,8,Regulars
27038,376,11,777.86,2,3,1,6,Regulars
27039,208,10,876.4399999999999,3,3,2,8,Regulars
27040,367,8,1503.55,2,2,3,7,Regulars
27041,716,13,1971.9599999999998,1,4,4,9,At Risk
27042,119,9,3945.25,4,2,5,11,Big Spenders
27043,564,15,2683.15,1,5,5,11,At Risk
27044,382,6,589.9300000000001,2,1,1,4,Hibernating
27045,151,8,548.88,3,2,1,6,Regulars
27046,394,11,2134.75,2,3,4,9,Regulars
27047,147,11,1581.48,4,3,3,10,Loyal
27048,60,7,1489.2499999999998,5,1,3,9,Regulars
27049,307,13,3892.5699999999997,2,4,5,11,At Risk
27050,63,7,1326.01,5,1,3,9,Regulars
27051,800,9,1190.72,1,2,2,5,Hibernating
27052,388,16,9195.24,2,5,5,12,At Risk
27053,65,12,1480.49,5,4,3,12,Loyal
27054,618,15,3657.52,1,5,5,11,At Risk
27055,1139,7,2300.32,1,1,4,6,Regulars
27056,200,9,733.88,3,2,1,6,Regulars
27057,346,9,1166.95,2,2,2,6,Hibernating
27058,455,8,2212.84,2,2,4,8,Regulars
27059,467,14,1869.42,1,5,4,10,At Risk
27060,53,11,1729.95,5,3,4,12,Loyal
27061,308,13,1433.99,2,4,3,9,At Risk
27062,159,10,1149.56,3,3,2,8,Regulars
27063,41,15,2228.17,5,5,4,14,Champions
27064,24,15,1595.18,5,5,3,13,Loyal
27065,162,11,1621.54,3,3,3,9,Regulars
27066,495,10,1169.29,1,3,2,6,Regulars
27067,1432,5,238.29,1,1,1,3,Hibernating
27068,269,8,2440.46,2,2,4,8,Regulars
27069,561,10,1566.49,1,3,3,7,Regulars
27070,39,14,1709.69,5,5,3,13,Loyal
27071,204,14,1609.99,3,5,3,11,Regulars
27072,568,15,2022.96,1,5,4,10,At Risk
27073,20,6,2177.5299999999997,5,1,4,10,Big Spenders
27074,116,12,2334.08,4,4,4,12,Champions
27075,49,12,2111.95,5,4,4,13,Champions
27076,85,14,3063.48,4,5,5,14,Champions
27077,537,11,1364.59,1,3,3,7,Regulars
27078,44,13,2423.85,5,4,4,13,Champions
27079,685,9,1257.1899999999998,1,2,3,6,Regulars
27080,69,14,2456.84,4,5,4,13,Champions
27081,30,15,3600.69,5,5,5,15,Champions
27082,72,14,3342.08,4,5,5,14,Champions
27083,156,15,2026.46,3,5,4,12,Big Spenders
27084,545,10,3192.83,1,3,5,9,Regulars
27085,505,11,4867.11,1,3,5,9,Regulars
27086,233,9,465.47,3,2,1,6,Regulars
27087,64,13,1417.3600000000001,5,4,3,12,Loyal
27088,92,12,1977.3999999999999,4,4,4,12,Champions
27089,15,18,1584.19,5,5,3,13,Loyal
27090,730,10,770.3199999999999,1,3,1,5,Regulars
27091,567,8,1684.09,1,2,3,6,Regulars
27092,28,19,2710.15,5,5,5,15,Champions
27093,504,6,617.44,1,1,1,3,Hibernating
27094,579,9,1903.11,1,2,4,7,Regulars
27095,124,8,2376.55,4,2,4,10,Big Spenders
27096,131,5,355.48,4,1,1,6,Regulars
27097,476,7,1358.73,1,1,3,5,Regulars
27098,1248,8,5815.97,1,2,5,8,Regulars
27099,169,9,1685.5600000000002,3,2,3,8,Regulars
27100,82,6,978.96,4,1,2,7,Regulars
27101,1,17,1942.3899999999999,5,5,4,14,Champions
27102,20,14,2372.1600000000003,5,5,4,14,Champions
27103,261,6,767.94,2,1,1,4,Hibernating
27104,393,10,1375.55,2,3,3,8,Regulars
27105,518,7,1205.0,1,1,2,4,Hibernating
27106,63,11,3318.0,5,3,5,13,Loyal
27107,96,9,2528.4700000000003,4,2,4,10,Big Spenders
27108,151,15,2861.84,3,5,5,13,Big Spenders
27109,26,7,1322.98,5,1,3,9,Regulars
27110,464,16,3472.03,1,5,5,11,At Risk
27111,94,11,782.66,4,3,1,8,Loyal
27112,351,10,1770.3,2,3,4,9,Regulars
27113,95,16,4675.93,4,5,5,14,Champions
27114,39,10,1151.1399999999999,5,3,2,10,Loyal
27115,149,13,1865.4899999999998,3,4,4,11,Big Spenders
27116,46,15,2208.89,5,5,4,14,Champions
27117,242,12,1210.52,3,4,2,9,Regulars
27118,827,6,925.0500000000001,1,1,2,4,Hibernating
27119,2006,3,525.3,1,1,1,3,Hibernating
27120,996,10,1361.47,1,3,3,7,Regulars
27121,578,12,2038.27,1,4,4,9,At Risk
27122,358,12,3354.4300000000003,2,4,5,11,At Risk
27123,64,9,1775.9,5,2,4,11,Big Spenders
27124,145,13,2171.02,4,4,4,12,Champions
27125,255,13,3715.71,2,4,5,11,At Risk
27126,772,5,1368.46,1,1,3,5,Regulars
27127,23,12,2252.48,5,4,4,13,Champions
27128,743,7,1189.32,1,1,2,4,Hibernating
27129,526,6,423.49,1,1,1,3,Hibernating
27130,54,13,1084.94,5,4,2,11,Loyal
27131,323,12,3616.4700000000003,2,4,5,11,At Risk
27132,1055,7,632.75,1,1,1,3,Hibernating
27133,23,12,1438.96,5,4,3,12,Loyal
27134,1053,10,1333.9,1,3,3,7,Regulars
27135,257,12,3471.4300000000003,2,4,5,11,At Risk
27136,513,14,4718.87,1,5,5,11,At Risk
27137,58,11,2216.3,5,3,4,12,Loyal
27138,93,10,2038.24,4,3,4,11,Loyal
27139,57,11,741.73,5,3,1,9,Loyal
27140,857,10,2160.98,1,3,4,8,Regulars
27141,100,11,1262.59,4,3,3,10,Loyal
27142,26,9,1159.06,5,2,2,9,Regulars
27143,91,13,1193.7,4,4,2,10,Loyal
27144,39,9,670.33,5,2,1,8,Regulars
27145,120,13,2074.38,4,4,4,12,Champions
27146,603,10,1331.65,1,3,3,7,Regulars
27147,61,10,2168.92,5,3,4,12,Loyal
27148,148,11,1763.76,3,3,4,10,Big Spenders
27149,118,13,3538.09,4,4,5,13,Champions
27150,352,9,689.25,2,2,1,5,Hibernating
27151,36,9,1437.01,5,2,3,10,Regulars
27152,448,7,757.71,2,1,1,4,Hibernating
27153,208,13,1037.63,3,4,2,9,Regulars
27154,115,10,1507.8899999999999,4,3,3,10,Loyal
27155,414,5,398.0,2,1,1,4,Hibernating
27156,27,4,411.56,5,1,1,7,Regulars
27157,5,10,1227.34,5,3,2,10,Loyal
27158,115,9,1615.5100000000002,4,2,3,9,Regulars
27159,465,10,3418.46,1,3,5,9,Regulars
27160,151,11,1249.08,3,3,3,9,Regulars
27161,45,15,1217.35,5,5,2,12,Loyal
27162,96,8,858.58,4,2,2,8,Regulars
27163,154,9,1066.29,3,2,2,7,Regulars
27164,202,10,2434.45,3,3,4,10,Big Spenders
27165,11,15,1891.47,5,5,4,14,Champions
27166,20,7,1201.1100000000001,5,1,2,8,Regulars
27167,91,12,1596.46,4,4,3,11,Loyal
27168,92,12,1187.73,4,4,2,10,Loyal
27169,886,7,1403.57,1,1,3,5,Regulars
27170,290,12,1838.81,2,4,4,10,At Risk
27171,579,17,3915.95,1,5,5,11,At Risk
27172,952,10,3863.67,1,3,5,9,Regulars
27173,89,12,1098.5,4,4,2,10,Loyal
27174,300,12,1951.84,2,4,4,10,At Risk
27175,333,15,3214.84,2,5,5,12,At Risk
27176,26,12,1957.6599999999999,5,4,4,13,Champions
27177,151,11,2551.3900000000003,3,3,4,10,Big Spenders
27178,32,10,614.42,5,3,1,9,Loyal
27179,194,13,1379.21,3,4,3,10,Regulars
27180,9,11,4017.35,5,3,5,13,Loyal
27181,622,8,1045.88,1,2,2,5,Hibernating
27182,611,8,507.24,1,2,1,4,Hibernating
27183,200,11,3241.77,3,3,5,11,Big Spenders
27184,14,12,2345.35,5,4,4,13,Champions
27185,940,13,1645.0300000000002,1,4,3,8,At Risk
27186,63,15,3966.04,5,5,5,15,Champions
27187,112,9,3649.95,4,2,5,11,Big Spenders
27188,369,12,1736.6299999999999,2,4,4,10,At Risk
27189,421,8,1189.74,2,2,2,6,Hibernating
27190,255,9,1120.8,2,2,2,6,Hibernating
27191,110,6,1460.57,4,1,3,8,Regulars
27192,50,13,2084.7999999999997,5,4,4,13,Champions
27193,219,15,1574.22,3,5,3,11,Regulars
27194,239,8,588.55,3,2,1,6,Regulars
27195,266,11,2241.46,2,3,4,9,Regulars
27196,888,9,708.48,1,2,1,4,Hibernating
27197,113,18,2805.98,4,5,5,14,Champions
27198,1124,10,1193.07,1,3,2,6,Regulars
27199,312,8,868.13,2,2,2,6,Hibernating
27200,403,11,4114.72,2,3,5,10,Regulars
27201,394,6,967.3299999999999,2,1,2,5,Hibernating
27202,3,9,983.78,5,2,2,9,Regulars
27203,159,9,1328.65,3,2,3,8,Regulars
27204,105,11,1026.5900000000001,4,3,2,9,Loyal
27205,597,9,2123.9,1,2,4,7,Regulars
27206,411,9,722.22,2,2,1,5,Hibernating
27207,124,19,1561.3600000000001,4,5,3,12,Loyal
27208,3,16,3054.03,5,5,5,15,Champions
27209,39,6,1860.0999999999997,5,1,4,10,Big Spenders
27210,31,15,1643.92,5,5,3,13,Loyal
27211,482,5,3225.1200000000003,1,1,5,7,Regulars
27212,175,9,1046.42,3,2,2,7,Regulars
27213,66,9,430.28,4,2,1,7,Regulars
27214,139,5,1622.27,4,1,3,8,Regulars
27215,215,12,2627.55,3,4,5,12,Big Spenders
27216,79,7,2168.5199999999995,4,1,4,9,Big Spenders
27217,31,9,570.56,5,2,1,8,Regulars
27218,64,14,1666.6100000000001,5,5,3,13,Loyal
27219,2,9,1539.31,5,2,3,10,Regulars
27220,66,7,621.26,4,1,1,6,Regulars
27221,250,13,2393.4700000000003,2,4,4,10,At Risk
27222,358,8,4830.38,2,2,5,9,Regulars
27223,420,10,2536.5099999999998,2,3,4,9,Regulars
27224,11,8,1368.96,5,2,3,10,Regulars
27225,164,12,1531.4599999999998,3,4,3,10,Regulars
27226,28,11,1910.98,5,3,4,12,Loyal
27227,113,14,990.85,4,5,2,11,Loyal
27228,132,13,3465.6099999999997,4,4,5,13,Champions
27229,6,10,556.33,5,3,1,9,Loyal
27230,1408,6,585.93,1,1,1,3,Hibernating
27231,389,7,2158.5200000000004,2,1,4,7,Regulars
27232,157,12,1135.69,3,4,2,9,Regulars
27233,29,9,801.0600000000001,5,2,1,8,Regulars
27234,488,6,485.7,1,1,1,3,Hibernating
27235,202,16,4168.44,3,5,5,13,Big Spenders
27236,296,7,625.71,2,1,1,4,Hibernating
27237,212,9,1808.9500000000003,3,2,4,9,Big Spenders
27238,156,9,1240.56,3,2,2,7,Regulars
27239,104,10,1724.6999999999998,4,3,3,10,Loyal
27240,852,7,872.2,1,1,2,4,Hibernating
27241,362,9,2504.85,2,2,4,8,Regulars
27242,70,6,792.5500000000001,4,1,1,6,Regulars
27243,453,8,1044.04,2,2,2,6,Hibernating
27244,149,6,697.6700000000001,3,1,1,5,Regulars
27245,1067,5,1799.7399999999998,1,1,4,6,Regulars
27246,346,9,727.7,2,2,1,5,Hibernating
27247,14,17,1627.75,5,5,3,13,Loyal
27248,42,14,1260.05,5,5,3,13,Loyal
27249,85,5,1413.3,4,1,3,8,Regulars
27250,92,15,2490.46,4,5,4,13,Champions
27251,1111,11,1579.07,1,3,3,7,Regulars
27252,962,5,2126.2999999999997,1,1,4,6,Regulars
27253,0,10,1283.44,5,3,3,11,Loyal
27254,724,4,420.88,1,1,1,3,Hibernating
27255,442,13,4808.3,2,4,5,11,At Risk
27256,287,13,3881.07,2,4,5,11,At Risk
27257,352,6,749.5,2,1,1,4,Hibernating
27258,583,11,1152.82,1,3,2,6,Regulars
27259,83,5,356.28999999999996,4,1,1,6,Regulars
27260,556,13,1283.94,1,4,3,8,At Risk
27261,104,12,1823.09,4,4,4,12,Champions
27262,180,5,877.61,3,1,2,6,Regulars
27263,46,9,760.8399999999999,5,2,1,8,Regulars
27264,524,7,1535.01,1,1,3,5,Regulars
27265,49,4,346.88,5,1,1,7,Regulars
27266,428,5,534.86,2,1,1,4,Hibernating
27267,110,9,1223.1299999999999,4,2,2,8,Regulars
27268,153,12,1940.43,3,4,4,11,Big Spenders
27269,69,11,1222.15,4,3,2,9,Loyal
27270,1092,3,413.0,1,1,1,3,Hibernating
27271,130,6,969.2,4,1,2,7,Regulars
27272,71,13,1845.71,4,4,4,12,Champions
27273,334,10,989.85,2,3,2,7,Regulars
27274,474,11,659.88,1,3,1,5,Regulars
27275,204,12,3214.06,3,4,5,12,Big Spenders
27276,823,10,2570.95,1,3,4,8,Regulars
27277,128,13,1230.63,4,4,2,10,Loyal
27278,83,4,365.29,4,1,1,6,Regulars
27279,233,7,704.75,3,1,1,5,Regulars
27280,22,8,745.8,5,2,1,8,Regulars
27281,173,6,650.36,3,1,1,5,Regulars
27282,45,14,3623.59,5,5,5,15,Champions
27283,278,8,570.8,2,2,1,5,Hibernating
27284,69,11,1176.74,4,3,2,9,Loyal
27285,552,7,1147.0100000000002,1,1,2,4,Hibernating
27286,156,9,2753.36,3,2,5,10,Big Spenders
27287,68,10,1563.3700000000001,4,3,3,10,Loyal
27288,150,15,2030.0,3,5,4,12,Big Spenders
27289,310,12,1596.39,2,4,3,9,At Risk
27290,73,14,1762.3300000000002,4,5,4,13,Champions
27291,180,15,1610.97,3,5,3,11,Regulars
27292,159,14,1620.84,3,5,3,11,Regulars
27293,125,12,4162.9400000000005,4,4,5,13,Champions
27294,59,7,472.43,5,1,1,7,Regulars
27295,118,12,2591.2599999999998,4,4,5,13,Champions
27296,134,8,2506.01,4,2,4,10,Big Spenders
27297,378,12,4752.37,2,4,5,11,At Risk
27298,165,7,1970.9099999999999,3,1,4,8,Big Spenders
27299,331,14,1415.15,2,5,3,10,At Risk
27300,767,6,619.5500000000001,1,1,1,3,Hibernating
27301,264,8,1036.93,2,2,2,6,Hibernating
27302,474,8,944.88,1,2,2,5,Hibernating
27303,252,7,364.03,2,1,1,4,Hibernating
27304,507,9,3532.38,1,2,5,8,Regulars
27305,160,7,569.27,3,1,1,5,Regulars
27306,271,10,3441.3900000000003,2,3,5,10,Regulars
27307,603,10,1087.3,1,3,2,6,Regulars
27308,90,14,4118.3,4,5,5,14,Champions
27309,145,11,664.04,4,3,1,8,Loyal
27310,119,7,587.0,4,1,1,6,Regulars
27311,85,15,928.52,4,5,2,11,Loyal
27312,28,12,1726.56,5,4,4,13,Champions
27313,358,8,1022.5699999999999,2,2,2,6,Hibernating
27314,17,12,2125.4,5,4,4,13,Champions
27315,65,15,974.03,5,5,2,12,Loyal
27316,1367,9,4723.28,1,2,5,8,Regulars
27317,125,6,388.53000000000003,4,1,1,6,Regulars
27318,384,10,936.4599999999999,2,3,2,7,Regulars
27319,88,14,2123.48,4,5,4,13,Champions
27320,108,11,1011.96,4,3,2,9,Loyal
27321,110,9,1487.01,4,2,3,9,Regulars
27322,307,8,771.46,2,2,1,5,Hibernating
27323,29,10,948.3199999999999,5,3,2,10,Loyal
27324,185,6,2100.3700000000003,3,1,4,8,Big Spenders
27325,70,16,3718.52,4,5,5,14,Champions
27326,195,9,3582.3700000000003,3,2,5,10,Big Spenders
27327,945,11,1167.11,1,3,2,6,Regulars
27328,36,9,631.89,5,2,1,8,Regulars
27329,2,11,3211.7400000000002,5,3,5,13,Loyal
27330,628,8,4327.91,1,2,5,8,Regulars
27331,90,18,3491.5899999999997,4,5,5,14,Champions
27332,69,17,3601.2000000000003,4,5,5,14,Champions
27333,501,10,1673.28,1,3,3,7,Regulars
27334,400,11,1606.02,2,3,3,8,Regulars
27335,313,11,1229.86,2,3,2,7,Regulars
27336,940,5,718.65,1,1,1,3,Hibernating
27337,273,4,761.4500000000002,2,1,1,4,Hibernating
27338,294,11,1856.28,2,3,4,9,Regulars
27339,93,20,4351.179999999999,4,5,5,14,Champions
27340,334,10,3484.85,2,3,5,10,Regulars
27341,27,12,2905.2000000000003,5,4,5,14,Champions
27342,124,14,1154.91,4,5,2,11,Loyal
27343,351,5,1225.73,2,1,2,5,Hibernating
27344,159,14,4247.05,3,5,5,13,Big Spenders
27345,492,13,3006.66,1,4,5,10,At Risk
27346,43,11,2395.71,5,3,4,12,Loyal
27347,140,11,1424.73,4,3,3,10,Loyal
27348,119,8,1330.9299999999998,4,2,3,9,Regulars
27349,331,13,1266.89,2,4,3,9,At Risk
27350,228,13,2867.5,3,4,5,12,Big Spenders
27351,87,11,1599.22,4,3,3,10,Loyal
27352,182,12,1533.82,3,4,3,10,Regulars
27353,511,9,1902.86,1,2,4,7,Regulars
27354,19,11,2432.67,5,3,4,12,Loyal
27355,156,15,1754.68,3,5,4,12,Big Spenders
27356,4,12,1501.23,5,4,3,12,Loyal
27357,558,6,1035.54,1,1,2,4,Hibernating
27358,287,8,906.63,2,2,2,6,Hibernating
27359,357,10,1085.43,2,3,2,7,Regulars
27360,630,11,1044.57,1,3,2,6,Regulars
27361,505,8,4754.79,1,2,5,8,Regulars
27362,270,10,1209.66,2,3,2,7,Regulars
27363,564,9,907.29,1,2,2,5,Hibernating
27364,465,7,489.34000000000003,1,1,1,3,Hibernating
27365,791,8,1555.1599999999999,1,2,3,6,Regulars
27366,293,14,3238.1899999999996,2,5,5,12,At Risk
27367,1167,5,914.37,1,1,2,4,Hibernating
27368,105,8,610.0799999999999,4,2,1,7,Regulars
27369,279,11,1801.46,2,3,4,9,Regulars
27370,369,13,1085.9,2,4,2,8,At Risk
27371,239,8,2239.85,3,2,4,9,Big Spenders
27372,520,11,910.97,1,3,2,6,Regulars
27373,289,9,699.85,2,2,1,5,Hibernating
27374,3,11,2856.4700000000003,5,3,5,13,Loyal
27375,270,18,3248.5,2,5,5,12,At Risk
27376,831,7,2422.71,1,1,4,6,Regulars
27377,53,8,2262.95,5,2,4,11,Big Spenders
27378,277,18,4420.91,2,5,5,12,At Risk
27379,374,6,827.81,2,1,1,4,Hibernating
27380,113,8,1026.24,4,2,2,8,Regulars
27381,94,14,2052.63,4,5,4,13,Champions
27382,441,11,899.4200000000001,2,3,2,7,Regulars
27383,802,13,1620.99,1,4,3,8,At Risk
27384,165,11,1079.17,3,3,2,8,Regulars
27385,665,13,1336.8799999999999,1,4,3,8,At Risk
27386,184,11,2232.59,3,3,4,10,Big Spenders
27387,216,5,842.1700000000001,3,1,1,5,Regulars
27388,761,9,871.85,1,2,2,5,Hibernating
27389,108,15,2423.59,4,5,4,13,Champions
27390,182,12,1391.51,3,4,3,10,Regulars
27391,450,9,986.9,2,2,2,6,Hibernating
27392,31,5,328.46999999999997,5,1,1,7,Regulars
27393,924,14,2583.5499999999997,1,5,5,11,At Risk
27394,265,11,1517.1,2,3,3,8,Regulars
27395,175,14,8008.24,3,5,5,13,Big Spenders
27396,511,8,898.44,1,2,2,5,Hibernating
27397,261,14,1782.2,2,5,4,11,At Risk
27398,17,9,1866.2800000000002,5,2,4,11,Big Spenders
27399,540,9,2054.13,1,2,4,7,Regulars
27400,204,9,457.78,3,2,1,6,Regulars
27401,65,11,1399.68,5,3,3,11,Loyal
27402,47,12,1015.08,5,4,2,11,Loyal
27403,515,8,1207.6100000000001,1,2,2,5,Hibernating
27404,119,8,514.98,4,2,1,7,Regulars
27405,400,11,3933.4,2,3,5,10,Regulars
27406,134,11,1193.97,4,3,2,9,Loyal
27407,72,9,1073.31,4,2,2,8,Regulars
27408,85,6,1136.8,4,1,2,7,Regulars
27409,52,13,1708.01,5,4,3,12,Loyal
27410,98,13,1098.21,4,4,2,10,Loyal
27411,276,10,1514.3899999999999,2,3,3,8,Regulars
27412,104,17,3843.5499999999997,4,5,5,14,Champions
27413,137,14,1330.11,4,5,3,12,Loyal
27414,483,16,1711.21,1,5,3,9,At Risk
27415,132,11,1546.1100000000001,4,3,3,10,Loyal
27416,137,14,2331.31,4,5,4,13,Champions
27417,1079,9,1834.61,1,2,4,7,Regulars
27418,517,10,1214.23,1,3,2,6,Regulars
27419,27,8,1030.8999999999999,5,2,2,9,Regulars
27420,1019,7,1164.12,1,1,2,4,Hibernating
27421,1008,4,476.28,1,1,1,3,Hibernating
27422,56,9,709.6,5,2,1,8,Regulars
27423,100,9,1471.1200000000001,4,2,3,9,Regulars
27424,67,12,1233.76,4,4,2,10,Loyal
27425,50,9,1018.05,5,2,2,9,Regulars
27426,317,6,3578.48,2,1,5,8,Regulars
27427,386,15,2854.65,2,5,5,12,At Risk
27428,297,19,3606.93,2,5,5,12,At Risk
27429,85,12,2006.47,4,4,4,12,Champions
27430,273,10,2248.2200000000003,2,3,4,9,Regulars
27431,1047,9,4425.21,1,2,5,8,Regulars
27432,300,5,525.8199999999999,2,1,1,4,Hibernating
27433,311,3,325.89,2,1,1,4,Hibernating
27434,210,16,2558.4,3,5,4,12,Big Spenders
27435,185,8,2096.7599999999998,3,2,4,9,Big Spenders
27436,1,8,472.2,5,2,1,8,Regulars
27437,539,7,2964.02,1,1,5,7,Regulars
27438,123,12,1437.13,4,4,3,11,Loyal
27439,409,4,348.5,2,1,1,4,Hibernating
27440,539,6,247.56,1,1,1,3,Hibernating
27441,141,9,1367.77,4,2,3,9,Regulars
27442,387,8,2076.2200000000003,2,2,4,8,Regulars
27443,131,13,1386.34,4,4,3,11,Loyal
27444,196,11,866.5,3,3,2,8,Regulars
27445,309,6,671.61,2,1,1,4,Hibernating
27446,42,9,1623.6,5,2,3,10,Regulars
27447,385,8,1050.39,2,2,2,6,Hibernating
27448,152,5,388.5,3,1,1,5,Regulars
27449,1171,6,564.46,1,1,1,3,Hibernating
27450,638,8,513.52,1,2,1,4,Hibernating
27451,103,8,652.2,4,2,1,7,Regulars
27452,233,9,993.5699999999999,3,2,2,7,Regulars
27453,233,15,1977.5900000000001,3,5,4,12,Big Spenders
27454,25,10,1456.02,5,3,3,11,Loyal
27455,74,7,581.89,4,1,1,6,Regulars
27456,89,12,1936.35,4,4,4,12,Champions
27457,161,5,506.98,3,1,1,5,Regulars
27458,454,1,67.81,2,1,1,4,Hibernating
27459,361,5,499.6,2,1,1,4,Hibernating
27460,261,8,596.6800000000001,2,2,1,5,Hibernating
27461,998,9,1316.97,1,2,3,6,Regulars
27462,273,8,1705.48,2,2,3,7,Regulars
27463,562,12,1362.9,1,4,3,8,At Risk
27464,86,6,399.21000000000004,4,1,1,6,Regulars
27465,90,10,542.24,4,3,1,8,Loyal
27466,209,14,1719.85,3,5,3,11,Regulars
27467,16,9,2492.36,5,2,4,11,Big Spenders
27468,108,18,3173.23,4,5,5,14,Champions
27469,1233,8,762.12,1,2,1,4,Hibernating
27470,448,6,702.35,2,1,1,4,Hibernating
27471,104,14,1565.13,4,5,3,12,Loyal
27472,40,11,1577.06,5,3,3,11,Loyal
27473,56,8,433.90000000000003,5,2,1,8,Regulars
27474,226,12,1305.5,3,4,3,10,Regulars
27475,29,12,2892.33,5,4,5,14,Champions
27476,413,10,1368.15,2,3,3,8,Regulars
27477,15,12,2451.0299999999997,5,4,4,13,Champions
27478,177,9,1088.5,3,2,2,7,Regulars
27479,998,3,169.98,1,1,1,3,Hibernating
27480,1442,4,599.29,1,1,1,3,Hibernating
27481,55,7,425.12,5,1,1,7,Regulars
27482,213,9,2145.1400000000003,3,2,4,9,Big Spenders
27483,342,3,160.29999999999998,2,1,1,4,Hibernating
27484,187,13,6985.759999999999,3,4,5,12,Big Spenders
27485,188,14,1474.75,3,5,3,11,Regulars
27486,173,7,709.32,3,1,1,5,Regulars
27487,30,11,1009.5899999999999,5,3,2,10,Loyal
27488,234,12,3666.95,3,4,5,12,Big Spenders
27489,41,11,1131.1399999999999,5,3,2,10,Loyal
27490,303,11,1503.6299999999999,2,3,3,8,Regulars
27491,231,13,1900.5800000000002,3,4,4,11,Big Spenders
27492,301,12,2193.64,2,4,4,10,At Risk
27493,313,11,1956.48,2,3,4,9,Regulars
27494,90,10,3569.44,4,3,5,12,Loyal
27495,103,19,2833.61,4,5,5,14,Champions
27496,148,12,3279.18,3,4,5,12,Big Spenders
27497,243,14,1609.97,3,5,3,11,Regulars
27498,75,12,3063.77,4,4,5,13,Champions
27499,139,10,1771.05,4,3,4,11,Loyal
27500,587,6,918.44,1,1,2,4,Hibernating
27501,215,8,805.98,3,2,1,6,Regulars
27502,539,11,1190.9,1,3,2,6,Regulars
27503,598,8,691.12,1,2,1,4,Hibernating
27504,439,6,313.1,2,1,1,4,Hibernating
27505,366,10,1097.49,2,3,2,7,Regulars
27506,246,7,531.96,3,1,1,5,Regulars
27507,283,9,1082.58,2,2,2,6,Hibernating
27508,655,6,499.02,1,1,1,3,Hibernating
27509,110,13,1602.64,4,4,3,11,Loyal
27510,235,12,1215.75,3,4,2,9,Regulars
27511,39,15,1201.16,5,5,2,12,Loyal
27512,582,11,1499.74,1,3,3,7,Regulars
27513,177,12,3446.6400000000003,3,4,5,12,Big Spenders
27514,1078,11,1644.3400000000001,1,3,3,7,Regulars
27515,32,8,1212.97,5,2,2,9,Regulars
27516,173,16,3530.95,3,5,5,13,Big Spenders
27517,156,10,1173.01,3,3,2,8,Regulars
27518,1308,3,86.06,1,1,1,3,Hibernating
27519,243,12,3276.8199999999997,3,4,5,12,Big Spenders
27520,44,17,2596.92,5,5,5,15,Champions
27521,157,13,1500.85,3,4,3,10,Regulars
27522,185,9,742.05,3,2,1,6,Regulars
27523,320,14,1008.11,2,5,2,9,At Risk
27524,36,7,875.7,5,1,2,8,Regulars
27525,450,7,733.8199999999999,2,1,1,4,Hibernating
27526,222,7,785.44,3,1,1,5,Regulars
27527,775,7,1043.6599999999999,1,1,2,4,Hibernating
27528,309,5,448.84000000000003,2,1,1,4,Hibernating
27529,243,6,646.49,3,1,1,5,Regulars
27530,502,11,2081.63,1,3,4,8,Regulars
27531,420,13,1250.06,2,4,3,9,At Risk
27532,209,15,2397.4,3,5,4,12,Big Spenders
27533,0,16,1673.77,5,5,3,13,Loyal
27534,113,4,176.61,4,1,1,6,Regulars
27535,201,13,3547.8499999999995,3,4,5,12,Big Spenders
27536,778,9,2294.2200000000003,1,2,4,7,Regulars
27537,166,15,2424.2599999999998,3,5,4,12,Big Spenders
27538,77,8,954.39,4,2,2,8,Regulars
27539,558,5,853.6600000000001,1,1,2,4,Hibernating
27540,313,11,998.03,2,3,2,7,Regulars
27541,277,13,1170.77,2,4,2,8,At Risk
27542,427,12,1474.41,2,4,3,9,At Risk
27543,27,17,1342.54,5,5,3,13,Loyal
27544,870,6,411.33,1,1,1,3,Hibernating
27545,174,6,719.48,3,1,1,5,Regulars
27546,278,8,722.97,2,2,1,5,Hibernating
27547,57,9,649.61,5,2,1,8,Regulars
27548,314,7,3278.5,2,1,5,8,Regulars
27549,274,8,1602.14,2,2,3,7,Regulars
27550,541,6,520.6,1,1,1,3,Hibernating
27551,20,13,1604.76,5,4,3,12,Loyal
27552,528,5,867.29,1,1,2,4,Hibernating
27553,24,12,2895.31,5,4,5,14,Champions
27554,74,13,2358.33,4,4,4,12,Champions
27555,623,7,1654.43,1,1,3,5,Regulars
27556,199,6,466.23,3,1,1,5,Regulars
27557,564,7,387.21999999999997,1,1,1,3,Hibernating
27558,237,15,1757.26,3,5,4,12,Big Spenders
27559,575,8,3054.94,1,2,5,8,Regulars
27560,41,12,1188.01,5,4,2,11,Loyal
27561,166,7,826.18,3,1,1,5,Regulars
27562,69,10,2002.42,4,3,4,11,Loyal
27563,162,4,383.19,3,1,1,5,Regulars
27564,95,16,2861.61,4,5,5,14,Champions
27565,1050,6,2363.68,1,1,4,6,Regulars
27566,386,11,726.39,2,3,1,6,Regulars
27567,376,10,548.96,2,3,1,6,Regulars
27568,94,5,837.2,4,1,1,6,Regulars
27569,621,6,1962.1299999999999,1,1,4,6,Regulars
27570,546,11,1106.6399999999999,1,3,2,6,Regulars
27571,91,9,2343.94,4,2,4,10,Big Spenders
27572,34,13,917.0699999999999,5,4,2,11,Loyal
27573,206,10,1303.97,3,3,3,9,Regulars
27574,100,9,684.19,4,2,1,7,Regulars
27575,751,15,2378.98,1,5,4,10,At Risk
27576,630,9,3510.1199999999994,1,2,5,8,Regulars
27577,23,10,2065.0,5,3,4,12,Loyal
27578,818,8,1617.3,1,2,3,6,Regulars
27579,142,7,953.29,4,1,2,7,Regulars
27580,288,10,1059.52,2,3,2,7,Regulars
27581,343,16,2036.8,2,5,4,11,At Risk
27582,382,9,753.0,2,2,1,5,Hibernating
27583,175,7,766.2,3,1,1,5,Regulars
27584,337,14,1676.43,2,5,3,10,At Risk
27585,161,9,737.67,3,2,1,6,Regulars
27586,609,6,873.2800000000001,1,1,2,4,Hibernating
27587,82,8,1111.93,4,2,2,8,Regulars
27588,57,10,4037.8199999999997,5,3,5,13,Loyal
27589,870,8,1664.6799999999998,1,2,3,6,Regulars
27590,1256,4,358.49,1,1,1,3,Hibernating
27591,253,5,254.31,2,1,1,4,Hibernating
27592,88,12,1797.33,4,4,4,12,Champions
27593,29,9,1509.32,5,2,3,10,Regulars
27594,127,5,620.3299999999999,4,1,1,6,Regulars
27595,23,15,2008.42,5,5,4,14,Champions
27596,23,9,820.47,5,2,1,8,Regulars
27597,225,10,885.4000000000001,3,3,2,8,Regulars
27598,563,13,1512.09,1,4,3,8,At Risk
27599,99,12,1968.06,4,4,4,12,Champions
27600,241,9,915.75,3,2,2,7,Regulars
27601,255,9,1436.0700000000002,2,2,3,7,Regulars
27602,237,10,1260.8300000000002,3,3,3,9,Regulars
27603,235,5,1731.27,3,1,4,8,Big Spenders
27604,444,11,4079.28,2,3,5,10,Regulars
27605,158,8,683.21,3,2,1,6,Regulars
27606,349,7,1979.58,2,1,4,7,Regulars
27607,95,14,2172.99,4,5,4,13,Champions
27608,23,5,405.68,5,1,1,7,Regulars
27609,1528,5,1103.1100000000001,1,1,2,4,Hibernating
27610,30,11,1283.85,5,3,3,11,Loyal
27611,489,11,3822.89,1,3,5,9,Regulars
27612,9,10,1062.52,5,3,2,10,Loyal
27613,362,15,5113.44,2,5,5,12,At Risk
27614,601,6,413.37,1,1,1,3,Hibernating
27615,25,10,2144.54,5,3,4,12,Loyal
27616,39,6,832.37,5,1,1,7,Regulars
27617,147,14,1714.14,4,5,3,12,Loyal
27618,38,9,635.92,5,2,1,8,Regulars
27619,396,11,3086.2900000000004,2,3,5,10,Regulars
27620,199,9,2410.23,3,2,4,9,Big Spenders
27621,49,11,1295.26,5,3,3,11,Loyal
27622,42,9,1273.72,5,2,3,10,Regulars
27623,347,6,808.7099999999999,2,1,1,4,Hibernating
27624,367,9,2002.98,2,2,4,8,Regulars
27625,562,6,773.9,1,1,1,3,Hibernating
27626,109,10,1054.67,4,3,2,9,Loyal
27627,707,10,2368.23,1,3,4,8,Regulars
27628,393,12,3424.7800000000007,2,4,5,11,At Risk
27629,245,10,824.9,3,3,1,7,Regulars
27630,206,16,3857.0899999999997,3,5,5,13,Big Spenders
27631,231,8,1591.06,3,2,3,8,Regulars
27632,372,9,2883.92,2,2,5,9,Regulars
27633,23,13,2295.8,5,4,4,13,Champions
27634,122,8,1823.5,4,2,4,10,Big Spenders
27635,484,7,1010.6600000000001,1,1,2,4,Hibernating
27636,72,13,2607.15,4,4,5,13,Champions
27637,329,14,3024.92,2,5,5,12,At Risk
27638,116,16,2014.18,4,5,4,13,Champions
27639,14,12,3722.54,5,4,5,14,Champions
27640,8,13,2823.59,5,4,5,14,Champions
27641,617,13,1476.28,1,4,3,8,At Risk
27642,91,15,1837.08,4,5,4,13,Champions
27643,74,10,1131.06,4,3,2,9,Loyal
27644,530,6,1185.8600000000001,1,1,2,4,Hibernating
27645,893,8,502.08,1,2,1,4,Hibernating
27646,379,9,2258.0099999999998,2,2,4,8,Regulars
27647,119,16,2768.55,4,5,5,14,Champions
27648,83,10,1639.79,4,3,3,10,Loyal
27649,221,9,1736.51,3,2,4,9,Big Spenders
27650,848,4,457.25,1,1,1,3,Hibernating
27651,117,11,1570.51,4,3,3,10,Loyal
27652,401,10,1798.56,2,3,4,9,Regulars
27653,306,13,1187.83,2,4,2,8,At Risk
27654,166,15,1555.6100000000001,3,5,3,11,Regulars
27655,209,9,950.91,3,2,2,7,Regulars
27656,475,11,1258.9,1,3,3,7,Regulars
27657,246,8,332.93,3,2,1,6,Regulars
27658,6,11,1999.0100000000002,5,3,4,12,Loyal
27659,388,9,1855.58,2,2,4,8,Regulars
27660,122,11,1545.38,4,3,3,10,Loyal
27661,220,7,1638.92,3,1,3,7,Regulars
27662,159,10,3119.5299999999997,3,3,5,11,Big Spenders
27663,195,9,751.9399999999999,3,2,1,6,Regulars
27664,553,7,440.27,1,1,1,3,Hibernating
27665,499,8,671.8,1,2,1,4,Hibernating
27666,55,17,2683.43,5,5,5,15,Champions
27667,91,19,3032.3100000000004,4,5,5,14,Champions
27668,707,8,818.62,1,2,1,4,Hibernating
27669,118,6,1274.43,4,1,3,8,Regulars
27670,513,7,1993.1399999999999,1,1,4,6,Regulars
27671,15,7,524.6,5,1,1,7,Regulars
27672,290,13,3858.31,2,4,5,11,At Risk
27673,232,10,1511.92,3,3,3,9,Regulars
27674,384,10,4203.04,2,3,5,10,Regulars
27675,21,10,4043.29,5,3,5,13,Loyal
27676,156,12,1153.74,3,4,2,9,Regulars
27677,0,4,1765.85,5,1,4,10,Big Spenders
27678,221,14,1505.93,3,5,3,11,Regulars
27679,905,6,748.04,1,1,1,3,Hibernating
27680,10,13,1806.26,5,4,4,13,Champions
27681,140,15,1400.04,4,5,3,12,Loyal
27682,434,10,1105.6,2,3,2,7,Regulars
27683,252,13,2327.98,2,4,4,10,At Risk
27684,623,10,2519.71,1,3,4,8,Regulars
27685,665,11,987.72,1,3,2,6,Regulars
27686,14,12,1815.13,5,4,4,13,Champions
27687,339,7,1041.45,2,1,2,5,Hibernating
27688,93,12,2011.0099999999998,4,4,4,12,Champions
27689,12,13,2303.55,5,4,4,13,Champions
27690,49,9,1528.8100000000002,5,2,3,10,Regulars
27691,658,4,371.42,1,1,1,3,Hibernating
27692,386,6,634.39,2,1,1,4,Hibernating
27693,34,13,1003.33,5,4,2,11,Loyal
27694,227,10,2393.59,3,3,4,10,Big Spenders
27695,84,9,3894.03,4,2,5,11,Big Spenders
27696,285,7,357.03,2,1,1,4,Hibernating
27697,366,8,2965.94,2,2,5,9,Regulars
27698,128,13,5678.29,4,4,5,13,Champions
27699,102,10,770.26,4,3,1,8,Loyal
27700,317,10,1239.42,2,3,2,7,Regulars
27701,629,7,1245.73,1,1,3,5,Regulars
27702,364,9,3123.2799999999997,2,2,5,9,Regulars
27703,48,9,1457.3000000000002,5,2,3,10,Regulars
27704,733,5,983.34,1,1,2,4,Hibernating
27705,664,7,2980.4399999999996,1,1,5,7,Regulars
27706,125,15,1412.92,4,5,3,12,Loyal
27707,14,9,1320.15,5,2,3,10,Regulars
27708,223,12,3974.73,3,4,5,12,Big Spenders
27709,264,8,748.6899999999999,2,2,1,5,Hibernating
27710,266,13,1774.06,2,4,4,10,At Risk
27711,797,12,1255.52,1,4,3,8,At Risk
27712,279,7,643.55,2,1,1,4,Hibernating
27713,124,18,6257.3,4,5,5,14,Champions
27714,554,4,235.14,1,1,1,3,Hibernating
27715,67,8,442.40000000000003,4,2,1,7,Regulars
27716,780,7,3301.9100000000003,1,1,5,7,Regulars
27717,272,7,956.5899999999999,2,1,2,5,Hibernating
27718,55,4,3021.29,5,1,5,11,Big Spenders
27719,200,9,1112.45,3,2,2,7,Regulars
27720,143,18,2319.4900000000002,4,5,4,13,Champions
27721,138,10,1000.01,4,3,2,9,Loyal
27722,171,12,1712.1,3,4,3,10,Regulars
27723,843,8,1488.78,1,2,3,6,Regulars
27724,290,13,1780.1,2,4,4,10,At Risk
27725,15,8,2856.38,5,2,5,12,Big Spenders
27726,64,19,4108.59,5,5,5,15,Champions
27727,103,7,660.5200000000001,4,1,1,6,Regulars
27728,99,8,1052.34,4,2,2,8,Regulars
27729,383,14,1605.3,2,5,3,10,At Risk
27730,292,9,497.7,2,2,1,5,Hibernating
27731,89,11,1836.85,4,3,4,11,Loyal
27732,118,13,2517.6,4,4,4,12,Champions
27733,298,13,1481.22,2,4,3,9,At Risk
27734,139,8,938.8100000000001,4,2,2,8,Regulars
27735,182,12,3041.0499999999997,3,4,5,12,Big Spenders
27736,609,11,1719.96,1,3,3,7,Regulars
27737,255,6,943.98,2,1,2,5,Hibernating
27738,301,7,2241.66,2,1,4,7,Regulars
27739,91,14,3958.36,4,5,5,14,Champions
27740,119,11,5761.84,4,3,5,12,Loyal
27741,44,15,3119.11,5,5,5,15,Champions
27742,52,20,4101.55,5,5,5,15,Champions
27743,0,11,1242.9399999999998,5,3,3,11,Loyal
27744,45,12,733.29,5,4,1,10,Loyal
27745,382,10,1145.35,2,3,2,7,Regulars
27746,430,13,1475.53,2,4,3,9,At Risk
27747,24,9,775.45,5,2,1,8,Regulars
27748,319,11,2723.58,2,3,5,10,Regulars
27749,142,6,1186.79,4,1,2,7,Regulars
27750,521,19,2527.93,1,5,4,10,At Risk
27751,204,10,2179.08,3,3,4,10,Big Spenders
27752,139,14,3573.47,4,5,5,14,Champions
27753,278,14,1795.15,2,5,4,11,At Risk
27754,118,10,3406.25,4,3,5,12,Loyal
27755,212,6,914.0699999999999,3,1,2,6,Regulars
27756,184,15,2450.18,3,5,4,12,Big Spenders
27757,1142,6,1173.03,1,1,2,4,Hibernating
27758,252,13,1383.44,2,4,3,9,At Risk
27759,133,13,2715.62,4,4,5,13,Champions
27760,34,4,203.98000000000002,5,1,1,7,Regulars
27761,12,6,1231.81,5,1,2,8,Regulars
27762,347,9,1071.95,2,2,2,6,Hibernating
27763,28,11,1413.67,5,3,3,11,Loyal
27764,75,8,551.3199999999999,4,2,1,7,Regulars
27765,578,7,1222.0,1,1,2,4,Hibernating
27766,179,9,1974.01,3,2,4,9,Big Spenders
27767,114,9,1556.96,4,2,3,9,Regulars
27768,848,5,250.91,1,1,1,3,Hibernating
27769,831,7,931.02,1,1,2,4,Hibernating
27770,230,5,445.16999999999996,3,1,1,5,Regulars
27771,111,15,2565.75,4,5,4,13,Champions
27772,71,10,2398.29,4,3,4,11,Loyal
27773,93,7,1460.37,4,1,3,8,Regulars
27774,295,11,1732.04,2,3,4,9,Regulars
27775,453,8,1581.48,2,2,3,7,Regulars
27776,26,10,2113.63,5,3,4,12,Loyal
27777,195,8,1144.87,3,2,2,7,Regulars
27778,50,12,1629.3700000000001,5,4,3,12,Loyal
27779,425,12,1366.98,2,4,3,9,At Risk
27780,41,11,2949.7,5,3,5,13,Loyal
27781,6,10,1045.06,5,3,2,10,Loyal
27782,52,15,6817.17,5,5,5,15,Champions
27783,110,16,4216.2,4,5,5,14,Champions
27784,290,13,1066.57,2,4,2,8,At Risk
27785,54,11,2599.71,5,3,5,13,Loyal
27786,714,9,1068.25,1,2,2,5,Hibernating
27787,218,12,2186.86,3,4,4,11,Big Spenders
27788,213,7,700.0600000000001,3,1,1,5,Regulars
27789,378,13,4180.35,2,4,5,11,At Risk
27790,462,11,2450.06,1,3,4,8,Regulars
27791,191,13,1239.09,3,4,2,9,Regulars
27792,155,11,1293.1200000000001,3,3,3,9,Regulars
27793,76,8,802.5300000000001,4,2,1,7,Regulars
27794,525,4,167.83,1,1,1,3,Hibernating
27795,586,10,1000.5699999999999,1,3,2,6,Regulars
27796,21,7,663.49,5,1,1,7,Regulars
27797,99,14,5868.61,4,5,5,14,Champions
27798,131,10,3365.1699999999996,4,3,5,12,Loyal
27799,110,8,1739.32,4,2,4,10,Big Spenders
27800,531,9,761.19,1,2,1,4,Hibernating
27801,351,9,791.04,2,2,1,5,Hibernating
27802,68,12,2983.4700000000003,4,4,5,13,Champions
27803,475,6,725.56,1,1,1,3,Hibernating
27804,104,10,2323.0699999999997,4,3,4,11,Loyal
27805,825,5,497.58000000000004,1,1,1,3,Hibernating
27806,497,8,2274.85,1,2,4,7,Regulars
27807,39,11,3439.0300000000007,5,3,5,13,Loyal
27808,116,12,1152.63,4,4,2,10,Loyal
27809,1,10,4006.81,5,3,5,13,Loyal
27810,296,12,1848.58,2,4,4,10,At Risk
27811,1601,2,124.27,1,1,1,3,Hibernating
27812,176,12,1064.32,3,4,2,9,Regulars
27813,237,9,843.31,3,2,1,6,Regulars
27814,24,7,508.36,5,1,1,7,Regulars
27815,1310,9,1247.41,1,2,3,6,Regulars
27816,165,9,2026.05,3,2,4,9,Big Spenders
27817,71,13,1645.16,4,4,3,11,Loyal
27818,21,10,1335.42,5,3,3,11,Loyal
27819,53,7,911.38,5,1,2,8,Regulars
27820,298,13,2155.29,2,4,4,10,At Risk
27821,7,10,2372.83,5,3,4,12,Loyal
27822,167,8,813.87,3,2,1,6,Regulars
27823,728,11,1094.38,1,3,2,6,Regulars
27824,440,14,2412.2999999999997,2,5,4,11,At Risk
27825,882,8,569.66,1,2,1,4,Hibernating
27826,46,11,1411.3,5,3,3,11,Loyal
27827,223,10,2061.14,3,3,4,10,Big Spenders
27828,292,11,3086.6,2,3,5,10,Regulars
27829,0,12,918.8,5,4,2,11,Loyal
27830,904,7,620.14,1,1,1,3,Hibernating
27831,165,6,1423.21,3,1,3,7,Regulars
27832,146,8,1891.9499999999998,4,2,4,10,Big Spenders
27833,120,11,1124.69,4,3,2,9,Loyal
27834,521,11,2971.3999999999996,1,3,5,9,Regulars
27835,43,8,718.5699999999999,5,2,1,8,Regulars
27836,0,10,2452.58,5,3,4,12,Loyal
27837,122,18,2039.3600000000001,4,5,4,13,Champions
27838,539,7,940.9,1,1,2,4,Hibernating
27839,262,8,1830.7799999999997,2,2,4,8,Regulars
27840,279,4,2519.83,2,1,4,7,Regulars
27841,414,13,3126.46,2,4,5,11,At Risk
27842,127,12,1473.02,4,4,3,11,Loyal
27843,45,6,1635.6,5,1,3,9,Regulars
27844,166,11,1859.52,3,3,4,10,Big Spenders
27845,889,10,870.48,1,3,2,6,Regulars
27846,124,9,2836.62,4,2,5,11,Big Spenders
27847,60,8,2489.75,5,2,4,11,Big Spenders
27848,490,6,750.29,1,1,1,3,Hibernating
27849,403,8,890.45,2,2,2,6,Hibernating
27850,98,7,3028.25,4,1,5,10,Big Spenders
27851,66,12,1250.45,4,4,3,11,Loyal
27852,348,15,3824.0899999999997,2,5,5,12,At Risk
27853,697,10,2398.16,1,3,4,8,Regulars
27854,33,11,1223.76,5,3,2,10,Loyal
27855,291,18,2064.19,2,5,4,11,At Risk
27856,322,16,2817.7799999999997,2,5,5,12,At Risk
27857,1630,5,353.07,1,1,1,3,Hibernating
27858,58,9,1445.31,5,2,3,10,Regulars
27859,676,10,1396.4,1,3,3,7,Regulars
27860,399,9,1352.88,2,2,3,7,Regulars
27861,5,8,3521.71,5,2,5,12,Big Spenders
27862,539,7,780.66,1,1,1,3,Hibernating
27863,239,14,3762.7300000000005,3,5,5,13,Big Spenders
27864,341,8,825.26,2,2,1,5,Hibernating
27865,975,5,558.6600000000001,1,1,1,3,Hibernating
27866,768,8,694.4200000000001,1,2,1,4,Hibernating
27867,705,3,1665.7400000000002,1,1,3,5,Regulars
27868,93,16,2946.7799999999997,4,5,5,14,Champions
27869,158,13,2793.5699999999997,3,4,5,12,Big Spenders
27870,56,12,1321.37,5,4,3,12,Loyal
27871,90,12,1663.21,4,4,3,11,Loyal
27872,8,20,3096.9900000000002,5,5,5,15,Champions
27873,25,6,731.3199999999999,5,1,1,7,Regulars
27874,313,9,1042.86,2,2,2,6,Hibernating
27875,85,15,2663.5699999999997,4,5,5,14,Champions
27876,393,11,811.64,2,3,1,6,Regulars
27877,100,14,2026.94,4,5,4,13,Champions
27878,152,12,1807.8,3,4,4,11,Big Spenders
27879,124,10,1907.41,4,3,4,11,Loyal
27880,293,8,2990.43,2,2,5,9,Regulars
27881,10,10,2865.27,5,3,5,13,Loyal
27882,19,7,3189.03,5,1,5,11,Big Spenders
27883,88,13,1830.9299999999998,4,4,4,12,Champions
27884,381,6,654.41,2,1,1,4,Hibernating
27885,114,7,944.98,4,1,2,7,Regulars
27886,349,6,661.6400000000001,2,1,1,4,Hibernating
27887,328,13,2342.0,2,4,4,10,At Risk
27888,14,8,1032.38,5,2,2,9,Regulars
27889,12,13,3903.0699999999997,5,4,5,14,Champions
27890,22,11,736.59,5,3,1,9,Loyal
27891,149,14,1792.0100000000002,3,5,4,12,Big Spenders
27892,292,11,788.0699999999999,2,3,1,6,Regulars
27893,83,8,539.8,4,2,1,7,Regulars
27894,1205,6,1454.49,1,1,3,5,Regulars
27895,351,8,4092.34,2,2,5,9,Regulars
27896,113,9,1445.68,4,2,3,9,Regulars
27897,505,13,1911.5500000000002,1,4,4,9,At Risk
27898,16,16,2533.42,5,5,4,14,Champions
27899,134,12,7092.43,4,4,5,13,Champions
27900,339,10,3926.16,2,3,5,10,Regulars
27901,552,7,943.6,1,1,2,4,Hibernating
27902,20,7,555.19,5,1,1,7,Regulars
27903,30,15,1545.31,5,5,3,13,Loyal
27904,577,12,2133.42,1,4,4,9,At Risk
27905,0,13,1344.74,5,4,3,12,Loyal
27906,96,11,1284.6100000000001,4,3,3,10,Loyal
27907,59,11,1793.41,5,3,4,12,Loyal
27908,452,7,859.79,2,1,2,5,Hibernating
27909,714,4,376.27,1,1,1,3,Hibernating
27910,277,11,2301.9199999999996,2,3,4,9,Regulars
27911,277,11,2670.84,2,3,5,10,Regulars
27912,34,8,483.97,5,2,1,8,Regulars
27913,604,12,1727.1799999999998,1,4,4,9,At Risk
27914,198,14,1135.22,3,5,2,10,Regulars
27915,308,8,3007.12,2,2,5,9,Regulars
27916,404,8,435.36,2,2,1,5,Hibernating
27917,52,12,3222.28,5,4,5,14,Champions
27918,336,14,5388.290000000001,2,5,5,12,At Risk
27919,226,13,2367.16,3,4,4,11,Big Spenders
27920,331,10,801.8100000000001,2,3,1,6,Regulars
27921,69,9,920.2600000000001,4,2,2,8,Regulars
27922,531,8,656.09,1,2,1,4,Hibernating
27923,121,9,666.66,4,2,1,7,Regulars
27924,97,11,1539.59,4,3,3,10,Loyal
27925,688,6,1706.6300000000006,1,1,3,5,Regulars
27926,203,13,789.08,3,4,1,8,Regulars
27927,339,8,790.27,2,2,1,5,Hibernating
27928,354,10,2327.69,2,3,4,9,Regulars
27929,20,17,2478.2,5,5,4,14,Champions
27930,219,8,708.72,3,2,1,6,Regulars
27931,629,9,1254.5,1,2,3,6,Regulars
27932,971,5,502.95,1,1,1,3,Hibernating
27933,108,10,1277.68,4,3,3,10,Loyal
27934,331,11,1383.2,2,3,3,8,Regulars
27935,553,4,1457.3,1,1,3,5,Regulars
27936,611,5,2176.89,1,1,4,6,Regulars
27937,357,13,1102.58,2,4,2,8,At Risk
27938,386,13,1191.88,2,4,2,8,At Risk
27939,177,12,1072.04,3,4,2,9,Regulars
27940,128,11,1423.4,4,3,3,10,Loyal
27941,163,12,1086.01,3,4,2,9,Regulars
27942,404,10,1278.27,2,3,3,8,Regulars
27943,1298,4,653.61,1,1,1,3,Hibernating
27944,186,8,630.28,3,2,1,6,Regulars
27945,228,10,1008.24,3,3,2,8,Regulars
27946,108,13,2059.82,4,4,4,12,Champions
27947,829,3,121.09,1,1,1,3,Hibernating
27948,178,16,4737.84,3,5,5,13,Big Spenders
27949,201,8,3109.7799999999997,3,2,5,10,Big Spenders
27950,112,14,5331.97,4,5,5,14,Champions
27951,1319,9,885.5500000000001,1,2,2,5,Hibernating
27952,387,9,906.09,2,2,2,6,Hibernating
27953,12,9,1160.21,5,2,2,9,Regulars
27954,530,10,717.19,1,3,1,5,Regulars
27955,40,13,1100.57,5,4,2,11,Loyal
27956,22,12,1971.25,5,4,4,13,Champions
27957,586,3,281.85,1,1,1,3,Hibernating
27958,8,14,3004.5299999999997,5,5,5,15,Champions
27959,580,10,1767.67,1,3,4,8,Regulars
27960,695,11,2177.91,1,3,4,8,Regulars
27961,18,11,1343.96,5,3,3,11,Loyal
27962,0,12,3164.2,5,4,5,14,Champions
27963,351,11,1126.15,2,3,2,7,Regulars
27964,107,8,643.2,4,2,1,7,Regulars
27965,210,16,1889.68,3,5,4,12,Big Spenders
27966,187,11,1170.82,3,3,2,8,Regulars
27967,110,9,1731.55,4,2,4,10,Big Spenders
27968,279,8,1442.49,2,2,3,7,Regulars
27969,153,11,1923.63,3,3,4,10,Big Spenders
27970,277,8,511.92,2,2,1,5,Hibernating
27971,413,6,739.0600000000001,2,1,1,4,Hibernating
27972,250,8,4673.32,2,2,5,9,Regulars
27973,97,12,1472.4099999999999,4,4,3,11,Loyal
27974,200,8,1027.59,3,2,2,7,Regulars
27975,221,8,1262.87,3,2,3,8,Regulars
27976,137,12,1462.55,4,4,3,11,Loyal
27977,71,9,1295.45,4,2,3,9,Regulars
27978,854,6,883.0699999999999,1,1,2,4,Hibernating
27979,95,11,3157.87,4,3,5,12,Loyal
27980,196,10,2631.6,3,3,5,11,Big Spenders
27981,13,12,1038.71,5,4,2,11,Loyal
27982,55,10,1643.49,5,3,3,11,Loyal
27983,10,9,961.73,5,2,2,9,Regulars
27984,74,18,962.61,4,5,2,11,Loyal
27985,394,12,2709.8,2,4,5,11,At Risk
27986,588,8,1014.1499999999999,1,2,2,5,Hibernating
27987,247,8,2592.65,3,2,5,10,Big Spenders
27988,584,10,610.98,1,3,1,5,Regulars
27989,183,14,5122.67,3,5,5,13,Big Spenders
27990,56,13,1345.14,5,4,3,12,Loyal
27991,453,14,2524.2999999999997,2,5,4,11,At Risk
27992,164,8,1027.04,3,2,2,7,Regulars
27993,10,14,920.62,5,5,2,12,Loyal
27994,19,11,2775.79,5,3,5,13,Loyal
27995,116,8,963.5600000000001,4,2,2,8,Regulars
27996,338,7,3187.3,2,1,5,8,Regulars
27997,49,8,812.3000000000001,5,2,1,8,Regulars
27998,403,12,1239.77,2,4,2,8,At Risk
27999,118,11,1082.63,4,3,2,9,Loyal
28000,160,15,3073.79,3,5,5,13,Big Spenders
28001,77,7,1501.7300000000002,4,1,3,8,Regulars
28002,290,6,1734.31,2,1,4,7,Regulars
28003,127,8,958.3299999999999,4,2,2,8,Regulars
28004,166,4,243.47,3,1,1,5,Regulars
28005,812,9,630.3299999999999,1,2,1,4,Hibernating
28006,72,7,2385.6400000000003,4,1,4,9,Big Spenders
28007,50,9,1861.9099999999999,5,2,4,11,Big Spenders
28008,208,8,746.01,3,2,1,6,Regulars
28009,525,11,1485.55,1,3,3,7,Regulars
28010,539,10,1708.6699999999998,1,3,3,7,Regulars
28011,104,12,2421.06,4,4,4,12,Champions
28012,349,9,859.74,2,2,2,6,Hibernating
28013,267,12,1658.31,2,4,3,9,At Risk
28014,89,15,3161.56,4,5,5,14,Champions
28015,87,6,1486.47,4,1,3,8,Regulars
28016,394,8,1808.57,2,2,4,8,Regulars
28017,263,11,2450.25,2,3,4,9,Regulars
28018,347,13,3050.96,2,4,5,11,At Risk
28019,180,10,1047.78,3,3,2,8,Regulars
28020,48,10,520.51,5,3,1,9,Loyal
28021,19,12,3697.93,5,4,5,14,Champions
28022,112,9,1482.25,4,2,3,9,Regulars
28023,126,9,778.8100000000001,4,2,1,7,Regulars
28024,916,8,2106.59,1,2,4,7,Regulars
28025,157,11,2532.61,3,3,4,10,Big Spenders
28026,397,6,710.29,2,1,1,4,Hibernating
28027,284,11,3003.73,2,3,5,10,Regulars
28028,1493,7,633.4100000000001,1,1,1,3,Hibernating
28029,636,5,811.09,1,1,1,3,Hibernating
28030,668,13,1754.6899999999998,1,4,4,9,At Risk
28031,86,12,1801.78,4,4,4,12,Champions
28032,172,15,1770.36,3,5,4,12,Big Spenders
28033,656,7,992.4200000000001,1,1,2,4,Hibernating
28034,609,8,990.6300000000001,1,2,2,5,Hibernating
28035,542,10,885.09,1,3,2,6,Regulars
28036,519,8,2297.81,1,2,4,7,Regulars
28037,528,10,1452.1799999999998,1,3,3,7,Regulars
28038,160,12,2957.77,3,4,5,12,Big Spenders
28039,311,8,1028.87,2,2,2,6,Hibernating
28040,175,11,1364.7,3,3,3,9,Regulars
28041,614,6,733.3399999999999,1,1,1,3,Hibernating
28042,586,9,516.15,1,2,1,4,Hibernating
28043,302,7,714.6199999999999,2,1,1,4,Hibernating
28044,172,11,894.34,3,3,2,8,Regulars
28045,540,9,647.95,1,2,1,4,Hibernating
28046,538,14,4022.76,1,5,5,11,At Risk
28047,3,13,2243.0,5,4,4,13,Champions
28048,63,11,2629.44,5,3,5,13,Loyal
28049,238,9,3779.6499999999996,3,2,5,10,Big Spenders
28050,63,11,2274.39,5,3,4,12,Loyal
28051,70,12,3178.74,4,4,5,13,Champions
28052,351,15,3658.9,2,5,5,12,At Risk
28053,548,8,693.81,1,2,1,4,Hibernating
28054,124,13,2134.9,4,4,4,12,Champions
28055,48,18,2686.46,5,5,5,15,Champions
28056,327,12,1276.81,2,4,3,9,At Risk
28057,218,16,1109.3,3,5,2,10,Regulars
28058,55,13,2036.73,5,4,4,13,Champions
28059,160,12,1441.83,3,4,3,10,Regulars
28060,1806,6,872.4,1,1,2,4,Hibernating
28061,610,18,2131.0,1,5,4,10,At Risk
28062,261,12,708.42,2,4,1,7,At Risk
28063,356,2,211.28,2,1,1,4,Hibernating
28064,296,10,1164.53,2,3,2,7,Regulars
28065,444,5,596.33,2,1,1,4,Hibernating
28066,1012,8,1608.87,1,2,3,6,Regulars
28067,209,6,953.01,3,1,2,6,Regulars
28068,377,16,1913.66,2,5,4,11,At Risk
28069,49,14,1540.9,5,5,3,13,Loyal
28070,12,11,3642.5800000000004,5,3,5,13,Loyal
28071,352,4,452.21,2,1,1,4,Hibernating
28072,150,15,1310.53,3,5,3,11,Regulars
28073,122,10,1636.7199999999998,4,3,3,10,Loyal
28074,64,10,3178.09,5,3,5,13,Loyal
28075,78,9,978.61,4,2,2,8,Regulars
28076,159,17,4068.92,3,5,5,13,Big Spenders
28077,318,11,1423.57,2,3,3,8,Regulars
28078,237,10,1056.13,3,3,2,8,Regulars
28079,352,8,978.58,2,2,2,6,Hibernating
28080,147,9,1501.28,4,2,3,9,Regulars
28081,130,13,2275.91,4,4,4,12,Champions
28082,23,11,2134.29,5,3,4,12,Loyal
28083,168,9,1639.6399999999999,3,2,3,8,Regulars
28084,178,15,1721.92,3,5,3,11,Regulars
28085,178,11,2942.69,3,3,5,11,Big Spenders
28086,188,13,3620.7,3,4,5,12,Big Spenders
28087,239,14,1644.49,3,5,3,11,Regulars
28088,76,9,589.34,4,2,1,7,Regulars
28089,1408,4,274.81,1,1,1,3,Hibernating
28090,214,11,5444.570000000001,3,3,5,11,Big Spenders
28091,618,11,2793.18,1,3,5,9,Regulars
28092,5,7,2324.05,5,1,4,10,Big Spenders
28093,44,12,3382.35,5,4,5,14,Champions
28094,54,11,1888.91,5,3,4,12,Loyal
28095,357,12,938.51,2,4,2,8,At Risk
28096,172,13,3624.83,3,4,5,12,Big Spenders
28097,173,13,1137.41,3,4,2,9,Regulars
28098,29,13,3520.95,5,4,5,14,Champions
28099,71,15,2647.9,4,5,5,14,Champions
28100,617,11,767.1,1,3,1,5,Regulars
28101,234,7,887.43,3,1,2,6,Regulars
28102,1182,6,768.54,1,1,1,3,Hibernating
28103,522,6,3607.71,1,1,5,7,Regulars
28104,20,15,5181.05,5,5,5,15,Champions
28105,130,11,1821.3999999999999,4,3,4,11,Loyal
28106,234,11,5073.52,3,3,5,11,Big Spenders
28107,1209,6,510.94,1,1,1,3,Hibernating
28108,477,7,261.03999999999996,1,1,1,3,Hibernating
28109,35,12,1679.74,5,4,3,12,Loyal
28110,305,11,2464.02,2,3,4,9,Regulars
28111,149,7,563.47,3,1,1,5,Regulars
28112,147,12,1417.09,4,4,3,11,Loyal
28113,449,5,520.58,2,1,1,4,Hibernating
28114,0,10,799.04,5,3,1,9,Loyal
28115,29,11,3836.6,5,3,5,13,Loyal
28116,665,12,865.22,1,4,2,7,At Risk
28117,31,19,2851.09,5,5,5,15,Champions
28118,326,9,922.26,2,2,2,6,Hibernating
28119,107,8,1043.7,4,2,2,8,Regulars
28120,177,12,899.0,3,4,2,9,Regulars
28121,166,9,1515.16,3,2,3,8,Regulars
28122,16,9,878.39,5,2,2,9,Regulars
28123,55,13,5064.1,5,4,5,14,Champions
28124,99,4,235.96999999999997,4,1,1,6,Regulars
28125,7,11,1268.5900000000001,5,3,3,11,Loyal
28126,49,15,2132.84,5,5,4,14,Champions
28127,448,13,2851.9199999999996,2,4,5,11,At Risk
28128,282,9,1684.76,2,2,3,7,Regulars
28129,76,8,634.79,4,2,1,7,Regulars
28130,252,6,837.34,2,1,1,4,Hibernating
28131,539,9,1249.6799999999998,1,2,3,6,Regulars
28132,120,11,4249.78,4,3,5,12,Loyal
28133,60,10,1391.37,5,3,3,11,Loyal
28134,0,14,1701.4099999999999,5,5,3,13,Loyal
28135,16,20,1897.59,5,5,4,14,Champions
28136,60,12,1406.55,5,4,3,12,Loyal
28137,404,7,1079.73,2,1,2,5,Hibernating
28138,346,9,1194.56,2,2,2,6,Hibernating
28139,175,4,191.7,3,1,1,5,Regulars
28140,526,12,1051.21,1,4,2,7,At Risk
28141,67,11,2751.3,4,3,5,12,Loyal
28142,112,15,3681.28,4,5,5,14,Champions
28143,438,10,3174.15,2,3,5,10,Regulars
28144,37,7,2521.37,5,1,4,10,Big Spenders
28145,104,6,1103.3300000000002,4,1,2,7,Regulars
28146,100,9,1002.27,4,2,2,8,Regulars
28147,216,11,925.32,3,3,2,8,Regulars
28148,309,9,1557.44,2,2,3,7,Regulars
28149,280,8,2946.39,2,2,5,9,Regulars
28150,116,12,489.40999999999997,4,4,1,9,Loyal
28151,453,15,1922.18,2,5,4,11,At Risk
28152,184,10,1406.83,3,3,3,9,Regulars
28153,32,13,1382.23,5,4,3,12,Loyal
28154,573,13,2893.38,1,4,5,10,At Risk
28155,997,10,2076.75,1,3,4,8,Regulars
28156,78,6,567.1899999999999,4,1,1,6,Regulars
28157,124,12,928.24,4,4,2,10,Loyal
28158,118,15,2078.79,4,5,4,13,Champions
28159,113,8,1023.9399999999999,4,2,2,8,Regulars
28160,411,9,1480.04,2,2,3,7,Regulars
28161,491,8,958.6100000000001,1,2,2,5,Hibernating
28162,244,10,1244.25,3,3,3,9,Regulars
28163,233,9,1292.4099999999999,3,2,3,8,Regulars
28164,245,11,1406.92,3,3,3,9,Regulars
28165,174,11,1152.4699999999998,3,3,2,8,Regulars
28166,162,5,2665.2,3,1,5,9,Big Spenders
28167,37,22,2573.31,5,5,4,14,Champions
28168,40,17,2953.1499999999996,5,5,5,15,Champions
28169,542,8,1428.8,1,2,3,6,Regulars
28170,228,9,711.51,3,2,1,6,Regulars
28171,878,5,575.6700000000001,1,1,1,3,Hibernating
28172,159,12,1203.6299999999999,3,4,2,9,Regulars
28173,248,6,323.3,2,1,1,4,Hibernating
28174,190,9,1646.42,3,2,3,8,Regulars
28175,108,8,1600.6599999999999,4,2,3,9,Regulars
28176,454,8,893.1200000000001,2,2,2,6,Hibernating
28177,246,10,1475.45,3,3,3,9,Regulars
28178,74,9,4290.08,4,2,5,11,Big Spenders
28179,892,6,1261.9699999999998,1,1,3,5,Regulars
28180,1047,5,102.32000000000001,1,1,1,3,Hibernating
28181,220,9,1054.56,3,2,2,7,Regulars
28182,445,11,1777.71,2,3,4,9,Regulars
28183,1201,6,279.66,1,1,1,3,Hibernating
28184,155,15,2288.74,3,5,4,12,Big Spenders
28185,70,9,1691.63,4,2,3,9,Regulars
28186,92,11,2384.83,4,3,4,11,Loyal
28187,1223,4,1093.23,1,1,2,4,Hibernating
28188,54,10,2654.94,5,3,5,13,Loyal
28189,69,7,1053.95,4,1,2,7,Regulars
28190,116,11,1761.85,4,3,4,11,Loyal
28191,6,7,1462.42,5,1,3,9,Regulars
28192,1284,6,390.64,1,1,1,3,Hibernating
28193,139,9,789.9300000000001,4,2,1,7,Regulars
28194,99,7,3152.22,4,1,5,10,Big Spenders
28195,49,7,2126.22,5,1,4,10,Big Spenders
28196,114,13,1318.67,4,4,3,11,Loyal
28197,234,9,1243.73,3,2,3,8,Regulars
28198,44,12,3022.5099999999998,5,4,5,14,Champions
28199,108,12,3533.2000000000003,4,4,5,13,Champions
28200,230,8,1895.2,3,2,4,9,Big Spenders
28201,75,7,562.92,4,1,1,6,Regulars
28202,701,8,1155.67,1,2,2,5,Hibernating
28203,523,10,711.35,1,3,1,5,Regulars
28204,430,10,1008.94,2,3,2,7,Regulars
28205,815,7,875.4200000000001,1,1,2,4,Hibernating
28206,15,10,1219.36,5,3,2,10,Loyal
28207,76,12,874.34,4,4,2,10,Loyal
28208,19,7,757.3600000000001,5,1,1,7,Regulars
28209,171,10,1485.3400000000001,3,3,3,9,Regulars
28210,23,8,985.8,5,2,2,9,Regulars
28211,291,6,807.8600000000001,2,1,1,4,Hibernating
28212,30,10,3111.6099999999997,5,3,5,13,Loyal
28213,35,14,3575.33,5,5,5,15,Champions
28214,155,8,1743.3999999999999,3,2,4,9,Big Spenders
28215,83,9,1700.57,4,2,3,9,Regulars
28216,426,8,2328.15,2,2,4,8,Regulars
28217,841,10,825.7,1,3,1,5,Regulars
28218,582,9,3977.45,1,2,5,8,Regulars
28219,6,15,1797.6599999999999,5,5,4,14,Champions
28220,111,11,3270.46,4,3,5,12,Loyal
28221,207,7,1539.3700000000001,3,1,3,7,Regulars
28222,164,12,1779.65,3,4,4,11,Big Spenders
28223,134,8,1730.35,4,2,4,10,Big Spenders
28224,345,12,1385.1100000000001,2,4,3,9,At Risk
28225,155,8,1524.56,3,2,3,8,Regulars
28226,217,5,353.59,3,1,1,5,Regulars
28227,180,7,800.54,3,1,1,5,Regulars
28228,163,9,1686.8999999999999,3,2,3,8,Regulars
28229,226,11,2297.06,3,3,4,10,Big Spenders
28230,380,16,5575.5,2,5,5,12,At Risk
28231,453,9,688.69,2,2,1,5,Hibernating
28232,86,10,4637.679999999999,4,3,5,12,Loyal
28233,536,5,493.59,1,1,1,3,Hibernating
28234,642,8,1398.92,1,2,3,6,Regulars
28235,1020,5,1594.7799999999997,1,1,3,5,Regulars
28236,42,15,1690.37,5,5,3,13,Loyal
28237,543,12,925.26,1,4,2,7,At Risk
28238,33,7,509.15,5,1,1,7,Regulars
28239,525,14,2355.02,1,5,4,10,At Risk
28240,65,12,4016.3,5,4,5,14,Champions
28241,681,7,431.8,1,1,1,3,Hibernating
28242,1039,7,3166.2200000000003,1,1,5,7,Regulars
28243,123,10,913.29,4,3,2,9,Loyal
28244,105,8,620.45,4,2,1,7,Regulars
28245,964,7,2595.1,1,1,5,7,Regulars
28246,847,11,4035.26,1,3,5,9,Regulars
28247,725,6,2972.1400000000003,1,1,5,7,Regulars
28248,258,11,1424.0,2,3,3,8,Regulars
28249,179,7,2847.8399999999997,3,1,5,9,Big Spenders
28250,761,8,1364.95,1,2,3,6,Regulars
28251,285,8,1213.1200000000001,2,2,2,6,Hibernating
28252,170,11,1046.18,3,3,2,8,Regulars
28253,431,8,823.41,2,2,1,5,Hibernating
28254,513,8,1537.81,1,2,3,6,Regulars
28255,470,11,1038.78,1,3,2,6,Regulars
28256,2,10,1209.42,5,3,2,10,Loyal
28257,35,9,649.15,5,2,1,8,Regulars
28258,122,10,949.4100000000001,4,3,2,9,Loyal
28259,98,8,368.27,4,2,1,7,Regulars
28260,1610,6,418.54,1,1,1,3,Hibernating
28261,247,12,1358.66,3,4,3,10,Regulars
28262,610,9,776.85,1,2,1,4,Hibernating
28263,279,8,537.87,2,2,1,5,Hibernating
28264,196,12,1314.05,3,4,3,10,Regulars
28265,275,11,1341.9,2,3,3,8,Regulars
28266,31,10,2770.17,5,3,5,13,Loyal
28267,272,10,2091.12,2,3,4,9,Regulars
28268,255,8,832.12,2,2,1,5,Hibernating
28269,166,9,959.14,3,2,2,7,Regulars
28270,193,8,1681.69,3,2,3,8,Regulars
28271,359,7,2459.49,2,1,4,7,Regulars
28272,441,8,1088.67,2,2,2,6,Hibernating
28273,180,11,484.1,3,3,1,7,Regulars
28274,1,8,1587.18,5,2,3,10,Regulars
28275,203,15,2121.67,3,5,4,12,Big Spenders
28276,31,9,940.7900000000001,5,2,2,9,Regulars
28277,161,9,2230.78,3,2,4,9,Big Spenders
28278,610,14,1398.6,1,5,3,9,At Risk
28279,839,12,2589.63,1,4,5,10,At Risk
28280,139,13,2325.1,4,4,4,12,Champions
28281,245,15,3354.81,3,5,5,13,Big Spenders
28282,595,10,2826.32,1,3,5,9,Regulars
28283,104,11,1535.66,4,3,3,10,Loyal
28284,152,8,878.87,3,2,2,7,Regulars
28285,156,6,1242.77,3,1,3,7,Regulars
28286,444,11,2035.32,2,3,4,9,Regulars
28287,683,15,5353.82,1,5,5,11,At Risk
28288,20,17,2141.55,5,5,4,14,Champions
28289,623,13,1849.87,1,4,4,9,At Risk
28290,177,11,2769.5299999999997,3,3,5,11,Big Spenders
28291,347,12,3068.45,2,4,5,11,At Risk
28292,292,9,788.19,2,2,1,5,Hibernating
28293,113,10,3358.79,4,3,5,12,Loyal
28294,151,14,2773.15,3,5,5,13,Big Spenders
28295,132,8,1047.49,4,2,2,8,Regulars
28296,217,11,1196.76,3,3,2,8,Regulars
28297,215,10,1595.8899999999999,3,3,3,9,Regulars
28298,662,6,700.5600000000001,1,1,1,3,Hibernating
28299,264,11,1657.1399999999999,2,3,3,8,Regulars
28300,645,6,900.33,1,1,2,4,Hibernating
28301,237,16,959.2,3,5,2,10,Regulars
28302,171,7,850.6299999999999,3,1,2,6,Regulars
28303,7,15,2140.95,5,5,4,14,Champions
28304,169,10,1604.11,3,3,3,9,Regulars
28305,202,13,2310.24,3,4,4,11,Big Spenders
28306,247,13,1377.97,3,4,3,10,Regulars
28307,392,8,840.0500000000001,2,2,1,5,Hibernating
28308,90,11,4178.67,4,3,5,12,Loyal
28309,139,12,1597.09,4,4,3,11,Loyal
28310,38,12,3491.04,5,4,5,14,Champions
28311,287,8,854.04,2,2,2,6,Hibernating
28312,216,13,1320.74,3,4,3,10,Regulars
28313,387,11,1458.94,2,3,3,8,Regulars
28314,135,8,2699.55,4,2,5,11,Big Spenders
28315,180,7,1374.0700000000002,3,1,3,7,Regulars
28316,560,11,5660.12,1,3,5,9,Regulars
28317,16,9,1064.57,5,2,2,9,Regulars
28318,446,7,1010.3499999999999,2,1,2,5,Hibernating
28319,115,10,3299.42,4,3,5,12,Loyal
28320,935,15,2922.13,1,5,5,11,At Risk
28321,320,9,2100.72,2,2,4,8,Regulars
28322,218,14,1674.3700000000001,3,5,3,11,Regulars
28323,121,7,956.9,4,1,2,7,Regulars
28324,346,13,2005.05,2,4,4,10,At Risk
28325,387,11,2778.88,2,3,5,10,Regulars
28326,177,10,1589.0,3,3,3,9,Regulars
28327,71,18,1857.8600000000001,4,5,4,13,Champions
28328,351,9,1648.03,2,2,3,7,Regulars
28329,17,12,3019.2400000000002,5,4,5,14,Champions
28330,296,13,2913.37,2,4,5,11,At Risk
28331,156,15,1159.9,3,5,2,10,Regulars
28332,364,10,1147.8,2,3,2,7,Regulars
28333,128,13,1087.41,4,4,2,10,Loyal
28334,538,9,1257.26,1,2,3,6,Regulars
28335,45,15,1692.46,5,5,3,13,Loyal
28336,644,9,1251.76,1,2,3,6,Regulars
28337,49,9,1093.94,5,2,2,9,Regulars
28338,209,11,1585.91,3,3,3,9,Regulars
28339,127,8,745.4399999999999,4,2,1,7,Regulars
28340,335,10,735.3,2,3,1,6,Regulars
28341,123,8,2163.2999999999997,4,2,4,10,Big Spenders
28342,201,14,1975.49,3,5,4,12,Big Spenders
28343,257,11,1333.56,2,3,3,8,Regulars
28344,163,11,2851.04,3,3,5,11,Big Spenders
28345,73,12,3425.0799999999995,4,4,5,13,Champions
28346,505,6,494.66,1,1,1,3,Hibernating
28347,1153,10,864.4300000000001,1,3,2,6,Regulars
28348,189,15,3931.84,3,5,5,13,Big Spenders
28349,21,12,1749.49,5,4,4,13,Champions
28350,127,9,1925.04,4,2,4,10,Big Spenders
28351,193,7,979.85,3,1,2,6,Regulars
28352,12,7,570.99,5,1,1,7,Regulars
28353,391,11,1089.6000000000001,2,3,2,7,Regulars
28354,621,6,1065.27,1,1,2,4,Hibernating
28355,236,12,1307.82,3,4,3,10,Regulars
28356,668,12,1630.3600000000001,1,4,3,8,At Risk
28357,728,9,1158.02,1,2,2,5,Hibernating
28358,37,15,4939.36,5,5,5,15,Champions
28359,26,6,1086.94,5,1,2,8,Regulars
28360,132,7,1537.11,4,1,3,8,Regulars
28361,419,10,1639.72,2,3,3,8,Regulars
28362,338,6,610.6,2,1,1,4,Hibernating
28363,595,13,1173.9,1,4,2,7,At Risk
28364,276,6,983.17,2,1,2,5,Hibernating
28365,65,7,917.5,5,1,2,8,Regulars
28366,344,10,3072.57,2,3,5,10,Regulars
28367,291,8,1042.34,2,2,2,6,Hibernating
28368,220,10,1171.52,3,3,2,8,Regulars
28369,333,11,3420.58,2,3,5,10,Regulars
28370,214,16,4948.54,3,5,5,13,Big Spenders
28371,135,13,1881.79,4,4,4,12,Champions
28372,18,18,3019.92,5,5,5,15,Champions
28373,14,13,1447.08,5,4,3,12,Loyal
28374,849,7,567.97,1,1,1,3,Hibernating
28375,18,9,2812.58,5,2,5,12,Big Spenders
28376,5,10,851.5799999999999,5,3,2,10,Loyal
28377,82,20,2419.63,4,5,4,13,Champions
28378,260,16,2858.4399999999996,2,5,5,12,At Risk
28379,119,14,2403.27,4,5,4,13,Champions
28380,521,13,1629.02,1,4,3,8,At Risk
28381,175,11,1811.9499999999998,3,3,4,10,Big Spenders
28382,686,8,928.62,1,2,2,5,Hibernating
28383,37,11,1364.19,5,3,3,11,Loyal
28384,936,10,635.0,1,3,1,5,Regulars
28385,23,10,2448.93,5,3,4,12,Loyal
28386,125,10,1697.0,4,3,3,10,Loyal
28387,40,14,2517.17,5,5,4,14,Champions
28388,37,4,1122.83,5,1,2,8,Regulars
28389,48,9,2788.2999999999997,5,2,5,12,Big Spenders
28390,45,17,3754.37,5,5,5,15,Champions
28391,638,13,2058.42,1,4,4,9,At Risk
28392,247,12,1998.6200000000001,3,4,4,11,Big Spenders
28393,18,14,2603.0099999999998,5,5,5,15,Champions
28394,155,17,1750.63,3,5,4,12,Big Spenders
28395,366,9,987.36,2,2,2,6,Hibernating
28396,326,10,932.52,2,3,2,7,Regulars
28397,261,6,603.8199999999999,2,1,1,4,Hibernating
28398,229,8,1012.57,3,2,2,7,Regulars
28399,91,12,3144.2,4,4,5,13,Champions
28400,216,9,748.52,3,2,1,6,Regulars
28401,120,13,2974.43,4,4,5,13,Champions
28402,21,15,2148.1800000000003,5,5,4,14,Champions
28403,14,16,1787.04,5,5,4,14,Champions
28404,2,16,2202.42,5,5,4,14,Champions
28405,12,11,1309.32,5,3,3,11,Loyal
28406,441,12,1987.85,2,4,4,10,At Risk
28407,213,10,1103.8600000000001,3,3,2,8,Regulars
28408,361,9,956.53,2,2,2,6,Hibernating
28409,283,9,1556.01,2,2,3,7,Regulars
28410,160,9,1190.4,3,2,2,7,Regulars
28411,372,10,670.54,2,3,1,6,Regulars
28412,502,6,916.17,1,1,2,4,Hibernating
28413,267,14,1797.75,2,5,4,11,At Risk
28414,50,9,909.3500000000001,5,2,2,9,Regulars
28415,148,12,1995.8099999999997,3,4,4,11,Big Spenders
28416,85,15,1553.6100000000001,4,5,3,12,Loyal
28417,699,6,1143.3200000000002,1,1,2,4,Hibernating
28418,546,11,1414.1100000000001,1,3,3,7,Regulars
28419,140,12,1782.62,4,4,4,12,Champions
28420,321,14,1671.83,2,5,3,10,At Risk
28421,21,6,1369.46,5,1,3,9,Regulars
28422,286,15,2437.64,2,5,4,11,At Risk
28423,348,12,841.05,2,4,1,7,At Risk
28424,304,11,3544.28,2,3,5,10,Regulars
28425,25,11,3531.5,5,3,5,13,Loyal
28426,132,8,2657.21,4,2,5,11,Big Spenders
28427,255,7,914.4000000000001,2,1,2,5,Hibernating
28428,561,11,696.26,1,3,1,5,Regulars
28429,3,9,657.9200000000001,5,2,1,8,Regulars
28430,41,10,1808.5100000000002,5,3,4,12,Loyal
28431,164,17,3352.73,3,5,5,13,Big Spenders
28432,167,12,2136.56,3,4,4,11,Big Spenders
28433,211,9,3262.24,3,2,5,10,Big Spenders
28434,222,11,1971.0700000000002,3,3,4,10,Big Spenders
28435,1139,5,300.48,1,1,1,3,Hibernating
28436,480,10,2998.81,1,3,5,9,Regulars
28437,137,10,865.16,4,3,2,9,Loyal
28438,19,20,2480.26,5,5,4,14,Champions
28439,121,16,1703.58,4,5,3,12,Loyal
28440,439,13,3026.82,2,4,5,11,At Risk
28441,31,12,912.53,5,4,2,11,Loyal
28442,83,8,1099.38,4,2,2,8,Regulars
28443,580,14,1422.51,1,5,3,9,At Risk
28444,610,7,925.5999999999999,1,1,2,4,Hibernating
28445,186,14,3862.22,3,5,5,13,Big Spenders
28446,998,9,2479.02,1,2,4,7,Regulars
28447,180,12,2572.16,3,4,4,11,Big Spenders
28448,602,11,1313.55,1,3,3,7,Regulars
28449,66,10,3176.87,4,3,5,12,Loyal
28450,161,12,1823.04,3,4,4,11,Big Spenders
28451,5,8,1082.15,5,2,2,9,Regulars
28452,56,15,2563.84,5,5,4,14,Champions
28453,143,10,1140.37,4,3,2,9,Loyal
28454,225,11,1261.48,3,3,3,9,Regulars
28455,208,6,724.3900000000001,3,1,1,5,Regulars
28456,810,13,1982.6200000000001,1,4,4,9,At Risk
28457,178,11,1574.22,3,3,3,9,Regulars
28458,204,12,1614.6,3,4,3,10,Regulars
28459,203,13,5229.53,3,4,5,12,Big Spenders
28460,122,13,3647.2700000000004,4,4,5,13,Champions
28461,34,11,1321.13,5,3,3,11,Loyal
28462,487,12,1040.44,1,4,2,7,At Risk
28463,30,8,1188.8200000000002,5,2,2,9,Regulars
28464,797,12,1378.55,1,4,3,8,At Risk
28465,182,7,2202.89,3,1,4,8,Big Spenders
28466,222,12,2600.88,3,4,5,12,Big Spenders
28467,92,14,3981.2,4,5,5,14,Champions
28468,467,9,952.55,1,2,2,5,Hibernating
28469,256,8,1106.84,2,2,2,6,Hibernating
28470,89,9,1416.36,4,2,3,9,Regulars
28471,492,13,3348.42,1,4,5,10,At Risk
28472,202,11,2664.4900000000002,3,3,5,11,Big Spenders
28473,154,8,446.33,3,2,1,6,Regulars
28474,110,12,982.8299999999999,4,4,2,10,Loyal
28475,214,8,2348.07,3,2,4,9,Big Spenders
28476,1001,6,1035.4,1,1,2,4,Hibernating
28477,45,7,479.39,5,1,1,7,Regulars
28478,634,13,2434.1099999999997,1,4,4,9,At Risk
28479,55,8,1745.3500000000001,5,2,4,11,Big Spenders
28480,90,8,714.91,4,2,1,7,Regulars
28481,122,6,2131.37,4,1,4,9,Big Spenders
28482,502,10,2252.46,1,3,4,8,Regulars
28483,101,11,2236.5,4,3,4,11,Loyal
28484,30,18,4618.21,5,5,5,15,Champions
28485,183,10,1345.1,3,3,3,9,Regulars
28486,85,13,3193.3100000000004,4,4,5,13,Champions
28487,573,11,872.46,1,3,2,6,Regulars
28488,64,6,518.5799999999999,5,1,1,7,Regulars
28489,91,11,2434.0099999999998,4,3,4,11,Loyal
28490,46,12,2246.91,5,4,4,13,Champions
28491,283,9,930.21,2,2,2,6,Hibernating
28492,60,8,836.84,5,2,1,8,Regulars
28493,831,6,962.39,1,1,2,4,Hibernating
28494,0,11,1906.08,5,3,4,12,Loyal
28495,318,6,1858.47,2,1,4,7,Regulars
28496,175,11,695.26,3,3,1,7,Regulars
28497,2,10,2920.98,5,3,5,13,Loyal
28498,187,12,1810.5700000000002,3,4,4,11,Big Spenders
28499,434,10,922.4699999999999,2,3,2,7,Regulars
28500,177,8,565.92,3,2,1,6,Regulars
28501,281,15,3201.6499999999996,2,5,5,12,At Risk
28502,139,9,941.4199999999998,4,2,2,8,Regulars
28503,195,7,1596.9299999999998,3,1,3,7,Regulars
28504,473,6,916.15,1,1,2,4,Hibernating
28505,182,7,1421.36,3,1,3,7,Regulars
28506,179,13,1390.53,3,4,3,10,Regulars
28507,85,9,848.75,4,2,2,8,Regulars
28508,30,14,2334.94,5,5,4,14,Champions
28509,218,12,1157.51,3,4,2,9,Regulars
28510,590,7,1534.6,1,1,3,5,Regulars
28511,881,7,738.97,1,1,1,3,Hibernating
28512,389,10,1984.0,2,3,4,9,Regulars
28513,141,11,1822.28,4,3,4,11,Loyal
28514,128,10,2300.0099999999998,4,3,4,11,Loyal
28515,342,6,724.5899999999999,2,1,1,4,Hibernating
28516,223,12,3145.77,3,4,5,12,Big Spenders
28517,8,11,2700.06,5,3,5,13,Loyal
28518,237,6,2608.58,3,1,5,9,Big Spenders
28519,330,9,1093.91,2,2,2,6,Hibernating
28520,209,16,2284.82,3,5,4,12,Big Spenders
28521,408,8,1307.3700000000001,2,2,3,7,Regulars
28522,475,16,2581.24,1,5,5,11,At Risk
28523,74,8,2339.48,4,2,4,10,Big Spenders
28524,203,10,1464.89,3,3,3,9,Regulars
28525,255,11,2115.68,2,3,4,9,Regulars
28526,432,10,2383.2799999999997,2,3,4,9,Regulars
28527,38,16,6228.5599999999995,5,5,5,15,Champions
28528,440,12,1705.71,2,4,3,9,At Risk
28529,149,13,662.35,3,4,1,8,Regulars
28530,78,9,1169.62,4,2,2,8,Regulars
28531,51,13,1959.93,5,4,4,13,Champions
28532,271,8,1508.16,2,2,3,7,Regulars
28533,181,14,2496.69,3,5,4,12,Big Spenders
28534,21,13,2240.57,5,4,4,13,Champions
28535,296,7,723.54,2,1,1,4,Hibernating
28536,149,5,675.29,3,1,1,5,Regulars
28537,297,12,2272.33,2,4,4,10,At Risk
28538,56,8,651.73,5,2,1,8,Regulars
28539,25,15,3136.97,5,5,5,15,Champions
28540,357,12,2369.3999999999996,2,4,4,10,At Risk
28541,261,8,861.49,2,2,2,6,Hibernating
28542,487,8,507.43,1,2,1,4,Hibernating
28543,92,18,4385.13,4,5,5,14,Champions
28544,661,5,819.34,1,1,1,3,Hibernating
28545,145,14,2392.42,4,5,4,13,Champions
28546,18,10,656.71,5,3,1,9,Loyal
28547,262,11,1932.2600000000002,2,3,4,9,Regulars
28548,195,8,2826.21,3,2,5,10,Big Spenders
28549,12,16,2871.61,5,5,5,15,Champions
28550,268,7,382.23,2,1,1,4,Hibernating
28551,1330,8,1256.05,1,2,3,6,Regulars
28552,553,9,1737.89,1,2,4,7,Regulars
28553,1037,2,62.97,1,1,1,3,Hibernating
28554,660,7,723.47,1,1,1,3,Hibernating
28555,519,11,2161.87,1,3,4,8,Regulars
28556,494,9,1486.44,1,2,3,6,Regulars
28557,193,8,1061.19,3,2,2,7,Regulars
28558,50,10,3408.8300000000004,5,3,5,13,Loyal
28559,452,10,1208.32,2,3,2,7,Regulars
28560,675,8,359.97,1,2,1,4,Hibernating
28561,405,5,320.38,2,1,1,4,Hibernating
28562,312,11,2729.84,2,3,5,10,Regulars
28563,31,13,4588.62,5,4,5,14,Champions
28564,50,9,3684.9,5,2,5,12,Big Spenders
28565,219,11,1044.8,3,3,2,8,Regulars
28566,421,9,668.06,2,2,1,5,Hibernating
28567,284,7,647.8199999999999,2,1,1,4,Hibernating
28568,565,5,1117.3899999999999,1,1,2,4,Hibernating
28569,149,10,2785.8100000000004,3,3,5,11,Big Spenders
28570,35,7,1473.32,5,1,3,9,Regulars
28571,172,11,4899.6,3,3,5,11,Big Spenders
28572,96,8,1614.78,4,2,3,9,Regulars
28573,173,9,1873.95,3,2,4,9,Big Spenders
28574,215,9,526.41,3,2,1,6,Regulars
28575,128,8,1597.78,4,2,3,9,Regulars
28576,733,3,193.44,1,1,1,3,Hibernating
28577,154,8,609.04,3,2,1,6,Regulars
28578,163,12,1502.52,3,4,3,10,Regulars
28579,228,5,1971.79,3,1,4,8,Big Spenders
28580,99,12,2768.06,4,4,5,13,Champions
28581,216,4,572.17,3,1,1,5,Regulars
28582,156,8,1293.37,3,2,3,8,Regulars
28583,446,9,3065.9,2,2,5,9,Regulars
28584,626,9,2756.61,1,2,5,8,Regulars
28585,152,10,4148.33,3,3,5,11,Big Spenders
28586,26,13,1540.45,5,4,3,12,Loyal
28587,14,9,737.21,5,2,1,8,Regulars
28588,310,15,2863.88,2,5,5,12,At Risk
28589,557,10,1146.84,1,3,2,6,Regulars
28590,549,4,146.98999999999998,1,1,1,3,Hibernating
28591,369,15,3603.3399999999997,2,5,5,12,At Risk
28592,172,14,2277.21,3,5,4,12,Big Spenders
28593,115,8,2169.7000000000003,4,2,4,10,Big Spenders
28594,608,7,1749.31,1,1,4,6,Regulars
28595,194,11,5392.44,3,3,5,11,Big Spenders
28596,616,5,371.89,1,1,1,3,Hibernating
28597,65,9,1380.87,5,2,3,10,Regulars
28598,108,15,4338.29,4,5,5,14,Champions
28599,172,7,996.63,3,1,2,6,Regulars
28600,125,10,1575.46,4,3,3,10,Loyal
28601,505,11,1415.0000000000002,1,3,3,7,Regulars
28602,246,12,3186.84,3,4,5,12,Big Spenders
28603,48,12,2310.0699999999997,5,4,4,13,Champions
28604,487,15,2952.86,1,5,5,11,At Risk
28605,184,9,1201.9199999999998,3,2,2,7,Regulars
28606,497,7,308.08000000000004,1,1,1,3,Hibernating
28607,497,10,1524.37,1,3,3,7,Regulars
28608,833,6,1136.5,1,1,2,4,Hibernating
28609,124,13,1547.55,4,4,3,11,Loyal
28610,311,11,683.3000000000001,2,3,1,6,Regulars
28611,123,16,1700.89,4,5,3,12,Loyal
28612,268,4,742.4,2,1,1,4,Hibernating
28613,1046,7,1221.15,1,1,2,4,Hibernating
28614,77,11,3243.35,4,3,5,12,Loyal
28615,445,10,1562.15,2,3,3,8,Regulars
28616,350,10,3174.57,2,3,5,10,Regulars
28617,217,13,1875.65,3,4,4,11,Big Spenders
28618,160,10,1187.47,3,3,2,8,Regulars
28619,306,10,2788.54,2,3,5,10,Regulars
28620,124,13,1283.76,4,4,3,11,Loyal
28621,216,7,649.91,3,1,1,5,Regulars
28622,31,7,924.57,5,1,2,8,Regulars
28623,35,12,853.74,5,4,2,11,Loyal
28624,14,11,1642.82,5,3,3,11,Loyal
28625,322,10,2228.0,2,3,4,9,Regulars
28626,296,12,2733.1400000000003,2,4,5,11,At Risk
28627,61,14,3281.06,5,5,5,15,Champions
28628,564,8,2401.11,1,2,4,7,Regulars
28629,204,14,1649.79,3,5,3,11,Regulars
28630,519,10,1596.93,1,3,3,7,Regulars
28631,263,10,1557.71,2,3,3,8,Regulars
28632,187,10,1674.87,3,3,3,9,Regulars
28633,409,9,3532.86,2,2,5,9,Regulars
28634,170,9,681.98,3,2,1,6,Regulars
28635,305,10,857.06,2,3,2,7,Regulars
28636,1090,5,349.65,1,1,1,3,Hibernating
28637,105,14,1509.34,4,5,3,12,Loyal
28638,173,10,1681.6399999999999,3,3,3,9,Regulars
28639,347,12,1767.12,2,4,4,10,At Risk
28640,80,10,1304.34,4,3,3,10,Loyal
28641,10,7,763.89,5,1,1,7,Regulars
28642,89,10,1768.51,4,3,4,11,Loyal
28643,7,7,2106.04,5,1,4,10,Big Spenders
28644,99,16,4107.17,4,5,5,14,Champions
28645,296,9,1753.6799999999998,2,2,4,8,Regulars
28646,238,7,1425.85,3,1,3,7,Regulars
28647,199,14,4788.9,3,5,5,13,Big Spenders
28648,8,7,464.21000000000004,5,1,1,7,Regulars
28649,768,8,1184.26,1,2,2,5,Hibernating
28650,38,16,2791.33,5,5,5,15,Champions
28651,65,9,1328.23,5,2,3,10,Regulars
28652,630,13,3557.79,1,4,5,10,At Risk
28653,189,9,1951.53,3,2,4,9,Big Spenders
28654,249,10,792.1,2,3,1,6,Regulars
28655,71,11,794.49,4,3,1,8,Loyal
28656,1110,9,2508.51,1,2,4,7,Regulars
28657,337,10,1215.0100000000002,2,3,2,7,Regulars
28658,189,12,1198.3899999999999,3,4,2,9,Regulars
28659,239,7,4640.88,3,1,5,9,Big Spenders
28660,129,17,7282.39,4,5,5,14,Champions
28661,465,9,1575.2800000000002,1,2,3,6,Regulars
28662,354,12,1275.71,2,4,3,9,At Risk
28663,75,15,1482.71,4,5,3,12,Loyal
28664,373,15,5751.889999999999,2,5,5,12,At Risk
28665,194,11,1265.19,3,3,3,9,Regulars
28666,64,18,2906.9300000000003,5,5,5,15,Champions
28667,208,6,1955.04,3,1,4,8,Big Spenders
28668,201,15,4707.8099999999995,3,5,5,13,Big Spenders
28669,139,9,988.08,4,2,2,8,Regulars
28670,579,7,525.95,1,1,1,3,Hibernating
28671,258,8,846.15,2,2,2,6,Hibernating
28672,95,6,3435.5099999999998,4,1,5,10,Big Spenders
28673,382,11,1864.55,2,3,4,9,Regulars
28674,182,16,1247.59,3,5,3,11,Regulars
28675,50,12,1689.56,5,4,3,12,Loyal
28676,48,11,2663.18,5,3,5,13,Loyal
28677,323,5,435.94,2,1,1,4,Hibernating
28678,127,13,2744.29,4,4,5,13,Champions
28679,286,11,1793.42,2,3,4,9,Regulars
28680,22,12,2745.15,5,4,5,14,Champions
28681,70,5,1019.0699999999999,4,1,2,7,Regulars
28682,20,10,2989.43,5,3,5,13,Loyal
28683,134,9,920.73,4,2,2,8,Regulars
28684,681,7,740.54,1,1,1,3,Hibernating
28685,178,12,3369.13,3,4,5,12,Big Spenders
28686,268,15,3258.54,2,5,5,12,At Risk
28687,220,10,1526.2399999999998,3,3,3,9,Regulars
28688,266,9,1039.07,2,2,2,6,Hibernating
28689,300,7,2725.3900000000003,2,1,5,8,Regulars
28690,194,10,2164.84,3,3,4,10,Big Spenders
28691,497,13,962.76,1,4,2,7,At Risk
28692,170,17,2055.21,3,5,4,12,Big Spenders
28693,713,8,1995.74,1,2,4,7,Regulars
28694,164,14,4078.21,3,5,5,13,Big Spenders
28695,220,9,1247.93,3,2,3,8,Regulars
28696,203,8,1496.55,3,2,3,8,Regulars
28697,313,8,666.3299999999999,2,2,1,5,Hibernating
28698,737,6,513.36,1,1,1,3,Hibernating
28699,65,9,1566.9299999999998,5,2,3,10,Regulars
28700,6,11,949.27,5,3,2,10,Loyal
28701,117,14,3948.19,4,5,5,14,Champions
28702,2469,2,165.88,1,1,1,3,Hibernating
28703,232,10,1223.6100000000001,3,3,2,8,Regulars
28704,167,8,1086.96,3,2,2,7,Regulars
28705,202,9,1530.9299999999998,3,2,3,8,Regulars
28706,546,11,3381.29,1,3,5,9,Regulars
28707,0,26,2434.04,5,5,4,14,Champions
28708,547,7,589.28,1,1,1,3,Hibernating
28709,342,8,1648.0199999999998,2,2,3,7,Regulars
28710,490,8,839.68,1,2,1,4,Hibernating
28711,313,5,906.4300000000001,2,1,2,5,Hibernating
28712,111,13,1548.13,4,4,3,11,Loyal
28713,122,9,3435.5299999999997,4,2,5,11,Big Spenders
28714,362,10,851.77,2,3,2,7,Regulars
28715,90,13,2839.4,4,4,5,13,Champions
28716,327,12,4097.0,2,4,5,11,At Risk
28717,180,12,2557.8199999999997,3,4,4,11,Big Spenders
28718,180,13,2559.88,3,4,4,11,Big Spenders
28719,194,8,957.1399999999999,3,2,2,7,Regulars
28720,175,10,1694.83,3,3,3,9,Regulars
28721,156,9,555.51,3,2,1,6,Regulars
28722,132,10,2487.42,4,3,4,11,Loyal
28723,171,10,548.57,3,3,1,7,Regulars
28724,179,17,1878.54,3,5,4,12,Big Spenders
28725,2,11,862.8199999999999,5,3,2,10,Loyal
28726,564,10,1799.79,1,3,4,8,Regulars
28727,842,10,3841.7900000000004,1,3,5,9,Regulars
28728,79,14,1307.46,4,5,3,12,Loyal
28729,210,7,971.4100000000001,3,1,2,6,Regulars
28730,215,11,1985.35,3,3,4,10,Big Spenders
28731,3,11,2069.31,5,3,4,12,Loyal
28732,85,12,4101.0199999999995,4,4,5,13,Champions
28733,71,15,3550.84,4,5,5,14,Champions
28734,95,14,4450.32,4,5,5,14,Champions
28735,368,7,1089.1399999999999,2,1,2,5,Hibernating
28736,47,8,523.08,5,2,1,8,Regulars
28737,97,13,1866.54,4,4,4,12,Champions
28738,15,15,4939.450000000001,5,5,5,15,Champions
28739,23,11,1698.6000000000001,5,3,3,11,Loyal
28740,420,9,2024.69,2,2,4,8,Regulars
28741,426,6,605.39,2,1,1,4,Hibernating
28742,509,8,1068.94,1,2,2,5,Hibernating
28743,67,21,5793.85,4,5,5,14,Champions
28744,114,13,2174.02,4,4,4,12,Champions
28745,238,12,2593.9,3,4,5,12,Big Spenders
28746,46,12,2091.7599999999998,5,4,4,13,Champions
28747,8,9,4312.22,5,2,5,12,Big Spenders
28748,867,7,1733.6100000000001,1,1,4,6,Regulars
28749,95,14,2335.0499999999997,4,5,4,13,Champions
28750,235,11,741.8,3,3,1,7,Regulars
28751,102,11,4726.91,4,3,5,12,Loyal
28752,24,10,2212.21,5,3,4,12,Loyal
28753,682,11,1179.81,1,3,2,6,Regulars
28754,195,8,1485.81,3,2,3,8,Regulars
28755,107,11,1213.48,4,3,2,9,Loyal
28756,752,5,658.12,1,1,1,3,Hibernating
28757,245,10,1923.68,3,3,4,10,Big Spenders
28758,119,12,1464.35,4,4,3,11,Loyal
28759,461,11,948.89,1,3,2,6,Regulars
28760,307,10,3040.17,2,3,5,10,Regulars
28761,15,14,1247.05,5,5,3,13,Loyal
28762,23,9,562.27,5,2,1,8,Regulars
28763,446,7,2266.53,2,1,4,7,Regulars
28764,24,11,1580.22,5,3,3,11,Loyal
28765,372,8,1007.46,2,2,2,6,Hibernating
28766,130,10,2965.8199999999997,4,3,5,12,Loyal
28767,692,6,215.83,1,1,1,3,Hibernating
28768,127,7,551.96,4,1,1,6,Regulars
28769,386,10,3441.86,2,3,5,10,Regulars
28770,275,9,999.67,2,2,2,6,Hibernating
28771,134,18,4571.610000000001,4,5,5,14,Champions
28772,154,10,2710.4,3,3,5,11,Big Spenders
28773,134,13,1093.67,4,4,2,10,Loyal
28774,166,9,2422.6,3,2,4,9,Big Spenders
28775,221,7,983.48,3,1,2,6,Regulars
28776,342,14,1612.87,2,5,3,10,At Risk
28777,480,11,1878.0099999999998,1,3,4,8,Regulars
28778,568,9,3279.0699999999997,1,2,5,8,Regulars
28779,103,11,1151.42,4,3,2,9,Loyal
28780,30,15,3307.23,5,5,5,15,Champions
28781,73,12,2869.65,4,4,5,13,Champions
28782,152,14,1241.84,3,5,3,11,Regulars
28783,99,18,3690.75,4,5,5,14,Champions
28784,245,15,4632.32,3,5,5,13,Big Spenders
28785,305,13,1634.51,2,4,3,9,At Risk
28786,35,13,4510.61,5,4,5,14,Champions
28787,79,12,2662.28,4,4,5,13,Champions
28788,1271,3,148.02,1,1,1,3,Hibernating
28789,34,11,964.9200000000001,5,3,2,10,Loyal
28790,203,8,3043.0600000000004,3,2,5,10,Big Spenders
28791,665,4,220.29,1,1,1,3,Hibernating
28792,31,11,989.99,5,3,2,10,Loyal
28793,317,10,2483.87,2,3,4,9,Regulars
28794,120,12,3198.11,4,4,5,13,Champions
28795,349,9,2959.0299999999997,2,2,5,9,Regulars
28796,289,11,3362.28,2,3,5,10,Regulars
28797,13,12,1115.4099999999999,5,4,2,11,Loyal
28798,8,9,2667.38,5,2,5,12,Big Spenders
28799,68,8,606.1,4,2,1,7,Regulars
28800,82,10,938.0,4,3,2,9,Loyal
28801,222,16,2309.0299999999997,3,5,4,12,Big Spenders
28802,125,14,984.95,4,5,2,11,Loyal
28803,125,8,2489.5,4,2,4,10,Big Spenders
28804,494,7,1991.01,1,1,4,6,Regulars
28805,710,9,898.3299999999999,1,2,2,5,Hibernating
28806,143,13,1425.04,4,4,3,11,Loyal
28807,268,8,2594.71,2,2,5,9,Regulars
28808,528,10,3769.9299999999994,1,3,5,9,Regulars
28809,428,7,650.62,2,1,1,4,Hibernating
28810,94,22,6013.52,4,5,5,14,Champions
28811,90,14,1793.32,4,5,4,13,Champions
28812,239,5,955.1700000000001,3,1,2,6,Regulars
28813,9,13,1708.26,5,4,3,12,Loyal
28814,611,12,1672.1499999999999,1,4,3,8,At Risk
28815,29,12,1641.2,5,4,3,12,Loyal
28816,131,9,3555.3900000000003,4,2,5,11,Big Spenders
28817,99,10,1360.81,4,3,3,10,Loyal
28818,128,14,3216.94,4,5,5,14,Champions
28819,593,8,1340.8999999999999,1,2,3,6,Regulars
28820,33,11,1425.23,5,3,3,11,Loyal
28821,49,9,886.94,5,2,2,9,Regulars
28822,151,15,3729.51,3,5,5,13,Big Spenders
28823,56,12,1232.76,5,4,2,11,Loyal
28824,29,13,1099.53,5,4,2,11,Loyal
28825,88,13,1355.98,4,4,3,11,Loyal
28826,74,8,2910.15,4,2,5,11,Big Spenders
28827,248,16,4612.48,2,5,5,12,At Risk
28828,724,6,526.9399999999999,1,1,1,3,Hibernating
28829,333,16,1550.46,2,5,3,10,At Risk
28830,58,15,3186.7999999999997,5,5,5,15,Champions
28831,10,15,4991.75,5,5,5,15,Champions
28832,260,11,921.89,2,3,2,7,Regulars
28833,278,6,1154.85,2,1,2,5,Hibernating
28834,679,7,298.27,1,1,1,3,Hibernating
28835,225,12,2014.04,3,4,4,11,Big Spenders
28836,109,15,1693.17,4,5,3,12,Loyal
28837,355,9,1091.17,2,2,2,6,Hibernating
28838,110,9,1243.26,4,2,3,9,Regulars
28839,821,9,671.89,1,2,1,4,Hibernating
28840,124,7,1569.58,4,1,3,8,Regulars
28841,430,13,1384.65,2,4,3,9,At Risk
28842,453,11,3197.3,2,3,5,10,Regulars
28843,140,10,1393.8400000000001,4,3,3,10,Loyal
28844,348,5,340.98,2,1,1,4,Hibernating
28845,602,11,2897.96,1,3,5,9,Regulars
28846,43,9,2835.63,5,2,5,12,Big Spenders
28847,40,6,641.11,5,1,1,7,Regulars
28848,220,10,1404.8600000000001,3,3,3,9,Regulars
28849,469,17,1883.9299999999998,1,5,4,10,At Risk
28850,387,10,3361.34,2,3,5,10,Regulars
28851,361,9,491.4,2,2,1,5,Hibernating
28852,49,14,3061.01,5,5,5,15,Champions
28853,640,4,173.06,1,1,1,3,Hibernating
28854,118,9,1197.58,4,2,2,8,Regulars
28855,847,11,1811.0,1,3,4,8,Regulars
28856,10,11,2179.97,5,3,4,12,Loyal
28857,534,12,1146.98,1,4,2,7,At Risk
28858,458,15,3909.61,2,5,5,12,At Risk
28859,179,10,3432.4999999999995,3,3,5,11,Big Spenders
28860,130,8,1563.63,4,2,3,9,Regulars
28861,47,14,1981.99,5,5,4,14,Champions
28862,122,6,387.14,4,1,1,6,Regulars
28863,36,11,4447.06,5,3,5,13,Loyal
28864,21,8,879.7600000000001,5,2,2,9,Regulars
28865,946,10,2825.12,1,3,5,9,Regulars
28866,71,21,3410.42,4,5,5,14,Champions
28867,520,10,843.8100000000001,1,3,1,5,Regulars
28868,302,16,1939.72,2,5,4,11,At Risk
28869,1191,8,1378.17,1,2,3,6,Regulars
28870,615,9,1239.3100000000002,1,2,2,5,Hibernating
28871,306,15,2051.7,2,5,4,11,At Risk
28872,31,8,1138.76,5,2,2,9,Regulars
28873,288,5,5451.81,2,1,5,8,Regulars
28874,232,13,1040.53,3,4,2,9,Regulars
28875,85,15,1237.79,4,5,2,11,Loyal
28876,124,11,1560.32,4,3,3,10,Loyal
28877,68,10,1148.45,4,3,2,9,Loyal
28878,538,8,853.44,1,2,2,5,Hibernating
28879,155,10,1032.69,3,3,2,8,Regulars
28880,326,7,1119.97,2,1,2,5,Hibernating
28881,248,8,1084.35,2,2,2,6,Hibernating
28882,337,11,836.05,2,3,1,6,Regulars
28883,198,13,3286.53,3,4,5,12,Big Spenders
28884,282,13,1807.6899999999998,2,4,4,10,At Risk
28885,84,11,4570.240000000001,4,3,5,12,Loyal
28886,144,15,1522.54,4,5,3,12,Loyal
28887,53,17,2124.19,5,5,4,14,Champions
28888,1001,8,2127.75,1,2,4,7,Regulars
28889,531,12,1531.74,1,4,3,8,At Risk
28890,184,10,1281.28,3,3,3,9,Regulars
28891,491,11,1115.39,1,3,2,6,Regulars
28892,21,11,2050.96,5,3,4,12,Loyal
28893,121,14,1263.51,4,5,3,12,Loyal
28894,249,7,2452.11,2,1,4,7,Regulars
28895,272,10,1127.9199999999998,2,3,2,7,Regulars
28896,17,15,3094.0,5,5,5,15,Champions
28897,286,9,2121.52,2,2,4,8,Regulars
28898,180,10,2106.04,3,3,4,10,Big Spenders
28899,74,17,4013.72,4,5,5,14,Champions
28900,33,15,2910.98,5,5,5,15,Champions
28901,209,8,624.79,3,2,1,6,Regulars
28902,129,16,7040.44,4,5,5,14,Champions
28903,432,6,598.05,2,1,1,4,Hibernating
28904,518,10,1249.77,1,3,3,7,Regulars
28905,45,10,1432.53,5,3,3,11,Loyal
28906,83,9,1327.89,4,2,3,9,Regulars
28907,333,9,1197.46,2,2,2,6,Hibernating
28908,333,6,2819.7299999999996,2,1,5,8,Regulars
28909,65,13,2442.73,5,4,4,13,Champions
28910,202,15,1989.24,3,5,4,12,Big Spenders
28911,96,10,1322.42,4,3,3,10,Loyal
28912,11,9,493.33000000000004,5,2,1,8,Regulars
28913,78,10,3654.1700000000005,4,3,5,12,Loyal
28914,196,6,2077.88,3,1,4,8,Big Spenders
28915,302,9,1494.97,2,2,3,7,Regulars
28916,489,16,1747.94,1,5,4,10,At Risk
28917,215,12,1171.1,3,4,2,9,Regulars
28918,34,12,2749.42,5,4,5,14,Champions
28919,368,9,2582.49,2,2,5,9,Regulars
28920,229,9,748.22,3,2,1,6,Regulars
28921,21,8,821.79,5,2,1,8,Regulars
28922,246,9,974.74,3,2,2,7,Regulars
28923,359,9,727.69,2,2,1,5,Hibernating
28924,119,11,2187.0,4,3,4,11,Loyal
28925,165,10,861.06,3,3,2,8,Regulars
28926,553,5,511.18,1,1,1,3,Hibernating
28927,148,5,441.42,3,1,1,5,Regulars
28928,346,10,762.38,2,3,1,6,Regulars
28929,182,7,550.0,3,1,1,5,Regulars
28930,111,11,1879.46,4,3,4,11,Loyal
28931,45,12,3375.26,5,4,5,14,Champions
28932,94,8,3059.92,4,2,5,11,Big Spenders
28933,2,12,949.27,5,4,2,11,Loyal
28934,692,12,1830.3799999999999,1,4,4,9,At Risk
28935,31,12,2653.05,5,4,5,14,Champions
28936,193,7,1358.47,3,1,3,7,Regulars
28937,310,9,1468.37,2,2,3,7,Regulars
28938,530,9,3020.7400000000002,1,2,5,8,Regulars
28939,190,11,1507.16,3,3,3,9,Regulars
28940,487,14,2933.3199999999997,1,5,5,11,At Risk
28941,101,6,567.26,4,1,1,6,Regulars
28942,154,19,8782.86,3,5,5,13,Big Spenders
28943,1046,8,833.74,1,2,1,4,Hibernating
28944,7,10,966.0600000000001,5,3,2,10,Loyal
28945,184,11,1991.3999999999999,3,3,4,10,Big Spenders
28946,54,12,2990.5899999999997,5,4,5,14,Champions
28947,149,13,757.19,3,4,1,8,Regulars
28948,73,7,2220.7999999999997,4,1,4,9,Big Spenders
28949,379,9,3238.1399999999994,2,2,5,9,Regulars
28950,236,13,3595.3799999999997,3,4,5,12,Big Spenders
28951,1259,5,1014.52,1,1,2,4,Hibernating
28952,212,11,1813.78,3,3,4,10,Big Spenders
28953,229,6,2236.13,3,1,4,8,Big Spenders
28954,77,12,2193.95,4,4,4,12,Champions
28955,63,14,2399.2799999999997,5,5,4,14,Champions
28956,806,7,1975.46,1,1,4,6,Regulars
28957,745,6,1260.43,1,1,3,5,Regulars
28958,156,7,1573.15,3,1,3,7,Regulars
28959,25,6,2141.48,5,1,4,10,Big Spenders
28960,87,15,3095.2599999999998,4,5,5,14,Champions
28961,120,15,3999.2,4,5,5,14,Champions
28962,678,11,1559.1299999999999,1,3,3,7,Regulars
28963,385,7,1631.22,2,1,3,6,Regulars
28964,629,11,2767.6,1,3,5,9,Regulars
28965,118,10,1687.79,4,3,3,10,Loyal
28966,464,13,2670.01,1,4,5,10,At Risk
28967,172,7,576.16,3,1,1,5,Regulars
28968,182,12,1730.94,3,4,4,11,Big Spenders
28969,203,7,1036.06,3,1,2,6,Regulars
28970,238,10,1038.65,3,3,2,8,Regulars
28971,441,12,6063.96,2,4,5,11,At Risk
28972,446,10,720.24,2,3,1,6,Regulars
28973,265,5,2862.25,2,1,5,8,Regulars
28974,971,6,726.43,1,1,1,3,Hibernating
28975,122,13,2043.46,4,4,4,12,Champions
28976,416,7,510.3,2,1,1,4,Hibernating
28977,459,11,1602.99,2,3,3,8,Regulars
28978,194,10,1358.38,3,3,3,9,Regulars
28979,1193,4,1402.44,1,1,3,5,Regulars
28980,201,11,1738.04,3,3,4,10,Big Spenders
28981,91,13,2288.07,4,4,4,12,Champions
28982,23,12,1574.69,5,4,3,12,Loyal
28983,24,9,2753.0099999999998,5,2,5,12,Big Spenders
28984,42,14,1231.05,5,5,2,12,Loyal
28985,369,5,2915.7799999999997,2,1,5,8,Regulars
28986,92,9,1124.55,4,2,2,8,Regulars
28987,180,12,1763.96,3,4,4,11,Big Spenders
28988,188,10,941.4,3,3,2,8,Regulars
28989,111,4,955.8999999999999,4,1,2,7,Regulars
28990,186,7,1547.04,3,1,3,7,Regulars
28991,183,7,1506.47,3,1,3,7,Regulars
28992,32,12,2046.86,5,4,4,13,Champions
28993,42,11,1380.24,5,3,3,11,Loyal
28994,61,8,1623.24,5,2,3,10,Regulars
28995,305,7,1514.6200000000001,2,1,3,6,Regulars
28996,304,7,597.1,2,1,1,4,Hibernating
28997,615,8,384.47999999999996,1,2,1,4,Hibernating
28998,1053,6,1121.82,1,1,2,4,Hibernating
28999,154,10,779.56,3,3,1,7,Regulars
29000,507,9,926.53,1,2,2,5,Hibernating
29001,29,9,1431.53,5,2,3,10,Regulars
29002,309,10,1252.3700000000001,2,3,3,8,Regulars
29003,307,16,1483.05,2,5,3,10,At Risk
29004,333,5,432.54999999999995,2,1,1,4,Hibernating
29005,354,8,1014.49,2,2,2,6,Hibernating
29006,5,15,5709.71,5,5,5,15,Champions
29007,1,12,3494.89,5,4,5,14,Champions
29008,844,7,2826.06,1,1,5,7,Regulars
29009,53,7,1383.52,5,1,3,9,Regulars
29010,174,6,359.22,3,1,1,5,Regulars
29011,165,12,3274.52,3,4,5,12,Big Spenders
29012,185,8,4120.51,3,2,5,10,Big Spenders
29013,201,10,825.03,3,3,1,7,Regulars
29014,682,15,2570.5099999999998,1,5,4,10,At Risk
29015,624,10,1336.09,1,3,3,7,Regulars
29016,446,11,966.32,2,3,2,7,Regulars
29017,39,13,1410.6000000000001,5,4,3,12,Loyal
29018,2,14,2088.37,5,5,4,14,Champions
29019,156,15,2669.11,3,5,5,13,Big Spenders
29020,227,11,654.22,3,3,1,7,Regulars
29021,6,10,1003.4499999999999,5,3,2,10,Loyal
29022,54,12,3042.2299999999996,5,4,5,14,Champions
29023,508,10,2669.66,1,3,5,9,Regulars
29024,1239,3,145.44,1,1,1,3,Hibernating
29025,481,3,607.96,1,1,1,3,Hibernating
29026,11,10,953.0699999999999,5,3,2,10,Loyal
29027,3,10,1958.08,5,3,4,12,Loyal
29028,53,8,350.09,5,2,1,8,Regulars
29029,53,12,1035.39,5,4,2,11,Loyal
29030,58,16,3575.7000000000003,5,5,5,15,Champions
29031,296,10,754.9300000000001,2,3,1,6,Regulars
29032,125,9,3437.0299999999997,4,2,5,11,Big Spenders
29033,5,13,1888.2599999999998,5,4,4,13,Champions
29034,96,9,1407.62,4,2,3,9,Regulars
29035,420,9,2753.9100000000003,2,2,5,9,Regulars
29036,3,10,2661.38,5,3,5,13,Loyal
29037,54,13,2661.34,5,4,5,14,Champions
29038,148,9,1109.6399999999999,3,2,2,7,Regulars
29039,465,8,782.01,1,2,1,4,Hibernating
29040,338,11,1384.43,2,3,3,8,Regulars
29041,68,15,2012.34,4,5,4,13,Champions
29042,15,13,1744.04,5,4,4,13,Champions
29043,171,14,2762.41,3,5,5,13,Big Spenders
29044,15,11,3935.89,5,3,5,13,Loyal
29045,0,9,1225.04,5,2,2,9,Regulars
29046,317,17,3326.71,2,5,5,12,At Risk
29047,96,8,542.55,4,2,1,7,Regulars
29048,212,10,1493.58,3,3,3,9,Regulars
29049,153,5,903.47,3,1,2,6,Regulars
29050,18,10,1564.51,5,3,3,11,Loyal
29051,462,9,1239.6000000000001,1,2,2,5,Hibernating
29052,150,14,3531.81,3,5,5,13,Big Spenders
29053,211,11,1513.12,3,3,3,9,Regulars
29054,155,7,1316.1799999999998,3,1,3,7,Regulars
29055,90,8,394.44,4,2,1,7,Regulars
29056,85,7,776.69,4,1,1,6,Regulars
29057,211,11,1984.75,3,3,4,10,Big Spenders
29058,185,11,2222.12,3,3,4,10,Big Spenders
29059,40,7,1928.9299999999998,5,1,4,10,Big Spenders
29060,296,9,3432.6700000000005,2,2,5,9,Regulars
29061,366,12,982.8900000000001,2,4,2,8,At Risk
29062,95,13,2310.96,4,4,4,12,Champions
29063,40,6,885.78,5,1,2,8,Regulars
29064,609,6,478.01,1,1,1,3,Hibernating
29065,66,6,629.9399999999999,4,1,1,6,Regulars
29066,154,7,595.2,3,1,1,5,Regulars
29067,582,5,500.26,1,1,1,3,Hibernating
29068,561,10,1317.21,1,3,3,7,Regulars
29069,127,14,4340.23,4,5,5,14,Champions
29070,20,13,1542.46,5,4,3,12,Loyal
29071,72,9,597.1899999999999,4,2,1,7,Regulars
29072,233,10,2127.49,3,3,4,10,Big Spenders
29073,101,10,838.89,4,3,1,8,Loyal
29074,104,10,2117.4300000000003,4,3,4,11,Loyal
29075,82,13,1550.8600000000001,4,4,3,11,Loyal
29076,203,7,644.76,3,1,1,5,Regulars
29077,671,11,2984.8100000000004,1,3,5,9,Regulars
29078,30,6,1149.42,5,1,2,8,Regulars
29079,315,15,3759.5,2,5,5,12,At Risk
29080,318,7,513.99,2,1,1,4,Hibernating
29081,279,7,1790.98,2,1,4,7,Regulars
29082,248,7,1141.6,2,1,2,5,Hibernating
29083,109,12,4583.67,4,4,5,13,Champions
29084,337,7,764.16,2,1,1,4,Hibernating
29085,359,11,1595.7,2,3,3,8,Regulars
29086,879,11,1331.18,1,3,3,7,Regulars
29087,241,10,2511.0599999999995,3,3,4,10,Big Spenders
29088,65,15,884.76,5,5,2,12,Loyal
29089,935,5,616.05,1,1,1,3,Hibernating
29090,192,11,3028.79,3,3,5,11,Big Spenders
29091,176,7,1430.38,3,1,3,7,Regulars
29092,258,22,6380.780000000001,2,5,5,12,At Risk
29093,111,9,2626.15,4,2,5,11,Big Spenders
29094,478,15,2442.23,1,5,4,10,At Risk
29095,563,8,1371.9299999999998,1,2,3,6,Regulars
29096,8,7,1050.79,5,1,2,8,Regulars
29097,58,9,1900.37,5,2,4,11,Big Spenders
29098,187,16,6406.070000000001,3,5,5,13,Big Spenders
29099,14,13,1180.66,5,4,2,11,Loyal
29100,168,11,845.1899999999999,3,3,2,8,Regulars
29101,33,11,1675.8,5,3,3,11,Loyal
29102,19,9,1238.08,5,2,2,9,Regulars
29103,260,9,1258.21,2,2,3,7,Regulars
29104,105,11,1617.7,4,3,3,10,Loyal
29105,164,7,1088.74,3,1,2,6,Regulars
29106,570,12,2089.19,1,4,4,9,At Risk
29107,48,5,2647.98,5,1,5,11,Big Spenders
29108,633,11,3782.24,1,3,5,9,Regulars
29109,193,11,924.37,3,3,2,8,Regulars
29110,52,13,1983.42,5,4,4,13,Champions
29111,305,11,824.06,2,3,1,6,Regulars
29112,446,13,4158.65,2,4,5,11,At Risk
29113,733,10,2334.63,1,3,4,8,Regulars
29114,1,9,808.95,5,2,1,8,Regulars
29115,587,8,620.67,1,2,1,4,Hibernating
29116,382,7,478.28999999999996,2,1,1,4,Hibernating
29117,190,11,2000.38,3,3,4,10,Big Spenders
29118,493,8,722.3199999999999,1,2,1,4,Hibernating
29119,137,11,1032.46,4,3,2,9,Loyal
29120,223,7,1836.0300000000002,3,1,4,8,Big Spenders
29121,1270,6,627.19,1,1,1,3,Hibernating
29122,109,15,3291.45,4,5,5,14,Champions
29123,315,14,8610.57,2,5,5,12,At Risk
29124,496,10,3177.2999999999997,1,3,5,9,Regulars
29125,365,9,539.8199999999999,2,2,1,5,Hibernating
29126,272,13,2546.54,2,4,4,10,At Risk
29127,873,6,550.77,1,1,1,3,Hibernating
29128,515,5,557.98,1,1,1,3,Hibernating
29129,97,12,947.87,4,4,2,10,Loyal
29130,854,12,631.83,1,4,1,6,At Risk
29131,226,12,1918.13,3,4,4,11,Big Spenders
29132,98,8,1444.7799999999997,4,2,3,9,Regulars
29133,290,13,1371.75,2,4,3,9,At Risk
29134,133,15,2011.7,4,5,4,13,Champions
29135,76,7,3157.87,4,1,5,10,Big Spenders
29136,17,8,1000.25,5,2,2,9,Regulars
29137,1007,9,771.26,1,2,1,4,Hibernating
29138,127,10,1458.54,4,3,3,10,Loyal
29139,442,13,1984.12,2,4,4,10,At Risk
29140,60,8,839.24,5,2,1,8,Regulars
29141,728,9,3976.9,1,2,5,8,Regulars
29142,165,9,2106.23,3,2,4,9,Big Spenders
29143,847,14,1642.41,1,5,3,9,At Risk
29144,201,9,502.4,3,2,1,6,Regulars
29145,111,15,1703.02,4,5,3,12,Loyal
29146,23,7,939.98,5,1,2,8,Regulars
29147,76,8,1129.16,4,2,2,8,Regulars
29148,68,12,1397.63,4,4,3,11,Loyal
29149,98,10,2012.14,4,3,4,11,Loyal
29150,289,11,5916.0199999999995,2,3,5,10,Regulars
29151,742,12,2110.48,1,4,4,9,At Risk
29152,455,8,827.97,2,2,1,5,Hibernating
29153,174,11,1160.12,3,3,2,8,Regulars
29154,733,8,1139.3999999999999,1,2,2,5,Hibernating
29155,362,10,1523.4099999999999,2,3,3,8,Regulars
29156,377,8,2143.02,2,2,4,8,Regulars
29157,77,8,1407.24,4,2,3,9,Regulars
29158,237,8,1055.41,3,2,2,7,Regulars
29159,6,10,1235.1,5,3,2,10,Loyal
29160,90,4,152.84,4,1,1,6,Regulars
29161,389,10,679.65,2,3,1,6,Regulars
29162,342,9,840.4,2,2,1,5,Hibernating
29163,131,10,925.78,4,3,2,9,Loyal
29164,284,15,2871.52,2,5,5,12,At Risk
29165,454,12,1557.6399999999999,2,4,3,9,At Risk
29166,214,6,1331.98,3,1,3,7,Regulars
29167,117,7,2080.35,4,1,4,9,Big Spenders
29168,7,16,1312.69,5,5,3,13,Loyal
29169,72,16,2486.63,4,5,4,13,Champions
29170,358,6,423.73,2,1,1,4,Hibernating
29171,467,10,1505.3,1,3,3,7,Regulars
29172,105,16,1433.3899999999999,4,5,3,12,Loyal
29173,257,7,506.15,2,1,1,4,Hibernating
29174,1259,12,2066.4300000000003,1,4,4,9,At Risk
29175,8,12,828.58,5,4,1,10,Loyal
29176,35,11,1101.3700000000001,5,3,2,10,Loyal
29177,1592,5,355.73,1,1,1,3,Hibernating
29178,90,12,1519.6,4,4,3,11,Loyal
29179,65,11,1819.3,5,3,4,12,Loyal
29180,476,5,1167.8200000000002,1,1,2,4,Hibernating
29181,505,13,1173.91,1,4,2,7,At Risk
29182,2,9,746.98,5,2,1,8,Regulars
29183,274,18,2347.25,2,5,4,11,At Risk
29184,274,13,1481.3999999999999,2,4,3,9,At Risk
29185,65,15,4782.599999999999,5,5,5,15,Champions
29186,636,10,810.79,1,3,1,5,Regulars
29187,486,12,1070.29,1,4,2,7,At Risk
29188,264,8,1644.54,2,2,3,7,Regulars
29189,264,10,1193.67,2,3,2,7,Regulars
29190,187,10,3227.3900000000003,3,3,5,11,Big Spenders
29191,561,6,967.36,1,1,2,4,Hibernating
29192,87,18,2655.83,4,5,5,14,Champions
29193,595,8,2833.9799999999996,1,2,5,8,Regulars
29194,524,12,4529.28,1,4,5,10,At Risk
29195,17,11,1428.96,5,3,3,11,Loyal
29196,568,10,1465.76,1,3,3,7,Regulars
29197,928,5,451.41999999999996,1,1,1,3,Hibernating
29198,7,12,3272.8799999999997,5,4,5,14,Champions
29199,172,9,2363.6099999999997,3,2,4,9,Big Spenders
29200,15,14,1538.28,5,5,3,13,Loyal
29201,167,11,1136.78,3,3,2,8,Regulars
29202,173,10,2060.31,3,3,4,10,Big Spenders
29203,173,10,919.3,3,3,2,8,Regulars
29204,54,8,1007.05,5,2,2,9,Regulars
29205,135,6,635.0899999999999,4,1,1,6,Regulars
29206,72,8,862.49,4,2,2,8,Regulars
29207,38,6,1319.11,5,1,3,9,Regulars
29208,27,9,2573.37,5,2,4,11,Big Spenders
29209,224,13,1382.17,3,4,3,10,Regulars
29210,445,11,941.8100000000001,2,3,2,7,Regulars
29211,473,8,2620.4199999999996,1,2,5,8,Regulars
29212,70,3,449.64,4,1,1,6,Regulars
29213,224,7,388.1,3,1,1,5,Regulars
29214,53,13,3356.97,5,4,5,14,Champions
29215,39,15,2598.39,5,5,5,15,Champions
29216,500,12,4438.759999999999,1,4,5,10,At Risk
29217,451,8,1264.7900000000002,2,2,3,7,Regulars
29218,86,6,1776.8500000000001,4,1,4,9,Big Spenders
29219,408,8,958.5600000000001,2,2,2,6,Hibernating
29220,403,13,1421.39,2,4,3,9,At Risk
29221,147,13,1898.5900000000001,4,4,4,12,Champions
29222,348,8,1196.01,2,2,2,6,Hibernating
29223,557,10,692.6700000000001,1,3,1,5,Regulars
29224,26,11,2043.97,5,3,4,12,Loyal
29225,31,4,361.82000000000005,5,1,1,7,Regulars
29226,132,9,1333.92,4,2,3,9,Regulars
29227,3,11,2836.68,5,3,5,13,Loyal
29228,126,6,5666.22,4,1,5,10,Big Spenders
29229,43,20,2566.4,5,5,4,14,Champions
29230,33,5,964.45,5,1,2,8,Regulars
29231,270,7,1844.96,2,1,4,7,Regulars
29232,45,9,378.14,5,2,1,8,Regulars
29233,493,14,2999.4900000000002,1,5,5,11,At Risk
29234,1050,4,599.7,1,1,1,3,Hibernating
29235,147,13,1530.01,4,4,3,11,Loyal
29236,825,8,1682.8,1,2,3,6,Regulars
29237,897,6,535.02,1,1,1,3,Hibernating
29238,20,10,1554.1,5,3,3,11,Loyal
29239,23,11,2067.0899999999997,5,3,4,12,Loyal
29240,464,12,2441.67,1,4,4,9,At Risk
29241,49,12,1866.0500000000002,5,4,4,13,Champions
29242,66,11,1075.24,4,3,2,9,Loyal
29243,75,12,1603.36,4,4,3,11,Loyal
29244,52,12,1557.77,5,4,3,12,Loyal
29245,97,10,1659.67,4,3,3,10,Loyal
29246,528,9,3062.06,1,2,5,8,Regulars
29247,186,9,853.99,3,2,2,7,Regulars
29248,1444,6,426.18,1,1,1,3,Hibernating
29249,64,11,1136.05,5,3,2,10,Loyal
29250,288,15,3779.26,2,5,5,12,At Risk
29251,615,13,2382.46,1,4,4,9,At Risk
29252,513,14,2096.57,1,5,4,10,At Risk
29253,319,14,1603.78,2,5,3,10,At Risk
29254,950,8,1394.1399999999999,1,2,3,6,Regulars
29255,31,11,3044.2299999999996,5,3,5,13,Loyal
29256,476,7,1138.82,1,1,2,4,Hibernating
29257,148,11,1924.44,3,3,4,10,Big Spenders
29258,104,11,2486.41,4,3,4,11,Loyal
29259,535,12,2719.75,1,4,5,10,At Risk
29260,478,13,2687.05,1,4,5,10,At Risk
29261,182,14,3195.4700000000003,3,5,5,13,Big Spenders
29262,30,11,3570.7,5,3,5,13,Loyal
29263,179,11,1705.14,3,3,3,9,Regulars
29264,309,8,863.71,2,2,2,6,Hibernating
29265,177,12,2397.4700000000003,3,4,4,11,Big Spenders
29266,72,9,802.3799999999999,4,2,1,7,Regulars
29267,24,13,1502.27,5,4,3,12,Loyal
29268,283,10,1876.54,2,3,4,9,Regulars
29269,433,7,1145.6,2,1,2,5,Hibernating
29270,353,12,3674.2,2,4,5,11,At Risk
29271,5,8,1327.5,5,2,3,10,Regulars
29272,538,6,869.26,1,1,2,4,Hibernating
29273,103,11,1471.56,4,3,3,10,Loyal
29274,244,6,1548.31,3,1,3,7,Regulars
29275,45,11,941.41,5,3,2,10,Loyal
29276,18,14,622.92,5,5,1,11,Loyal
29277,111,9,1405.73,4,2,3,9,Regulars
29278,398,8,1063.77,2,2,2,6,Hibernating
29279,28,11,1847.19,5,3,4,12,Loyal
29280,121,16,1322.57,4,5,3,12,Loyal
29281,181,12,4485.5,3,4,5,12,Big Spenders
29282,7,17,1784.8300000000002,5,5,4,14,Champions
29283,109,12,1310.55,4,4,3,11,Loyal
29284,307,10,1257.24,2,3,3,8,Regulars
29285,225,12,1135.12,3,4,2,9,Regulars
29286,28,6,4591.719999999999,5,1,5,11,Big Spenders
29287,463,11,1010.76,1,3,2,6,Regulars
29288,14,10,821.92,5,3,1,9,Loyal
29289,534,7,1231.0,1,1,2,4,Hibernating
29290,836,7,941.98,1,1,2,4,Hibernating
29291,0,8,1126.52,5,2,2,9,Regulars
29292,1313,8,849.32,1,2,2,5,Hibernating
29293,642,5,863.3,1,1,2,4,Hibernating
29294,275,4,339.03,2,1,1,4,Hibernating
29295,204,13,1143.21,3,4,2,9,Regulars
29296,216,13,2580.6,3,4,5,12,Big Spenders
29297,20,11,1121.8,5,3,2,10,Loyal
29298,42,7,833.1700000000001,5,1,1,7,Regulars
29299,127,6,1053.18,4,1,2,7,Regulars
29300,30,16,3473.6600000000003,5,5,5,15,Champions
29301,399,7,348.42,2,1,1,4,Hibernating
29302,465,9,1032.77,1,2,2,5,Hibernating
29303,35,11,1014.49,5,3,2,10,Loyal
29304,119,12,1293.28,4,4,3,11,Loyal
29305,204,8,1039.23,3,2,2,7,Regulars
29306,94,10,1741.71,4,3,4,11,Loyal
29307,130,13,2968.1800000000003,4,4,5,13,Champions
29308,154,14,3971.2599999999998,3,5,5,13,Big Spenders
29309,16,9,2392.44,5,2,4,11,Big Spenders
29310,58,8,1240.48,5,2,2,9,Regulars
29311,188,16,4176.32,3,5,5,13,Big Spenders
29312,536,7,2923.59,1,1,5,7,Regulars
29313,1379,10,1483.17,1,3,3,7,Regulars
29314,74,8,979.56,4,2,2,8,Regulars
29315,119,12,1319.45,4,4,3,11,Loyal
29316,184,8,732.62,3,2,1,6,Regulars
29317,210,14,2376.58,3,5,4,12,Big Spenders
29318,2,16,6240.5599999999995,5,5,5,15,Champions
29319,187,9,1397.1100000000001,3,2,3,8,Regulars
29320,110,13,1410.47,4,4,3,11,Loyal
29321,392,5,1936.5,2,1,4,7,Regulars
29322,119,9,899.46,4,2,2,8,Regulars
29323,9,16,3774.6600000000003,5,5,5,15,Champions
29324,23,12,955.28,5,4,2,11,Loyal
29325,84,10,1611.8600000000001,4,3,3,10,Loyal
29326,744,8,2726.05,1,2,5,8,Regulars
29327,3,15,1929.71,5,5,4,14,Champions
29328,155,11,1798.9299999999998,3,3,4,10,Big Spenders
29329,9,7,1002.3,5,1,2,8,Regulars
29330,281,11,3155.48,2,3,5,10,Regulars
29331,199,9,2211.34,3,2,4,9,Big Spenders
29332,29,12,2330.11,5,4,4,13,Champions
29333,416,13,1871.18,2,4,4,10,At Risk
29334,11,8,1662.76,5,2,3,10,Regulars
29335,530,5,219.48,1,1,1,3,Hibernating
29336,74,15,3322.93,4,5,5,14,Champions
29337,220,9,590.77,3,2,1,6,Regulars
29338,44,15,3151.42,5,5,5,15,Champions
29339,303,6,4103.25,2,1,5,8,Regulars
29340,433,9,1161.96,2,2,2,6,Hibernating
29341,0,7,1210.17,5,1,2,8,Regulars
29342,410,10,1410.6000000000001,2,3,3,8,Regulars
29343,119,11,780.1600000000001,4,3,1,8,Loyal
29344,129,20,4887.349999999999,4,5,5,14,Champions
29345,96,8,2246.21,4,2,4,10,Big Spenders
29346,119,15,2881.2,4,5,5,14,Champions
29347,159,11,910.5,3,3,2,8,Regulars
29348,878,10,672.41,1,3,1,5,Regulars
29349,428,6,1925.29,2,1,4,7,Regulars
29350,1169,9,1381.8600000000001,1,2,3,6,Regulars
29351,298,8,1219.46,2,2,2,6,Hibernating
29352,163,8,1409.83,3,2,3,8,Regulars
29353,671,9,989.99,1,2,2,5,Hibernating
29354,68,12,1097.09,4,4,2,10,Loyal
29355,152,11,3375.87,3,3,5,11,Big Spenders
29356,859,11,3663.26,1,3,5,9,Regulars
29357,167,12,2136.8300000000004,3,4,4,11,Big Spenders
29358,781,8,1598.53,1,2,3,6,Regulars
29359,10,6,437.2,5,1,1,7,Regulars
29360,539,10,1133.59,1,3,2,6,Regulars
29361,755,9,945.3299999999999,1,2,2,5,Hibernating
29362,1149,4,537.6,1,1,1,3,Hibernating
29363,161,10,962.12,3,3,2,8,Regulars
29364,790,11,5539.75,1,3,5,9,Regulars
29365,523,11,4340.76,1,3,5,9,Regulars
29366,700,12,1176.84,1,4,2,7,At Risk
29367,295,3,333.03,2,1,1,4,Hibernating
29368,614,4,351.46,1,1,1,3,Hibernating
29369,9,8,503.07000000000005,5,2,1,8,Regulars
29370,263,8,2164.56,2,2,4,8,Regulars
29371,431,12,3475.47,2,4,5,11,At Risk
29372,592,6,1059.02,1,1,2,4,Hibernating
29373,442,17,4752.26,2,5,5,12,At Risk
29374,306,11,1181.01,2,3,2,7,Regulars
29375,397,14,2281.64,2,5,4,11,At Risk
29376,166,15,1667.5499999999997,3,5,3,11,Regulars
29377,262,12,2597.5699999999997,2,4,5,11,At Risk
29378,118,9,1097.75,4,2,2,8,Regulars
29379,436,7,1068.3799999999999,2,1,2,5,Hibernating
29380,83,10,1053.53,4,3,2,9,Loyal
29381,107,5,3853.12,4,1,5,10,Big Spenders
29382,102,10,686.76,4,3,1,8,Loyal
29383,653,8,808.55,1,2,1,4,Hibernating
29384,78,16,3342.19,4,5,5,14,Champions
29385,370,9,927.97,2,2,2,6,Hibernating
29386,150,9,1304.0300000000002,3,2,3,8,Regulars
29387,156,12,2097.46,3,4,4,11,Big Spenders
29388,199,9,2050.37,3,2,4,9,Big Spenders
29389,29,8,1272.47,5,2,3,10,Regulars
29390,719,11,1595.1499999999999,1,3,3,7,Regulars
29391,467,15,3417.84,1,5,5,11,At Risk
29392,93,14,1594.23,4,5,3,12,Loyal
29393,290,8,428.76,2,2,1,5,Hibernating
29394,731,7,5908.15,1,1,5,7,Regulars
29395,615,9,865.34,1,2,2,5,Hibernating
29396,221,12,1311.48,3,4,3,10,Regulars
29397,40,13,2582.52,5,4,5,14,Champions
29398,279,7,1535.76,2,1,3,6,Regulars
29399,71,13,2407.68,4,4,4,12,Champions
29400,64,12,2729.3500000000004,5,4,5,14,Champions
29401,374,14,996.02,2,5,2,9,At Risk
29402,149,9,1667.5,3,2,3,8,Regulars
29403,564,9,1114.55,1,2,2,5,Hibernating
29404,561,10,1616.29,1,3,3,7,Regulars
29405,84,10,1433.23,4,3,3,10,Loyal
29406,17,8,1422.75,5,2,3,10,Regulars
29407,89,12,1480.17,4,4,3,11,Loyal
29408,123,10,1196.95,4,3,2,9,Loyal
29409,1166,11,2418.5,1,3,4,8,Regulars
29410,21,7,1091.52,5,1,2,8,Regulars
29411,81,9,1089.24,4,2,2,8,Regulars
29412,286,9,1077.04,2,2,2,6,Hibernating
29413,87,16,2029.5700000000002,4,5,4,13,Champions
29414,77,7,1889.45,4,1,4,9,Big Spenders
29415,160,14,1197.51,3,5,2,10,Regulars
29416,38,10,3412.78,5,3,5,13,Loyal
29417,74,11,1422.21,4,3,3,10,Loyal
29418,1487,6,657.37,1,1,1,3,Hibernating
29419,318,8,1485.02,2,2,3,7,Regulars
29420,348,5,3032.02,2,1,5,8,Regulars
29421,409,9,760.59,2,2,1,5,Hibernating
29422,292,14,2437.9300000000003,2,5,4,11,At Risk
29423,85,9,1946.23,4,2,4,10,Big Spenders
29424,183,8,506.97,3,2,1,6,Regulars
29425,73,10,2316.85,4,3,4,11,Loyal
29426,318,7,1844.0500000000002,2,1,4,7,Regulars
29427,30,12,2236.83,5,4,4,13,Champions
29428,31,11,1280.35,5,3,3,11,Loyal
29429,50,13,1111.57,5,4,2,11,Loyal
29430,220,12,2899.8900000000003,3,4,5,12,Big Spenders
29431,129,7,1172.84,4,1,2,7,Regulars
29432,238,10,3542.5499999999997,3,3,5,11,Big Spenders
29433,470,13,1947.36,1,4,4,9,At Risk
29434,52,10,3865.9500000000003,5,3,5,13,Loyal
29435,256,5,666.43,2,1,1,4,Hibernating
29436,334,7,753.68,2,1,1,4,Hibernating
29437,419,10,1409.67,2,3,3,8,Regulars
29438,769,7,840.42,1,1,1,3,Hibernating
29439,93,11,1254.6799999999998,4,3,3,10,Loyal
29440,120,8,794.2,4,2,1,7,Regulars
29441,206,7,542.0699999999999,3,1,1,5,Regulars
29442,128,12,3500.82,4,4,5,13,Champions
29443,266,11,3243.32,2,3,5,10,Regulars
29444,215,7,641.85,3,1,1,5,Regulars
29445,122,13,2546.1,4,4,4,12,Champions
29446,272,12,1554.95,2,4,3,9,At Risk
29447,209,9,799.36,3,2,1,6,Regulars
29448,432,13,1485.03,2,4,3,9,At Risk
29449,128,12,1115.47,4,4,2,10,Loyal
29450,45,13,2554.61,5,4,4,13,Champions
29451,109,14,1638.67,4,5,3,12,Loyal
29452,35,12,3011.3700000000003,5,4,5,14,Champions
29453,190,8,1061.75,3,2,2,7,Regulars
29454,184,15,1714.42,3,5,3,11,Regulars
29455,35,11,1375.98,5,3,3,11,Loyal
29456,216,12,1040.12,3,4,2,9,Regulars
29457,61,16,1989.19,5,5,4,14,Champions
29458,196,9,3945.8399999999997,3,2,5,10,Big Spenders
29459,90,13,1079.8799999999999,4,4,2,10,Loyal
29460,395,6,630.8,2,1,1,4,Hibernating
29461,60,10,1872.05,5,3,4,12,Loyal
29462,322,10,1456.65,2,3,3,8,Regulars
29463,15,13,5632.33,5,4,5,14,Champions
29464,211,6,1959.11,3,1,4,8,Big Spenders
29465,69,9,1092.02,4,2,2,8,Regulars
29466,92,6,2438.06,4,1,4,9,Big Spenders
29467,310,8,1838.03,2,2,4,8,Regulars
29468,333,10,1796.6399999999999,2,3,4,9,Regulars
29469,571,12,2068.27,1,4,4,9,At Risk
29470,199,12,3210.0899999999997,3,4,5,12,Big Spenders
29471,487,4,3727.9300000000003,1,1,5,7,Regulars
29472,195,12,4655.900000000001,3,4,5,12,Big Spenders
29473,615,7,899.87,1,1,2,4,Hibernating
29474,36,8,2896.2000000000003,5,2,5,12,Big Spenders
29475,99,10,1044.07,4,3,2,9,Loyal
29476,287,12,887.69,2,4,2,8,At Risk
29477,29,9,2253.31,5,2,4,11,Big Spenders
29478,488,6,745.79,1,1,1,3,Hibernating
29479,209,9,810.4,3,2,1,6,Regulars
29480,753,8,641.69,1,2,1,4,Hibernating
29481,38,14,1236.18,5,5,2,12,Loyal
29482,184,14,3141.14,3,5,5,13,Big Spenders
29483,15,5,496.15000000000003,5,1,1,7,Regulars
29484,634,7,1614.28,1,1,3,5,Regulars
29485,0,11,3860.2999999999997,5,3,5,13,Loyal
29486,5,15,2691.2999999999997,5,5,5,15,Champions
29487,43,13,761.55,5,4,1,10,Loyal
29488,204,6,1282.72,3,1,3,7,Regulars
29489,31,16,4375.82,5,5,5,15,Champions
29490,94,12,1869.88,4,4,4,12,Champions
29491,1041,5,1278.2,1,1,3,5,Regulars
29492,350,13,2545.39,2,4,4,10,At Risk
29493,281,14,2967.44,2,5,5,12,At Risk
29494,667,14,1552.76,1,5,3,9,At Risk
29495,188,13,2211.11,3,4,4,11,Big Spenders
29496,740,5,501.88999999999993,1,1,1,3,Hibernating
29497,361,15,2831.7400000000002,2,5,5,12,At Risk
29498,333,12,2195.18,2,4,4,10,At Risk
29499,90,10,1109.29,4,3,2,9,Loyal
29500,67,8,686.19,4,2,1,7,Regulars
29501,260,15,1924.83,2,5,4,11,At Risk
29502,761,8,791.46,1,2,1,4,Hibernating
29503,169,11,597.34,3,3,1,7,Regulars
29504,226,13,2338.2999999999997,3,4,4,11,Big Spenders
29505,272,9,1185.31,2,2,2,6,Hibernating
29506,49,6,823.0,5,1,1,7,Regulars
29507,205,13,2340.46,3,4,4,11,Big Spenders
29508,460,12,2607.04,1,4,5,10,At Risk
29509,179,13,1718.1200000000001,3,4,3,10,Regulars
29510,232,12,1711.34,3,4,3,10,Regulars
29511,57,11,1508.3400000000001,5,3,3,11,Loyal
29512,53,14,1012.78,5,5,2,12,Loyal
29513,1010,4,1464.37,1,1,3,5,Regulars
29514,195,9,1760.92,3,2,4,9,Big Spenders
29515,545,7,422.67,1,1,1,3,Hibernating
29516,130,13,1992.46,4,4,4,12,Champions
29517,14,7,1932.46,5,1,4,10,Big Spenders
29518,131,8,1438.98,4,2,3,9,Regulars
29519,126,12,1171.92,4,4,2,10,Loyal
29520,265,10,2904.85,2,3,5,10,Regulars
29521,285,10,2193.54,2,3,4,9,Regulars
29522,417,6,2484.84,2,1,4,7,Regulars
29523,50,15,2974.55,5,5,5,15,Champions
29524,220,11,2233.71,3,3,4,10,Big Spenders
29525,108,12,1027.98,4,4,2,10,Loyal
29526,354,9,1060.65,2,2,2,6,Hibernating
29527,91,10,803.59,4,3,1,8,Loyal
29528,156,12,1327.83,3,4,3,10,Regulars
29529,23,14,1607.46,5,5,3,13,Loyal
29530,6,7,1385.08,5,1,3,9,Regulars
29531,546,8,3121.6699999999996,1,2,5,8,Regulars
29532,186,7,618.97,3,1,1,5,Regulars
29533,6,16,2210.83,5,5,4,14,Champions
29534,165,8,1380.98,3,2,3,8,Regulars
29535,48,12,1156.9,5,4,2,11,Loyal
29536,1233,8,1630.43,1,2,3,6,Regulars
29537,168,15,3848.95,3,5,5,13,Big Spenders
29538,90,11,1382.8200000000002,4,3,3,10,Loyal
29539,40,11,1558.41,5,3,3,11,Loyal
29540,131,6,352.08,4,1,1,6,Regulars
29541,407,8,765.77,2,2,1,5,Hibernating
29542,191,15,2994.28,3,5,5,13,Big Spenders
29543,481,10,1047.3600000000001,1,3,2,6,Regulars
29544,309,5,600.4,2,1,1,4,Hibernating
29545,21,11,3565.0599999999995,5,3,5,13,Loyal
29546,92,22,2896.15,4,5,5,14,Champions
29547,124,14,1454.72,4,5,3,12,Loyal
29548,846,12,2113.14,1,4,4,9,At Risk
29549,35,12,3789.17,5,4,5,14,Champions
29550,300,15,1192.65,2,5,2,9,At Risk
29551,242,6,1178.38,3,1,2,6,Regulars
29552,212,5,383.58,3,1,1,5,Regulars
29553,110,7,3852.37,4,1,5,10,Big Spenders
29554,742,10,648.26,1,3,1,5,Regulars
29555,64,14,2649.47,5,5,5,15,Champions
29556,49,19,2363.67,5,5,4,14,Champions
29557,56,13,1704.76,5,4,3,12,Loyal
29558,228,7,506.56,3,1,1,5,Regulars
29559,270,9,877.68,2,2,2,6,Hibernating
29560,18,8,638.46,5,2,1,8,Regulars
29561,123,12,1558.35,4,4,3,11,Loyal
29562,74,12,1991.34,4,4,4,12,Champions
29563,101,11,4053.7,4,3,5,12,Loyal
29564,373,11,1325.05,2,3,3,8,Regulars
29565,58,11,3171.6,5,3,5,13,Loyal
29566,27,6,1519.72,5,1,3,9,Regulars
29567,35,20,2083.19,5,5,4,14,Champions
29568,213,10,1646.77,3,3,3,9,Regulars
29569,148,14,3360.9999999999995,3,5,5,13,Big Spenders
29570,6,15,2299.7,5,5,4,14,Champions
29571,203,7,1019.5500000000001,3,1,2,6,Regulars
29572,7,11,1314.3,5,3,3,11,Loyal
29573,133,20,1973.1100000000001,4,5,4,13,Champions
29574,106,7,873.9300000000001,4,1,2,7,Regulars
29575,349,12,3446.7200000000003,2,4,5,11,At Risk
29576,662,12,1785.8400000000001,1,4,4,9,At Risk
29577,277,9,1222.48,2,2,2,6,Hibernating
29578,401,5,761.28,2,1,1,4,Hibernating
29579,54,12,1114.84,5,4,2,11,Loyal
29580,12,14,2333.57,5,5,4,14,Champions
29581,742,4,1696.67,1,1,3,5,Regulars
29582,297,15,3494.03,2,5,5,12,At Risk
29583,43,10,1123.69,5,3,2,10,Loyal
29584,69,18,2286.63,4,5,4,13,Champions
29585,755,11,2184.44,1,3,4,8,Regulars
29586,26,7,339.78,5,1,1,7,Regulars
29587,258,8,1477.08,2,2,3,7,Regulars
29588,682,5,1207.02,1,1,2,4,Hibernating
29589,434,7,723.26,2,1,1,4,Hibernating
29590,45,12,2376.84,5,4,4,13,Champions
29591,444,13,2743.24,2,4,5,11,At Risk
29592,1127,3,247.99,1,1,1,3,Hibernating
29593,14,10,3018.73,5,3,5,13,Loyal
29594,160,12,1441.34,3,4,3,10,Regulars
29595,90,10,1155.97,4,3,2,9,Loyal
29596,46,12,1040.69,5,4,2,11,Loyal
29597,412,6,2993.72,2,1,5,8,Regulars
29598,47,12,3325.28,5,4,5,14,Champions
29599,76,13,2538.23,4,4,4,12,Champions
29600,237,10,1274.5900000000001,3,3,3,9,Regulars
29601,167,10,4772.46,3,3,5,11,Big Spenders
29602,13,9,3582.9399999999996,5,2,5,12,Big Spenders
29603,521,11,1755.83,1,3,4,8,Regulars
29604,237,5,743.63,3,1,1,5,Regulars
29605,255,14,1866.97,2,5,4,11,At Risk
29606,442,9,605.6800000000001,2,2,1,5,Hibernating
29607,267,7,1688.0100000000002,2,1,3,6,Regulars
29608,295,5,867.77,2,1,2,5,Hibernating
29609,601,14,1936.36,1,5,4,10,At Risk
29610,395,12,1568.69,2,4,3,9,At Risk
29611,167,11,1014.5,3,3,2,8,Regulars
29612,461,12,5130.860000000001,1,4,5,10,At Risk
29613,56,17,2575.66,5,5,5,15,Champions
29614,8,9,1184.95,5,2,2,9,Regulars
29615,464,12,1502.52,1,4,3,8,At Risk
29616,471,6,2642.37,1,1,5,7,Regulars
29617,852,6,1520.44,1,1,3,5,Regulars
29618,281,14,2174.24,2,5,4,11,At Risk
29619,745,8,661.6600000000001,1,2,1,4,Hibernating
29620,11,9,2256.7799999999997,5,2,4,11,Big Spenders
29621,49,10,1968.97,5,3,4,12,Loyal
29622,450,11,976.38,2,3,2,7,Regulars
29623,60,13,1409.75,5,4,3,12,Loyal
29624,134,9,516.7900000000001,4,2,1,7,Regulars
29625,17,13,1750.9299999999998,5,4,4,13,Champions
29626,47,11,1954.25,5,3,4,12,Loyal
29627,427,7,633.85,2,1,1,4,Hibernating
29628,60,14,1665.38,5,5,3,13,Loyal
29629,67,16,2251.97,4,5,4,13,Champions
29630,701,8,1873.71,1,2,4,7,Regulars
29631,30,15,2081.8199999999997,5,5,4,14,Champions
29632,374,11,1338.27,2,3,3,8,Regulars
29633,440,8,3634.4,2,2,5,9,Regulars
29634,108,10,2048.6400000000003,4,3,4,11,Loyal
29635,1,11,1457.6200000000001,5,3,3,11,Loyal
29636,943,5,360.1,1,1,1,3,Hibernating
29637,149,15,3205.15,3,5,5,13,Big Spenders
29638,179,9,4476.63,3,2,5,10,Big Spenders
29639,211,9,485.53999999999996,3,2,1,6,Regulars
29640,85,10,1219.22,4,3,2,9,Loyal
29641,78,8,696.83,4,2,1,7,Regulars
29642,412,14,3009.52,2,5,5,12,At Risk
29643,61,12,1174.17,5,4,2,11,Loyal
29644,97,5,1373.34,4,1,3,8,Regulars
29645,416,3,354.22,2,1,1,4,Hibernating
29646,124,10,1548.35,4,3,3,10,Loyal
29647,76,17,4751.84,4,5,5,14,Champions
29648,755,14,3515.22,1,5,5,11,At Risk
29649,57,11,1488.26,5,3,3,11,Loyal
29650,136,16,3440.62,4,5,5,14,Champions
29651,82,12,1654.82,4,4,3,11,Loyal
29652,584,10,3009.82,1,3,5,9,Regulars
29653,108,10,1411.75,4,3,3,10,Loyal
29654,201,6,436.34,3,1,1,5,Regulars
29655,43,10,930.65,5,3,2,10,Loyal
29656,54,13,3732.87,5,4,5,14,Champions
29657,67,8,1296.98,4,2,3,9,Regulars
29658,62,6,581.6899999999999,5,1,1,7,Regulars
29659,25,8,693.31,5,2,1,8,Regulars
29660,18,14,1468.94,5,5,3,13,Loyal
29661,127,9,2592.79,4,2,5,11,Big Spenders
29662,248,12,1619.71,2,4,3,9,At Risk
29663,202,7,802.54,3,1,1,5,Regulars
29664,459,4,2363.1,2,1,4,7,Regulars
29665,432,15,2670.69,2,5,5,12,At Risk
29666,537,10,2030.48,1,3,4,8,Regulars
29667,77,10,2181.85,4,3,4,11,Loyal
29668,385,15,2062.92,2,5,4,11,At Risk
29669,12,15,813.51,5,5,1,11,Loyal
29670,78,11,1892.67,4,3,4,11,Loyal
29671,44,12,4079.47,5,4,5,14,Champions
29672,60,10,2876.3400000000006,5,3,5,13,Loyal
29673,192,16,2005.52,3,5,4,12,Big Spenders
29674,1386,7,562.97,1,1,1,3,Hibernating
29675,629,12,3721.91,1,4,5,10,At Risk
29676,602,10,2405.0,1,3,4,8,Regulars
29677,52,6,960.35,5,1,2,8,Regulars
29678,498,11,1123.98,1,3,2,6,Regulars
29679,52,12,1641.53,5,4,3,12,Loyal
29680,19,14,1514.04,5,5,3,13,Loyal
29681,329,14,1816.61,2,5,4,11,At Risk
29682,163,13,1338.76,3,4,3,10,Regulars
29683,0,6,409.35,5,1,1,7,Regulars
29684,456,13,6793.9400000000005,2,4,5,11,At Risk
29685,205,10,1600.4299999999998,3,3,3,9,Regulars
29686,60,6,771.68,5,1,1,7,Regulars
29687,171,8,1460.85,3,2,3,8,Regulars
29688,44,14,2384.12,5,5,4,14,Champions
29689,418,6,472.41,2,1,1,4,Hibernating
29690,180,9,956.37,3,2,2,7,Regulars
29691,91,8,547.4300000000001,4,2,1,7,Regulars
29692,194,11,3427.4300000000003,3,3,5,11,Big Spenders
29693,467,7,922.24,1,1,2,4,Hibernating
29694,238,12,3542.77,3,4,5,12,Big Spenders
29695,239,9,2925.02,3,2,5,10,Big Spenders
29696,132,10,2477.4,4,3,4,11,Loyal
29697,489,12,1134.79,1,4,2,7,At Risk
29698,859,9,1637.72,1,2,3,6,Regulars
29699,412,7,601.48,2,1,1,4,Hibernating
29700,20,13,1771.4499999999998,5,4,4,13,Champions
29701,61,8,644.79,5,2,1,8,Regulars
29702,34,7,1149.75,5,1,2,8,Regulars
29703,653,5,2737.43,1,1,5,7,Regulars
29704,337,11,3520.5099999999998,2,3,5,10,Regulars
29705,209,15,1464.13,3,5,3,11,Regulars
29706,630,9,2754.3100000000004,1,2,5,8,Regulars
29707,177,4,337.15,3,1,1,5,Regulars
29708,924,5,521.98,1,1,1,3,Hibernating
29709,30,18,3263.33,5,5,5,15,Champions
29710,207,10,925.69,3,3,2,8,Regulars
29711,518,10,704.63,1,3,1,5,Regulars
29712,89,12,1902.85,4,4,4,12,Champions
29713,383,7,1151.71,2,1,2,5,Hibernating
29714,28,8,1214.05,5,2,2,9,Regulars
29715,88,10,1869.06,4,3,4,11,Loyal
29716,231,4,352.38,3,1,1,5,Regulars
29717,17,7,2614.76,5,1,5,11,Big Spenders
29718,99,11,1223.27,4,3,2,9,Loyal
29719,247,9,793.69,3,2,1,6,Regulars
29720,135,13,2887.28,4,4,5,13,Champions
29721,784,9,2557.98,1,2,4,7,Regulars
29722,564,9,3775.23,1,2,5,8,Regulars
29723,447,11,863.15,2,3,2,7,Regulars
29724,723,16,1013.22,1,5,2,8,At Risk
29725,179,10,777.44,3,3,1,7,Regulars
29726,56,10,3094.8799999999997,5,3,5,13,Loyal
29727,143,14,3803.0,4,5,5,14,Champions
29728,171,9,893.08,3,2,2,7,Regulars
29729,243,10,1810.06,3,3,4,10,Big Spenders
29730,46,12,2025.48,5,4,4,13,Champions
29731,90,11,1620.58,4,3,3,10,Loyal
29732,495,11,1032.23,1,3,2,6,Regulars
29733,477,9,1180.1200000000001,1,2,2,5,Hibernating
29734,184,9,818.42,3,2,1,6,Regulars
29735,125,6,295.16,4,1,1,6,Regulars
29736,70,12,1920.54,4,4,4,12,Champions
29737,263,11,3031.24,2,3,5,10,Regulars
29738,124,16,1323.87,4,5,3,12,Loyal
29739,201,7,1109.34,3,1,2,6,Regulars
29740,531,9,1556.16,1,2,3,6,Regulars
29741,682,15,2050.2,1,5,4,10,At Risk
29742,133,6,652.3299999999999,4,1,1,6,Regulars
29743,79,8,687.21,4,2,1,7,Regulars
29744,379,7,1182.6399999999999,2,1,2,5,Hibernating
29745,66,7,1477.56,4,1,3,8,Regulars
29746,70,10,1102.51,4,3,2,9,Loyal
29747,20,12,2351.49,5,4,4,13,Champions
29748,75,8,779.11,4,2,1,7,Regulars
29749,88,10,787.72,4,3,1,8,Loyal
29750,482,9,3484.42,1,2,5,8,Regulars
29751,20,7,1783.2999999999997,5,1,4,10,Big Spenders
29752,88,11,2384.3,4,3,4,11,Loyal
29753,67,14,2728.59,4,5,5,14,Champions
29754,238,12,1050.53,3,4,2,9,Regulars
29755,258,8,2089.13,2,2,4,8,Regulars
29756,453,5,718.43,2,1,1,4,Hibernating
29757,410,7,2580.58,2,1,5,8,Regulars
29758,116,13,896.77,4,4,2,10,Loyal
29759,189,6,2974.8999999999996,3,1,5,9,Big Spenders
29760,283,6,551.5799999999999,2,1,1,4,Hibernating
29761,164,10,981.63,3,3,2,8,Regulars
29762,28,11,3264.01,5,3,5,13,Loyal
29763,218,10,2505.44,3,3,4,10,Big Spenders
29764,398,11,2211.1,2,3,4,9,Regulars
29765,101,11,777.44,4,3,1,8,Loyal
29766,400,14,1031.03,2,5,2,9,At Risk
29767,54,12,3729.55,5,4,5,14,Champions
29768,188,12,2288.01,3,4,4,11,Big Spenders
29769,212,7,735.97,3,1,1,5,Regulars
29770,22,10,1358.52,5,3,3,11,Loyal
29771,379,8,2023.9099999999999,2,2,4,8,Regulars
29772,208,13,2031.33,3,4,4,11,Big Spenders
29773,580,7,895.42,1,1,2,4,Hibernating
29774,351,6,1185.42,2,1,2,5,Hibernating
29775,50,8,630.54,5,2,1,8,Regulars
29776,116,9,2469.96,4,2,4,10,Big Spenders
29777,283,10,3315.08,2,3,5,10,Regulars
29778,298,11,1798.05,2,3,4,9,Regulars
29779,207,12,735.9,3,4,1,8,Regulars
29780,25,8,949.08,5,2,2,9,Regulars
29781,250,10,801.23,2,3,1,6,Regulars
29782,27,13,1282.87,5,4,3,12,Loyal
29783,982,9,2217.4900000000002,1,2,4,7,Regulars
29784,1302,4,676.45,1,1,1,3,Hibernating
29785,921,10,1077.1699999999998,1,3,2,6,Regulars
29786,133,9,1064.81,4,2,2,8,Regulars
29787,292,8,3026.33,2,2,5,9,Regulars
29788,361,8,1287.43,2,2,3,7,Regulars
29789,825,9,1553.26,1,2,3,6,Regulars
29790,148,11,2215.11,3,3,4,10,Big Spenders
29791,108,7,456.39,4,1,1,6,Regulars
29792,228,12,3536.88,3,4,5,12,Big Spenders
29793,947,10,4617.13,1,3,5,9,Regulars
29794,227,10,2676.1,3,3,5,11,Big Spenders
29795,209,14,4319.37,3,5,5,13,Big Spenders
29796,105,10,1219.84,4,3,2,9,Loyal
29797,168,11,3749.5499999999997,3,3,5,11,Big Spenders
29798,39,8,586.05,5,2,1,8,Regulars
29799,156,6,707.78,3,1,1,5,Regulars
29800,82,11,3053.04,4,3,5,12,Loyal
29801,217,12,1283.3600000000001,3,4,3,10,Regulars
29802,124,12,2003.4299999999998,4,4,4,12,Champions
29803,497,10,1925.28,1,3,4,8,Regulars
29804,147,9,415.64,4,2,1,7,Regulars
29805,487,8,753.93,1,2,1,4,Hibernating
29806,51,9,741.02,5,2,1,8,Regulars
29807,162,4,649.9300000000001,3,1,1,5,Regulars
29808,223,7,1162.22,3,1,2,6,Regulars
29809,39,8,752.11,5,2,1,8,Regulars
29810,543,4,994.8000000000001,1,1,2,4,Hibernating
29811,2,6,904.95,5,1,2,8,Regulars
29812,49,14,2883.9100000000003,5,5,5,15,Champions
29813,309,6,1141.07,2,1,2,5,Hibernating
29814,202,9,1419.33,3,2,3,8,Regulars
29815,274,13,1284.8999999999999,2,4,3,9,At Risk
29816,449,13,2300.68,2,4,4,10,At Risk
29817,41,10,2839.9,5,3,5,13,Loyal
29818,43,6,550.91,5,1,1,7,Regulars
29819,113,13,1206.8300000000002,4,4,2,10,Loyal
29820,243,10,849.48,3,3,2,8,Regulars
29821,188,5,386.98,3,1,1,5,Regulars
29822,269,7,1324.8,2,1,3,6,Regulars
29823,481,9,605.79,1,2,1,4,Hibernating
29824,345,14,1770.66,2,5,4,11,At Risk
29825,207,9,1952.08,3,2,4,9,Big Spenders
29826,483,8,1382.78,1,2,3,6,Regulars
29827,16,7,1041.01,5,1,2,8,Regulars
29828,366,6,294.71999999999997,2,1,1,4,Hibernating
29829,387,9,1920.45,2,2,4,8,Regulars
29830,23,14,4629.389999999999,5,5,5,15,Champions
29831,186,15,2732.25,3,5,5,13,Big Spenders
29832,160,8,2719.3599999999997,3,2,5,10,Big Spenders
29833,822,12,3630.2999999999997,1,4,5,10,At Risk
29834,734,8,2055.4,1,2,4,7,Regulars
29835,382,9,781.38,2,2,1,5,Hibernating
29836,43,8,2547.1,5,2,4,11,Big Spenders
29837,56,11,2706.67,5,3,5,13,Loyal
29838,120,8,626.8299999999999,4,2,1,7,Regulars
29839,293,9,1044.7099999999998,2,2,2,6,Hibernating
29840,199,11,3382.74,3,3,5,11,Big Spenders
29841,49,6,1302.34,5,1,3,9,Regulars
29842,280,10,789.31,2,3,1,6,Regulars
29843,47,11,906.5699999999999,5,3,2,10,Loyal
29844,179,11,1379.3700000000001,3,3,3,9,Regulars
29845,149,9,1292.0,3,2,3,8,Regulars
29846,126,8,1270.8000000000002,4,2,3,9,Regulars
29847,2,14,1661.8799999999999,5,5,3,13,Loyal
29848,185,9,1852.91,3,2,4,9,Big Spenders
29849,239,9,657.27,3,2,1,6,Regulars
29850,352,11,1676.02,2,3,3,8,Regulars
29851,0,13,1295.98,5,4,3,12,Loyal
29852,87,20,2989.78,4,5,5,14,Champions
29853,29,12,1570.8500000000001,5,4,3,12,Loyal
29854,168,12,901.87,3,4,2,9,Regulars
29855,247,8,1989.0300000000002,3,2,4,9,Big Spenders
29856,127,10,1268.67,4,3,3,10,Loyal
29857,284,10,2419.9900000000002,2,3,4,9,Regulars
29858,186,7,309.24,3,1,1,5,Regulars
29859,475,8,517.6899999999999,1,2,1,4,Hibernating
29860,68,13,1915.8100000000002,4,4,4,12,Champions
29861,70,9,1349.98,4,2,3,9,Regulars
29862,185,16,5428.74,3,5,5,13,Big Spenders
29863,801,10,924.5699999999999,1,3,2,6,Regulars
29864,72,10,3017.93,4,3,5,12,Loyal
29865,64,14,1009.9499999999999,5,5,2,12,Loyal
29866,356,13,2609.0099999999998,2,4,5,11,At Risk
29867,695,8,1175.02,1,2,2,5,Hibernating
29868,122,14,1227.45,4,5,2,11,Loyal
29869,270,12,1138.76,2,4,2,8,At Risk
29870,890,10,1307.39,1,3,3,7,Regulars
29871,290,11,2398.23,2,3,4,9,Regulars
29872,2,9,928.95,5,2,2,9,Regulars
29873,223,13,1580.44,3,4,3,10,Regulars
29874,65,6,587.26,5,1,1,7,Regulars
29875,51,8,1432.6200000000001,5,2,3,10,Regulars
29876,95,10,3035.32,4,3,5,12,Loyal
29877,82,14,2836.9300000000003,4,5,5,14,Champions
29878,256,8,922.24,2,2,2,6,Hibernating
29879,33,8,1199.69,5,2,2,9,Regulars
29880,99,13,2656.4599999999996,4,4,5,13,Champions
29881,42,11,1814.72,5,3,4,12,Loyal
29882,95,9,562.51,4,2,1,7,Regulars
29883,343,10,2179.12,2,3,4,9,Regulars
29884,614,10,1860.7299999999998,1,3,4,8,Regulars
29885,50,11,1229.78,5,3,2,10,Loyal
29886,108,9,2429.74,4,2,4,10,Big Spenders
29887,91,11,1511.21,4,3,3,10,Loyal
29888,24,11,1584.19,5,3,3,11,Loyal
29889,15,11,1324.44,5,3,3,11,Loyal
29890,615,13,2967.36,1,4,5,10,At Risk
29891,627,9,597.6400000000001,1,2,1,4,Hibernating
29892,32,18,4593.64,5,5,5,15,Champions
29893,221,8,976.33,3,2,2,7,Regulars
29894,556,8,1449.1,1,2,3,6,Regulars
29895,156,10,2308.48,3,3,4,10,Big Spenders
29896,225,16,2823.89,3,5,5,13,Big Spenders
29897,467,14,2750.6,1,5,5,11,At Risk
29898,539,14,3423.22,1,5,5,11,At Risk
29899,445,9,1261.84,2,2,3,7,Regulars
29900,52,12,1612.4,5,4,3,12,Loyal
29901,62,9,2344.12,5,2,4,11,Big Spenders
29902,36,8,557.14,5,2,1,8,Regulars
29903,28,11,980.5500000000001,5,3,2,10,Loyal
29904,212,11,1238.42,3,3,2,8,Regulars
29905,45,16,1439.78,5,5,3,13,Loyal
29906,727,7,1433.02,1,1,3,5,Regulars
29907,497,7,962.99,1,1,2,4,Hibernating
29908,5,12,1587.31,5,4,3,12,Loyal
29909,138,10,3453.68,4,3,5,12,Loyal
29910,143,13,3776.8299999999995,4,4,5,13,Champions
29911,250,7,936.33,2,1,2,5,Hibernating
29912,119,9,2309.13,4,2,4,10,Big Spenders
29913,54,9,654.3199999999999,5,2,1,8,Regulars
29914,170,13,3282.43,3,4,5,12,Big Spenders
29915,297,5,798.06,2,1,1,4,Hibernating
29916,415,9,1011.2,2,2,2,6,Hibernating
29917,547,15,2155.54,1,5,4,10,At Risk
29918,113,11,1015.4200000000001,4,3,2,9,Loyal
29919,391,12,1443.76,2,4,3,9,At Risk
29920,354,8,682.46,2,2,1,5,Hibernating
29921,194,8,798.91,3,2,1,6,Regulars
29922,190,11,1887.71,3,3,4,10,Big Spenders
29923,945,5,2900.22,1,1,5,7,Regulars
29924,104,13,2786.5699999999997,4,4,5,13,Champions
29925,6,12,3229.77,5,4,5,14,Champions
29926,253,6,450.52,2,1,1,4,Hibernating
29927,504,5,618.9,1,1,1,3,Hibernating
29928,356,7,634.67,2,1,1,4,Hibernating
29929,168,9,571.37,3,2,1,6,Regulars
29930,1289,7,1115.6200000000001,1,1,2,4,Hibernating
29931,251,6,2147.53,2,1,4,7,Regulars
29932,121,16,2286.2799999999997,4,5,4,13,Champions
29933,16,7,1372.18,5,1,3,9,Regulars
29934,203,11,862.6399999999999,3,3,2,8,Regulars
29935,281,13,875.64,2,4,2,8,At Risk
29936,217,6,492.54999999999995,3,1,1,5,Regulars
29937,190,5,418.15,3,1,1,5,Regulars
29938,233,7,1612.57,3,1,3,7,Regulars
29939,159,10,1236.8400000000001,3,3,2,8,Regulars
29940,85,7,655.45,4,1,1,6,Regulars
29941,69,9,1149.4,4,2,2,8,Regulars
29942,385,7,1536.24,2,1,3,6,Regulars
29943,294,13,5359.24,2,4,5,11,At Risk
29944,830,8,944.98,1,2,2,5,Hibernating
29945,109,9,1065.8,4,2,2,8,Regulars
29946,656,9,1263.22,1,2,3,6,Regulars
29947,945,10,626.79,1,3,1,5,Regulars
29948,272,8,2691.78,2,2,5,9,Regulars
29949,243,10,1677.26,3,3,3,9,Regulars
29950,106,6,505.89,4,1,1,6,Regulars
29951,92,11,2339.3,4,3,4,11,Loyal
29952,242,8,833.31,3,2,1,6,Regulars
29953,545,9,609.4,1,2,1,4,Hibernating
29954,158,9,407.49,3,2,1,6,Regulars
29955,614,8,792.35,1,2,1,4,Hibernating
29956,56,14,2545.19,5,5,4,14,Champions
29957,240,6,958.6300000000001,3,1,2,6,Regulars
29958,37,9,913.9300000000001,5,2,2,9,Regulars
29959,624,8,1372.8,1,2,3,6,Regulars
29960,571,9,911.66,1,2,2,5,Hibernating
29961,497,10,933.9799999999999,1,3,2,6,Regulars
29962,255,14,1566.72,2,5,3,10,At Risk
29963,91,9,1553.95,4,2,3,9,Regulars
29964,284,13,3130.17,2,4,5,11,At Risk
29965,204,9,1393.22,3,2,3,8,Regulars
29966,94,13,3200.42,4,4,5,13,Champions
29967,609,8,1036.35,1,2,2,5,Hibernating
29968,73,15,5651.62,4,5,5,14,Champions
29969,294,8,614.98,2,2,1,5,Hibernating
29970,7,9,2403.3599999999997,5,2,4,11,Big Spenders
29971,501,13,3960.2999999999997,1,4,5,10,At Risk
29972,425,11,781.55,2,3,1,6,Regulars
29973,945,11,1191.29,1,3,2,6,Regulars
29974,118,8,1277.24,4,2,3,9,Regulars
29975,598,6,3370.2599999999998,1,1,5,7,Regulars
29976,45,9,2086.11,5,2,4,11,Big Spenders
29977,345,17,2852.45,2,5,5,12,At Risk
29978,4,7,730.05,5,1,1,7,Regulars
29979,136,15,1086.33,4,5,2,11,Loyal
29980,239,12,2571.22,3,4,4,11,Big Spenders
29981,889,11,2075.63,1,3,4,8,Regulars
29982,1050,8,2284.46,1,2,4,7,Regulars
29983,71,14,1827.78,4,5,4,13,Champions
29984,45,13,1938.3500000000001,5,4,4,13,Champions
29985,80,9,1634.06,4,2,3,9,Regulars
29986,888,7,307.31999999999994,1,1,1,3,Hibernating
29987,791,6,320.14,1,1,1,3,Hibernating
29988,101,8,1387.78,4,2,3,9,Regulars
29989,188,16,3499.04,3,5,5,13,Big Spenders
29990,154,17,3547.19,3,5,5,13,Big Spenders
29991,56,11,1114.75,5,3,2,10,Loyal
29992,100,11,2306.84,4,3,4,11,Loyal
29993,85,11,3623.2799999999997,4,3,5,12,Loyal
29994,58,14,3810.23,5,5,5,15,Champions
29995,681,7,852.5400000000001,1,1,2,4,Hibernating
29996,985,6,635.2,1,1,1,3,Hibernating
29997,59,11,3873.48,5,3,5,13,Loyal
29998,54,13,8435.31,5,4,5,14,Champions
29999,199,8,1798.34,3,2,4,9,Big Spenders
30000,249,5,150.4,2,1,1,4,Hibernating
30001,653,7,938.21,1,1,2,4,Hibernating
30002,35,6,402.04999999999995,5,1,1,7,Regulars
30003,726,5,2076.04,1,1,4,6,Regulars
30004,6,10,1350.35,5,3,3,11,Loyal
30005,54,13,3012.06,5,4,5,14,Champions
30006,125,6,765.77,4,1,1,6,Regulars
30007,9,18,2660.42,5,5,5,15,Champions
30008,148,7,812.48,3,1,1,5,Regulars
30009,458,15,2324.04,2,5,4,11,At Risk
30010,131,11,2285.42,4,3,4,11,Loyal
30011,269,5,445.34999999999997,2,1,1,4,Hibernating
30012,28,11,608.13,5,3,1,9,Loyal
30013,484,12,5414.29,1,4,5,10,At Risk
30014,48,11,1419.5,5,3,3,11,Loyal
30015,378,17,2017.71,2,5,4,11,At Risk
30016,25,8,655.0,5,2,1,8,Regulars
30017,289,6,1676.4900000000002,2,1,3,6,Regulars
30018,81,4,1130.6499999999999,4,1,2,7,Regulars
30019,34,14,5145.49,5,5,5,15,Champions
30020,1,10,704.77,5,3,1,9,Loyal
30021,152,8,641.6,3,2,1,6,Regulars
30022,221,9,2226.15,3,2,4,9,Big Spenders
30023,410,15,3704.41,2,5,5,12,At Risk
30024,26,12,1339.79,5,4,3,12,Loyal
30025,138,8,3114.62,4,2,5,11,Big Spenders
30026,524,8,1086.93,1,2,2,5,Hibernating
30027,29,15,1366.27,5,5,3,13,Loyal
30028,1157,6,378.26,1,1,1,3,Hibernating
30029,275,8,631.61,2,2,1,5,Hibernating
30030,613,11,2556.26,1,3,4,8,Regulars
30031,338,11,1603.49,2,3,3,8,Regulars
30032,103,14,2623.87,4,5,5,14,Champions
30033,355,7,1937.76,2,1,4,7,Regulars
30034,357,16,1518.86,2,5,3,10,At Risk
30035,524,10,3869.69,1,3,5,9,Regulars
30036,545,10,1335.1,1,3,3,7,Regulars
30037,123,8,1078.8,4,2,2,8,Regulars
30038,110,5,2302.1,4,1,4,9,Big Spenders
30039,40,11,1354.75,5,3,3,11,Loyal
30040,190,12,1561.28,3,4,3,10,Regulars
30041,276,6,344.78000000000003,2,1,1,4,Hibernating
30042,785,13,2575.79,1,4,5,10,At Risk
30043,7,12,2017.0900000000001,5,4,4,13,Champions
30044,224,12,1170.28,3,4,2,9,Regulars
30045,555,14,4042.75,1,5,5,11,At Risk
30046,181,10,860.05,3,3,2,8,Regulars
30047,307,13,2486.12,2,4,4,10,At Risk
30048,235,5,312.39,3,1,1,5,Regulars
30049,132,13,3828.6099999999997,4,4,5,13,Champions
30050,146,18,3117.7599999999998,4,5,5,14,Champions
30051,243,8,966.59,3,2,2,7,Regulars
30052,250,17,6292.49,2,5,5,12,At Risk
30053,46,5,720.16,5,1,1,7,Regulars
30054,78,10,1343.34,4,3,3,10,Loyal
30055,126,17,3119.3599999999997,4,5,5,14,Champions
30056,412,11,1553.23,2,3,3,8,Regulars
30057,443,6,624.9300000000001,2,1,1,4,Hibernating
30058,2224,5,1540.57,1,1,3,5,Regulars
30059,388,11,7148.22,2,3,5,10,Regulars
30060,220,10,3172.4700000000003,3,3,5,11,Big Spenders
30061,58,10,1366.0700000000002,5,3,3,11,Loyal
30062,442,6,385.72,2,1,1,4,Hibernating
30063,155,10,1596.46,3,3,3,9,Regulars
30064,76,11,1140.07,4,3,2,9,Loyal
30065,538,8,1140.6999999999998,1,2,2,5,Hibernating
30066,466,11,1009.68,1,3,2,6,Regulars
30067,830,9,664.28,1,2,1,4,Hibernating
30068,254,12,1400.46,2,4,3,9,At Risk
30069,142,6,495.48,4,1,1,6,Regulars
30070,389,8,1674.14,2,2,3,7,Regulars
30071,5,12,1190.46,5,4,2,11,Loyal
30072,39,10,2762.8799999999997,5,3,5,13,Loyal
30073,117,5,601.0699999999999,4,1,1,6,Regulars
30074,45,6,874.77,5,1,2,8,Regulars
30075,84,15,3986.12,4,5,5,14,Champions
30076,613,9,1660.25,1,2,3,6,Regulars
30077,226,12,1307.01,3,4,3,10,Regulars
30078,226,8,526.4000000000001,3,2,1,6,Regulars
30079,82,11,2227.47,4,3,4,11,Loyal
30080,172,9,1103.54,3,2,2,7,Regulars
30081,192,14,1128.6399999999999,3,5,2,10,Regulars
30082,117,13,3534.9699999999993,4,4,5,13,Champions
30083,377,12,3393.1800000000003,2,4,5,11,At Risk
30084,7,15,4042.23,5,5,5,15,Champions
30085,269,7,755.52,2,1,1,4,Hibernating
30086,391,8,722.6999999999999,2,2,1,5,Hibernating
30087,22,12,3382.3900000000003,5,4,5,14,Champions
30088,116,12,2357.65,4,4,4,12,Champions
30089,177,11,2614.88,3,3,5,11,Big Spenders
30090,7,9,1332.3000000000002,5,2,3,10,Regulars
30091,27,9,1979.0800000000002,5,2,4,11,Big Spenders
30092,123,9,1414.72,4,2,3,9,Regulars
30093,44,13,4121.92,5,4,5,14,Champions
30094,99,9,850.78,4,2,2,8,Regulars
30095,310,10,1308.53,2,3,3,8,Regulars
30096,21,7,980.55,5,1,2,8,Regulars
30097,101,10,1312.48,4,3,3,10,Loyal
30098,400,6,490.76,2,1,1,4,Hibernating
30099,72,7,413.27,4,1,1,6,Regulars
30100,205,18,1969.61,3,5,4,12,Big Spenders
30101,244,15,908.77,3,5,2,10,Regulars
30102,19,13,1090.74,5,4,2,11,Loyal
30103,606,6,880.46,1,1,2,4,Hibernating
30104,166,9,1055.3500000000001,3,2,2,7,Regulars
30105,397,9,1742.7,2,2,4,8,Regulars
30106,110,13,1221.83,4,4,2,10,Loyal
30107,180,11,1535.1599999999999,3,3,3,9,Regulars
30108,64,8,1709.24,5,2,3,10,Regulars
30109,318,7,3612.81,2,1,5,8,Regulars
30110,91,9,1661.56,4,2,3,9,Regulars
30111,128,8,551.9,4,2,1,7,Regulars
30112,570,9,519.22,1,2,1,4,Hibernating
30113,6,12,1463.31,5,4,3,12,Loyal
30114,28,10,1445.42,5,3,3,11,Loyal
30115,90,10,1550.5900000000001,4,3,3,10,Loyal
30116,90,17,2518.4,4,5,4,13,Champions
30117,156,10,2134.6,3,3,4,10,Big Spenders
30118,486,17,3162.07,1,5,5,11,At Risk
30119,127,11,4424.28,4,3,5,12,Loyal
30120,290,4,1018.45,2,1,2,5,Hibernating
30121,413,9,1320.11,2,2,3,7,Regulars
30122,823,4,647.73,1,1,1,3,Hibernating
30123,236,6,636.05,3,1,1,5,Regulars
30124,816,4,811.3499999999999,1,1,1,3,Hibernating
30125,451,9,1384.08,2,2,3,7,Regulars
30126,467,10,2017.2,1,3,4,8,Regulars
30127,1,16,2709.3799999999997,5,5,5,15,Champions
30128,37,13,1451.65,5,4,3,12,Loyal
30129,112,8,1030.77,4,2,2,8,Regulars
30130,230,12,1315.06,3,4,3,10,Regulars
30131,215,10,2333.46,3,3,4,10,Big Spenders
30132,52,11,1413.8899999999999,5,3,3,11,Loyal
30133,67,8,742.1700000000001,4,2,1,7,Regulars
30134,139,11,2277.5299999999997,4,3,4,11,Loyal
30135,241,16,2750.22,3,5,5,13,Big Spenders
30136,15,14,1431.2099999999998,5,5,3,13,Loyal
30137,46,12,2177.3599999999997,5,4,4,13,Champions
30138,99,7,1750.7,4,1,4,9,Big Spenders
30139,309,6,1092.77,2,1,2,5,Hibernating
30140,2,15,2756.9900000000002,5,5,5,15,Champions
30141,103,10,2358.36,4,3,4,11,Loyal
30142,284,10,577.65,2,3,1,6,Regulars
30143,52,9,1062.37,5,2,2,9,Regulars
30144,455,10,3563.38,2,3,5,10,Regulars
30145,122,15,2779.21,4,5,5,14,Champions
30146,78,9,941.98,4,2,2,8,Regulars
30147,802,9,766.45,1,2,1,4,Hibernating
30148,480,7,1410.99,1,1,3,5,Regulars
30149,118,8,1026.25,4,2,2,8,Regulars
30150,196,10,1360.77,3,3,3,9,Regulars
30151,372,11,2502.3,2,3,4,9,Regulars
30152,323,10,1559.69,2,3,3,8,Regulars
30153,65,8,567.4300000000001,5,2,1,8,Regulars
30154,21,13,1339.1200000000001,5,4,3,12,Loyal
30155,150,18,1839.63,3,5,4,12,Big Spenders
30156,579,4,797.0799999999999,1,1,1,3,Hibernating
30157,167,13,1228.15,3,4,2,9,Regulars
30158,136,12,687.9399999999999,4,4,1,9,Loyal
30159,7,13,3053.6600000000003,5,4,5,14,Champions
30160,413,9,1186.07,2,2,2,6,Hibernating
30161,344,8,950.57,2,2,2,6,Hibernating
30162,486,10,822.36,1,3,1,5,Regulars
30163,369,8,772.79,2,2,1,5,Hibernating
30164,82,13,1148.3999999999999,4,4,2,10,Loyal
30165,353,6,979.34,2,1,2,5,Hibernating
30166,162,6,1657.46,3,1,3,7,Regulars
30167,50,13,962.81,5,4,2,11,Loyal
30168,446,11,4571.280000000001,2,3,5,10,Regulars
30169,263,12,1953.1599999999999,2,4,4,10,At Risk
30170,16,9,1393.02,5,2,3,10,Regulars
30171,234,6,551.07,3,1,1,5,Regulars
30172,92,14,2129.37,4,5,4,13,Champions
30173,1037,8,573.14,1,2,1,4,Hibernating
30174,280,17,3009.03,2,5,5,12,At Risk
30175,447,11,2041.98,2,3,4,9,Regulars
30176,257,10,1223.1,2,3,2,7,Regulars
30177,530,7,2174.1499999999996,1,1,4,6,Regulars
30178,418,11,1466.3,2,3,3,8,Regulars
30179,282,17,2073.6,2,5,4,11,At Risk
30180,128,12,3540.16,4,4,5,13,Champions
30181,125,8,1638.92,4,2,3,9,Regulars
30182,588,5,1301.1499999999999,1,1,3,5,Regulars
30183,445,10,3268.36,2,3,5,10,Regulars
30184,317,12,2212.59,2,4,4,10,At Risk
30185,17,16,3068.5099999999998,5,5,5,15,Champions
30186,138,10,2428.61,4,3,4,11,Loyal
30187,174,9,544.02,3,2,1,6,Regulars
30188,449,10,1818.82,2,3,4,9,Regulars
30189,21,13,3814.9799999999996,5,4,5,14,Champions
30190,113,7,1847.73,4,1,4,9,Big Spenders
30191,150,11,2543.19,3,3,4,10,Big Spenders
30192,94,11,2347.39,4,3,4,11,Loyal
30193,446,10,1615.89,2,3,3,8,Regulars
30194,726,13,1518.8400000000001,1,4,3,8,At Risk
30195,444,10,664.57,2,3,1,6,Regulars
30196,531,9,2729.8599999999997,1,2,5,8,Regulars
30197,4,12,1451.74,5,4,3,12,Loyal
30198,344,8,830.86,2,2,1,5,Hibernating
30199,498,14,1334.9099999999999,1,5,3,9,At Risk
30200,42,7,1291.0800000000002,5,1,3,9,Regulars
30201,90,11,2832.74,4,3,5,12,Loyal
30202,53,13,2931.62,5,4,5,14,Champions
30203,940,4,1065.13,1,1,2,4,Hibernating
30204,379,8,1031.0,2,2,2,6,Hibernating
30205,8,10,1930.44,5,3,4,12,Loyal
30206,132,7,782.24,4,1,1,6,Regulars
30207,1401,9,983.6899999999999,1,2,2,5,Hibernating
30208,404,8,468.32,2,2,1,5,Hibernating
30209,391,3,212.48,2,1,1,4,Hibernating
30210,223,15,3208.42,3,5,5,13,Big Spenders
30211,23,11,1526.42,5,3,3,11,Loyal
30212,120,17,3848.6900000000005,4,5,5,14,Champions
30213,363,9,1044.4,2,2,2,6,Hibernating
30214,126,9,655.85,4,2,1,7,Regulars
30215,166,9,1341.36,3,2,3,8,Regulars
30216,31,8,1576.87,5,2,3,10,Regulars
30217,193,13,1028.59,3,4,2,9,Regulars
30218,268,9,1729.38,2,2,4,8,Regulars
30219,135,5,552.08,4,1,1,6,Regulars
30220,467,14,2448.09,1,5,4,10,At Risk
30221,258,12,909.49,2,4,2,8,At Risk
30222,201,9,558.1500000000001,3,2,1,6,Regulars
30223,473,10,579.96,1,3,1,5,Regulars
30224,442,6,938.44,2,1,2,5,Hibernating
30225,21,12,1095.16,5,4,2,11,Loyal
30226,189,10,2168.03,3,3,4,10,Big Spenders
30227,27,11,1169.7,5,3,2,10,Loyal
30228,283,10,924.75,2,3,2,7,Regulars
30229,445,11,3139.8599999999997,2,3,5,10,Regulars
30230,412,9,678.6700000000001,2,2,1,5,Hibernating
30231,305,14,3743.5299999999997,2,5,5,12,At Risk
30232,270,12,2832.63,2,4,5,11,At Risk
30233,89,8,1376.24,4,2,3,9,Regulars
30234,794,6,375.97,1,1,1,3,Hibernating
30235,170,15,1702.74,3,5,3,11,Regulars
30236,190,9,3068.0099999999998,3,2,5,10,Big Spenders
30237,335,12,1927.44,2,4,4,10,At Risk
30238,236,12,2760.74,3,4,5,12,Big Spenders
30239,473,8,770.45,1,2,1,4,Hibernating
30240,317,6,403.65,2,1,1,4,Hibernating
30241,379,13,2086.0099999999998,2,4,4,10,At Risk
30242,474,10,1599.78,1,3,3,7,Regulars
30243,784,10,1973.56,1,3,4,8,Regulars
30244,69,7,1528.3400000000001,4,1,3,8,Regulars
30245,357,15,2319.91,2,5,4,11,At Risk
30246,128,14,4201.12,4,5,5,14,Champions
30247,252,16,1717.7199999999998,2,5,3,10,At Risk
30248,286,9,810.15,2,2,1,5,Hibernating
30249,64,9,1228.51,5,2,2,9,Regulars
30250,91,14,1862.6399999999999,4,5,4,13,Champions
30251,228,5,503.78999999999996,3,1,1,5,Regulars
30252,620,8,3208.65,1,2,5,8,Regulars
30253,409,7,541.55,2,1,1,4,Hibernating
30254,129,7,2122.14,4,1,4,9,Big Spenders
30255,81,9,569.68,4,2,1,7,Regulars
30256,87,20,3211.29,4,5,5,14,Champions
30257,149,7,695.55,3,1,1,5,Regulars
30258,383,9,2138.29,2,2,4,8,Regulars
30259,747,8,938.5600000000001,1,2,2,5,Hibernating
30260,4,9,1077.74,5,2,2,9,Regulars
30261,320,12,976.03,2,4,2,8,At Risk
30262,251,11,2638.08,2,3,5,10,Regulars
30263,197,11,1611.28,3,3,3,9,Regulars
30264,216,15,2305.0,3,5,4,12,Big Spenders
30265,65,12,1258.0900000000001,5,4,3,12,Loyal
30266,179,14,1387.58,3,5,3,11,Regulars
30267,100,12,1239.8,4,4,2,10,Loyal
30268,78,13,1453.63,4,4,3,11,Loyal
30269,39,7,2615.86,5,1,5,11,Big Spenders
30270,53,6,737.0699999999999,5,1,1,7,Regulars
30271,87,10,741.05,4,3,1,8,Loyal
30272,85,11,1010.23,4,3,2,9,Loyal
30273,302,8,597.06,2,2,1,5,Hibernating
30274,355,14,1746.46,2,5,4,11,At Risk
30275,822,13,1263.97,1,4,3,8,At Risk
30276,790,12,2769.92,1,4,5,10,At Risk
30277,123,15,1824.15,4,5,4,13,Champions
30278,706,9,926.6099999999999,1,2,2,5,Hibernating
30279,70,13,1598.15,4,4,3,11,Loyal
30280,232,12,2794.03,3,4,5,12,Big Spenders
30281,336,14,2986.25,2,5,5,12,At Risk
30282,416,15,2555.41,2,5,4,11,At Risk
30283,307,11,1383.18,2,3,3,8,Regulars
30284,733,3,162.14,1,1,1,3,Hibernating
30285,573,8,1287.0500000000002,1,2,3,6,Regulars
30286,50,5,363.33,5,1,1,7,Regulars
30287,111,8,1616.3700000000001,4,2,3,9,Regulars
30288,508,8,2844.79,1,2,5,8,Regulars
30289,14,12,3537.6900000000005,5,4,5,14,Champions
30290,189,10,1218.04,3,3,2,8,Regulars
30291,160,12,1115.19,3,4,2,9,Regulars
30292,122,13,972.8499999999999,4,4,2,10,Loyal
30293,266,12,1702.18,2,4,3,9,At Risk
30294,208,8,2576.7,3,2,5,10,Big Spenders
30295,260,10,3184.58,2,3,5,10,Regulars
30296,153,7,389.24,3,1,1,5,Regulars
30297,722,10,962.5,1,3,2,6,Regulars
30298,216,16,2102.92,3,5,4,12,Big Spenders
30299,176,14,1154.4,3,5,2,10,Regulars
30300,63,13,7614.04,5,4,5,14,Champions
30301,726,12,1776.27,1,4,4,9,At Risk
30302,789,7,672.89,1,1,1,3,Hibernating
30303,118,7,437.34,4,1,1,6,Regulars
30304,127,5,943.13,4,1,2,7,Regulars
30305,53,12,936.59,5,4,2,11,Loyal
30306,49,8,1663.9199999999998,5,2,3,10,Regulars
30307,524,10,5401.0599999999995,1,3,5,9,Regulars
30308,480,5,562.84,1,1,1,3,Hibernating
30309,193,7,378.5,3,1,1,5,Regulars
30310,53,11,2775.52,5,3,5,13,Loyal
30311,93,11,1092.16,4,3,2,9,Loyal
30312,210,11,1067.31,3,3,2,8,Regulars
30313,570,4,361.5799999999999,1,1,1,3,Hibernating
30314,123,10,1255.27,4,3,3,10,Loyal
30315,1204,6,716.77,1,1,1,3,Hibernating
30316,419,5,413.44,2,1,1,4,Hibernating
30317,28,10,2843.4900000000002,5,3,5,13,Loyal
30318,35,7,530.34,5,1,1,7,Regulars
30319,839,4,720.89,1,1,1,3,Hibernating
30320,232,14,2961.54,3,5,5,13,Big Spenders
30321,1310,4,306.13,1,1,1,3,Hibernating
30322,52,7,837.29,5,1,1,7,Regulars
30323,588,9,861.5500000000001,1,2,2,5,Hibernating
30324,208,9,1451.07,3,2,3,8,Regulars
30325,52,14,2771.54,5,5,5,15,Champions
30326,193,9,2792.11,3,2,5,10,Big Spenders
30327,20,11,1912.8999999999999,5,3,4,12,Loyal
30328,118,12,1375.08,4,4,3,11,Loyal
30329,250,9,693.73,2,2,1,5,Hibernating
30330,85,11,3930.56,4,3,5,12,Loyal
30331,248,15,2862.0099999999998,2,5,5,12,At Risk
30332,666,7,505.61,1,1,1,3,Hibernating
30333,59,13,1019.36,5,4,2,11,Loyal
30334,277,7,609.15,2,1,1,4,Hibernating
30335,48,15,1163.73,5,5,2,12,Loyal
30336,138,15,2030.23,4,5,4,13,Champions
30337,4,7,1495.0700000000002,5,1,3,9,Regulars
30338,98,8,1346.57,4,2,3,9,Regulars
30339,227,12,1374.86,3,4,3,10,Regulars
30340,173,12,6078.56,3,4,5,12,Big Spenders
30341,80,15,2085.8199999999997,4,5,4,13,Champions
30342,339,12,1898.76,2,4,4,10,At Risk
30343,978,12,1582.97,1,4,3,8,At Risk
30344,123,10,2381.23,4,3,4,11,Loyal
30345,38,7,1177.96,5,1,2,8,Regulars
30346,350,17,1340.0,2,5,3,10,At Risk
30347,93,11,1594.75,4,3,3,10,Loyal
30348,284,10,736.12,2,3,1,6,Regulars
30349,4,17,6285.7,5,5,5,15,Champions
30350,113,9,911.76,4,2,2,8,Regulars
30351,399,10,1143.14,2,3,2,7,Regulars
30352,553,10,1067.91,1,3,2,6,Regulars
30353,186,13,896.64,3,4,2,9,Regulars
30354,133,12,2784.15,4,4,5,13,Champions
30355,13,8,1397.3,5,2,3,10,Regulars
30356,235,10,652.0799999999999,3,3,1,7,Regulars
30357,258,12,1063.85,2,4,2,8,At Risk
30358,330,8,1152.3500000000001,2,2,2,6,Hibernating
30359,331,12,2147.6,2,4,4,10,At Risk
30360,83,5,573.82,4,1,1,6,Regulars
30361,853,5,613.33,1,1,1,3,Hibernating
30362,505,10,1465.44,1,3,3,7,Regulars
30363,425,8,461.37,2,2,1,5,Hibernating
30364,173,14,2956.35,3,5,5,13,Big Spenders
30365,590,16,2094.96,1,5,4,10,At Risk
30366,224,10,982.04,3,3,2,8,Regulars
30367,723,5,312.13,1,1,1,3,Hibernating
30368,235,10,1373.2900000000002,3,3,3,9,Regulars
30369,211,13,2457.67,3,4,4,11,Big Spenders
30370,43,5,462.2,5,1,1,7,Regulars
30371,202,14,3695.04,3,5,5,13,Big Spenders
30372,313,8,954.2,2,2,2,6,Hibernating
30373,74,10,1649.1100000000001,4,3,3,10,Loyal
30374,255,11,930.51,2,3,2,7,Regulars
30375,637,8,1126.0600000000002,1,2,2,5,Hibernating
30376,42,13,2339.21,5,4,4,13,Champions
30377,58,11,1912.42,5,3,4,12,Loyal
30378,159,5,1519.13,3,1,3,7,Regulars
30379,84,7,1692.62,4,1,3,8,Regulars
30380,44,12,1845.3200000000002,5,4,4,13,Champions
30381,4,9,769.69,5,2,1,8,Regulars
30382,92,4,1011.1199999999999,4,1,2,7,Regulars
30383,64,11,1694.55,5,3,3,11,Loyal
30384,194,9,1023.73,3,2,2,7,Regulars
30385,454,17,4032.07,2,5,5,12,At Risk
30386,236,12,1260.38,3,4,3,10,Regulars
30387,389,15,4004.9700000000003,2,5,5,12,At Risk
30388,453,11,1529.7,2,3,3,8,Regulars
30389,186,9,720.3000000000001,3,2,1,6,Regulars
30390,45,6,1703.42,5,1,3,9,Regulars
30391,346,12,1416.07,2,4,3,9,At Risk
30392,197,12,3736.3700000000003,3,4,5,12,Big Spenders
30393,179,12,1290.17,3,4,3,10,Regulars
30394,27,11,1894.8000000000002,5,3,4,12,Loyal
30395,475,7,1240.28,1,1,2,4,Hibernating
30396,151,7,678.6899999999999,3,1,1,5,Regulars
30397,122,12,1522.39,4,4,3,11,Loyal
30398,33,12,986.49,5,4,2,11,Loyal
30399,213,8,2885.9100000000003,3,2,5,10,Big Spenders
30400,172,9,2383.05,3,2,4,9,Big Spenders
30401,126,11,880.97,4,3,2,9,Loyal
30402,27,10,1352.45,5,3,3,11,Loyal
30403,412,11,1568.1100000000001,2,3,3,8,Regulars
30404,2,18,5705.14,5,5,5,15,Champions
30405,1274,7,932.09,1,1,2,4,Hibernating
30406,222,12,4788.5599999999995,3,4,5,12,Big Spenders
30407,521,6,2854.9900000000002,1,1,5,7,Regulars
30408,196,8,478.24,3,2,1,6,Regulars
30409,10,11,929.7199999999999,5,3,2,10,Loyal
30410,845,11,1434.8600000000001,1,3,3,7,Regulars
30411,56,12,1842.48,5,4,4,13,Champions
30412,92,9,2711.83,4,2,5,11,Big Spenders
30413,286,10,3103.04,2,3,5,10,Regulars
30414,223,16,1895.87,3,5,4,12,Big Spenders
30415,103,7,430.6,4,1,1,6,Regulars
30416,771,8,967.56,1,2,2,5,Hibernating
30417,173,11,2402.8599999999997,3,3,4,10,Big Spenders
30418,152,11,2375.43,3,3,4,10,Big Spenders
30419,148,13,1972.6399999999999,3,4,4,11,Big Spenders
30420,771,6,1102.27,1,1,2,4,Hibernating
30421,275,12,3038.19,2,4,5,11,At Risk
30422,287,10,1376.09,2,3,3,8,Regulars
30423,177,7,940.26,3,1,2,6,Regulars
30424,169,10,820.8299999999999,3,3,1,7,Regulars
30425,333,9,725.77,2,2,1,5,Hibernating
30426,212,9,1379.44,3,2,3,8,Regulars
30427,790,7,623.4300000000001,1,1,1,3,Hibernating
30428,159,11,1848.8,3,3,4,10,Big Spenders
30429,48,11,1515.61,5,3,3,11,Loyal
30430,100,8,676.0999999999999,4,2,1,7,Regulars
30431,111,10,1577.1200000000001,4,3,3,10,Loyal
30432,23,9,999.1,5,2,2,9,Regulars
30433,6,10,2033.12,5,3,4,12,Loyal
30434,552,8,1443.8200000000002,1,2,3,6,Regulars
30435,297,8,932.32,2,2,2,6,Hibernating
30436,5,10,5192.96,5,3,5,13,Loyal
30437,922,8,998.8900000000001,1,2,2,5,Hibernating
30438,229,12,1810.8799999999999,3,4,4,11,Big Spenders
30439,497,1,70.98,1,1,1,3,Hibernating
30440,195,7,1979.77,3,1,4,8,Big Spenders
30441,10,9,2160.0699999999997,5,2,4,11,Big Spenders
30442,156,14,3822.5799999999995,3,5,5,13,Big Spenders
30443,35,14,1947.84,5,5,4,14,Champions
30444,208,11,1296.3100000000002,3,3,3,9,Regulars
30445,113,13,919.7900000000001,4,4,2,10,Loyal
30446,120,14,2696.48,4,5,5,14,Champions
30447,347,10,3442.94,2,3,5,10,Regulars
30448,155,13,969.25,3,4,2,9,Regulars
30449,148,7,614.35,3,1,1,5,Regulars
30450,43,13,1233.34,5,4,2,11,Loyal
30451,548,7,529.82,1,1,1,3,Hibernating
30452,556,7,529.1,1,1,1,3,Hibernating
30453,435,13,1389.23,2,4,3,9,At Risk
30454,195,13,2892.46,3,4,5,12,Big Spenders
30455,440,16,1174.63,2,5,2,9,At Risk
30456,148,8,808.7,3,2,1,6,Regulars
30457,314,6,313.48,2,1,1,4,Hibernating
30458,257,11,1871.29,2,3,4,9,Regulars
30459,517,10,2463.09,1,3,4,8,Regulars
30460,295,11,1029.23,2,3,2,7,Regulars
30461,203,5,1222.48,3,1,2,6,Regulars
30462,90,16,1355.54,4,5,3,12,Loyal
30463,413,7,721.83,2,1,1,4,Hibernating
30464,261,6,248.76999999999998,2,1,1,4,Hibernating
30465,109,7,1008.9,4,1,2,7,Regulars
30466,221,12,1630.02,3,4,3,10,Regulars
30467,248,7,3191.7499999999995,2,1,5,8,Regulars
30468,1,14,3146.95,5,5,5,15,Champions
30469,81,15,1155.63,4,5,2,11,Loyal
30470,41,11,2923.62,5,3,5,13,Loyal
30471,1048,8,973.6600000000001,1,2,2,5,Hibernating
30472,374,7,745.52,2,1,1,4,Hibernating
30473,665,7,646.5600000000001,1,1,1,3,Hibernating
30474,745,7,5650.05,1,1,5,7,Regulars
30475,206,10,1269.6100000000001,3,3,3,9,Regulars
30476,31,8,477.64,5,2,1,8,Regulars
30477,228,10,783.3,3,3,1,7,Regulars
30478,430,17,4277.44,2,5,5,12,At Risk
30479,81,13,1610.34,4,4,3,11,Loyal
30480,45,10,808.27,5,3,1,9,Loyal
30481,49,12,2687.5800000000004,5,4,5,14,Champions
30482,520,11,1186.99,1,3,2,6,Regulars
30483,69,12,2798.53,4,4,5,13,Champions
30484,27,10,1222.85,5,3,2,10,Loyal
30485,266,11,1500.81,2,3,3,8,Regulars
30486,103,9,622.58,4,2,1,7,Regulars
30487,45,11,2966.02,5,3,5,13,Loyal
30488,22,11,1433.46,5,3,3,11,Loyal
30489,80,10,883.7099999999999,4,3,2,9,Loyal
30490,901,5,1554.56,1,1,3,5,Regulars
30491,147,13,1876.1,4,4,4,12,Champions
30492,18,15,789.56,5,5,1,11,Loyal
30493,87,13,3359.68,4,4,5,13,Champions
30494,407,10,695.1,2,3,1,6,Regulars
30495,368,10,1114.6399999999999,2,3,2,7,Regulars
30496,29,7,1263.6000000000001,5,1,3,9,Regulars
30497,61,9,870.76,5,2,2,9,Regulars
30498,144,10,2663.0299999999997,4,3,5,12,Loyal
30499,533,7,1348.7,1,1,3,5,Regulars
30500,991,5,1209.62,1,1,2,4,Hibernating
30501,209,9,2431.3300000000004,3,2,4,9,Big Spenders
30502,457,13,2453.33,2,4,4,10,At Risk
30503,71,10,1477.29,4,3,3,10,Loyal
30504,229,10,1315.8,3,3,3,9,Regulars
30505,142,13,1195.43,4,4,2,10,Loyal
30506,476,9,584.38,1,2,1,4,Hibernating
30507,218,8,1749.46,3,2,4,9,Big Spenders
30508,80,6,619.25,4,1,1,6,Regulars
30509,49,13,1275.56,5,4,3,12,Loyal
30510,225,11,1042.09,3,3,2,8,Regulars
30511,416,7,1177.84,2,1,2,5,Hibernating
30512,125,11,623.73,4,3,1,8,Loyal
30513,29,18,1386.25,5,5,3,13,Loyal
30514,610,10,5130.27,1,3,5,9,Regulars
30515,360,7,1415.1100000000001,2,1,3,6,Regulars
30516,449,8,1535.13,2,2,3,7,Regulars
30517,74,11,1513.93,4,3,3,10,Loyal
30518,431,13,2644.2599999999998,2,4,5,11,At Risk
30519,188,15,3293.58,3,5,5,13,Big Spenders
30520,1569,8,2333.98,1,2,4,7,Regulars
30521,2,12,742.1700000000001,5,4,1,10,Loyal
30522,202,13,1381.9699999999998,3,4,3,10,Regulars
30523,104,12,2801.43,4,4,5,13,Champions
30524,625,12,1738.21,1,4,4,9,At Risk
30525,140,11,1431.77,4,3,3,10,Loyal
30526,124,15,4803.01,4,5,5,14,Champions
30527,150,3,307.82,3,1,1,5,Regulars
30528,69,11,1218.76,4,3,2,9,Loyal
30529,590,13,1143.62,1,4,2,7,At Risk
30530,173,15,1578.45,3,5,3,11,Regulars
30531,179,11,1523.13,3,3,3,9,Regulars
30532,505,9,1885.1600000000003,1,2,4,7,Regulars
30533,97,10,3269.3399999999997,4,3,5,12,Loyal
30534,6,7,540.07,5,1,1,7,Regulars
30535,153,13,2263.5499999999997,3,4,4,11,Big Spenders
30536,367,9,1308.18,2,2,3,7,Regulars
30537,43,6,590.99,5,1,1,7,Regulars
30538,1047,10,1479.3,1,3,3,7,Regulars
30539,21,14,2752.89,5,5,5,15,Champions
30540,22,11,3011.2700000000004,5,3,5,13,Loyal
30541,57,15,2149.62,5,5,4,14,Champions
30542,267,9,1046.77,2,2,2,6,Hibernating
30543,99,5,581.48,4,1,1,6,Regulars
30544,323,7,1722.5600000000002,2,1,3,6,Regulars
30545,192,8,3896.58,3,2,5,10,Big Spenders
30546,82,7,470.58000000000004,4,1,1,6,Regulars
30547,308,11,1562.42,2,3,3,8,Regulars
30548,234,6,793.38,3,1,1,5,Regulars
30549,251,8,960.94,2,2,2,6,Hibernating
30550,100,14,1483.61,4,5,3,12,Loyal
30551,331,9,3592.3199999999997,2,2,5,9,Regulars
30552,67,8,1447.05,4,2,3,9,Regulars
30553,187,11,1011.13,3,3,2,8,Regulars
30554,175,6,712.6,3,1,1,5,Regulars
30555,819,6,303.38,1,1,1,3,Hibernating
30556,257,15,2064.54,2,5,4,11,At Risk
30557,167,14,1379.46,3,5,3,11,Regulars
30558,101,8,2098.89,4,2,4,10,Big Spenders
30559,96,10,1392.38,4,3,3,10,Loyal
30560,430,13,2821.1,2,4,5,11,At Risk
30561,73,16,2092.61,4,5,4,13,Champions
30562,727,8,1135.85,1,2,2,5,Hibernating
30563,724,11,1919.6200000000001,1,3,4,8,Regulars
30564,278,8,2623.79,2,2,5,9,Regulars
30565,262,9,2457.07,2,2,4,8,Regulars
30566,288,8,702.41,2,2,1,5,Hibernating
30567,313,18,3348.0099999999998,2,5,5,12,At Risk
30568,703,7,1187.38,1,1,2,4,Hibernating
30569,474,11,2631.21,1,3,5,9,Regulars
30570,230,11,1146.48,3,3,2,8,Regulars
30571,614,8,835.02,1,2,1,4,Hibernating
30572,565,13,1589.58,1,4,3,8,At Risk
30573,36,14,1339.81,5,5,3,13,Loyal
30574,1360,8,736.38,1,2,1,4,Hibernating
30575,241,10,2053.93,3,3,4,10,Big Spenders
30576,2223,3,182.05,1,1,1,3,Hibernating
30577,83,10,1084.57,4,3,2,9,Loyal
30578,912,6,2252.91,1,1,4,6,Regulars
30579,347,10,1386.1,2,3,3,8,Regulars
30580,12,18,2064.2599999999998,5,5,4,14,Champions
30581,473,4,543.11,1,1,1,3,Hibernating
30582,271,12,3445.54,2,4,5,11,At Risk
30583,69,8,3755.81,4,2,5,11,Big Spenders
30584,275,12,858.71,2,4,2,8,At Risk
30585,264,9,1767.26,2,2,4,8,Regulars
30586,83,13,1544.0300000000002,4,4,3,11,Loyal
30587,290,12,3375.7099999999996,2,4,5,11,At Risk
30588,177,12,841.99,3,4,1,8,Regulars
30589,179,11,1175.96,3,3,2,8,Regulars
30590,414,9,1410.8,2,2,3,7,Regulars
30591,837,7,970.49,1,1,2,4,Hibernating
30592,81,9,1602.5400000000002,4,2,3,9,Regulars
30593,57,10,2377.79,5,3,4,12,Loyal
30594,22,9,1356.74,5,2,3,10,Regulars
30595,34,7,1772.79,5,1,4,10,Big Spenders
30596,54,10,2147.7799999999997,5,3,4,12,Loyal
30597,199,5,3099.85,3,1,5,9,Big Spenders
30598,113,12,1131.15,4,4,2,10,Loyal
30599,267,9,1864.95,2,2,4,8,Regulars
30600,482,13,1828.89,1,4,4,9,At Risk
30601,56,8,3881.5499999999997,5,2,5,12,Big Spenders
30602,65,13,3498.1000000000004,5,4,5,14,Champions
30603,124,11,2737.27,4,3,5,12,Loyal
30604,93,5,436.5,4,1,1,6,Regulars
30605,4,11,1850.3200000000002,5,3,4,12,Loyal
30606,247,6,1397.17,3,1,3,7,Regulars
30607,38,5,257.23,5,1,1,7,Regulars
30608,50,7,1222.48,5,1,2,8,Regulars
30609,33,15,1873.48,5,5,4,14,Champions
30610,307,12,1444.18,2,4,3,9,At Risk
30611,61,6,832.14,5,1,1,7,Regulars
30612,38,9,868.6099999999999,5,2,2,9,Regulars
30613,264,9,2767.12,2,2,5,9,Regulars
30614,50,5,391.27,5,1,1,7,Regulars
30615,531,7,621.23,1,1,1,3,Hibernating
30616,33,10,969.9,5,3,2,10,Loyal
30617,444,9,605.61,2,2,1,5,Hibernating
30618,515,8,699.77,1,2,1,4,Hibernating
30619,119,11,1046.67,4,3,2,9,Loyal
30620,696,4,993.72,1,1,2,4,Hibernating
30621,102,12,2237.19,4,4,4,12,Champions
30622,225,14,2502.98,3,5,4,12,Big Spenders
30623,181,14,1969.59,3,5,4,12,Big Spenders
30624,571,6,430.09000000000003,1,1,1,3,Hibernating
30625,237,12,4861.9400000000005,3,4,5,12,Big Spenders
30626,162,11,2246.1800000000003,3,3,4,10,Big Spenders
30627,137,9,690.1800000000001,4,2,1,7,Regulars
30628,197,9,1726.6399999999999,3,2,4,9,Big Spenders
30629,35,12,1052.73,5,4,2,11,Loyal
30630,504,10,1571.6399999999999,1,3,3,7,Regulars
30631,287,5,534.1,2,1,1,4,Hibernating
30632,10,10,1218.4,5,3,2,10,Loyal
30633,20,16,3239.69,5,5,5,15,Champions
30634,121,15,1756.62,4,5,4,13,Champions
30635,435,9,1667.98,2,2,3,7,Regulars
30636,4,8,1913.43,5,2,4,11,Big Spenders
30637,486,13,4203.92,1,4,5,10,At Risk
30638,231,12,2000.04,3,4,4,11,Big Spenders
30639,826,6,319.35,1,1,1,3,Hibernating
30640,541,5,603.21,1,1,1,3,Hibernating
30641,111,8,577.1700000000001,4,2,1,7,Regulars
30642,264,15,1686.1100000000001,2,5,3,10,At Risk
30643,42,16,2424.82,5,5,4,14,Champions
30644,29,7,1170.83,5,1,2,8,Regulars
30645,717,9,545.47,1,2,1,4,Hibernating
30646,241,9,1154.22,3,2,2,7,Regulars
30647,26,10,1119.5,5,3,2,10,Loyal
30648,104,8,797.33,4,2,1,7,Regulars
30649,166,9,1156.3999999999999,3,2,2,7,Regulars
30650,204,15,2188.3900000000003,3,5,4,12,Big Spenders
30651,4,5,544.3299999999999,5,1,1,7,Regulars
30652,174,13,2417.36,3,4,4,11,Big Spenders
30653,190,11,3324.32,3,3,5,11,Big Spenders
30654,1334,7,1997.8400000000001,1,1,4,6,Regulars
30655,549,10,1080.0,1,3,2,6,Regulars
30656,113,5,419.84,4,1,1,6,Regulars
30657,237,8,1630.5099999999998,3,2,3,8,Regulars
30658,20,8,629.85,5,2,1,8,Regulars
30659,167,9,1624.61,3,2,3,8,Regulars
30660,2,14,1753.16,5,5,4,14,Champions
30661,141,11,1367.7,4,3,3,10,Loyal
30662,627,10,1746.6200000000001,1,3,4,8,Regulars
30663,267,13,1051.52,2,4,2,8,At Risk
30664,678,8,1782.72,1,2,4,7,Regulars
30665,369,4,2670.7799999999997,2,1,5,8,Regulars
30666,13,16,5536.88,5,5,5,15,Champions
30667,360,21,2172.48,2,5,4,11,At Risk
30668,320,10,2024.38,2,3,4,9,Regulars
30669,1400,1,55.77,1,1,1,3,Hibernating
30670,507,9,555.05,1,2,1,4,Hibernating
30671,202,9,2315.53,3,2,4,9,Big Spenders
30672,172,19,1691.58,3,5,3,11,Regulars
30673,107,14,2649.38,4,5,5,14,Champions
30674,428,10,1681.33,2,3,3,8,Regulars
30675,269,7,839.5799999999999,2,1,1,4,Hibernating
30676,56,11,4419.33,5,3,5,13,Loyal
30677,714,9,1452.02,1,2,3,6,Regulars
30678,252,19,3583.6600000000003,2,5,5,12,At Risk
30679,291,11,2467.51,2,3,4,9,Regulars
30680,8,15,1731.3999999999999,5,5,4,14,Champions
30681,407,7,524.03,2,1,1,4,Hibernating
30682,6,12,1423.69,5,4,3,12,Loyal
30683,345,9,1836.1999999999998,2,2,4,8,Regulars
30684,165,8,1341.13,3,2,3,8,Regulars
30685,488,10,1099.94,1,3,2,6,Regulars
30686,401,7,1196.23,2,1,2,5,Hibernating
30687,2,11,3056.11,5,3,5,13,Loyal
30688,161,11,1516.6299999999999,3,3,3,9,Regulars
30689,98,13,1103.02,4,4,2,10,Loyal
30690,398,8,1291.5900000000001,2,2,3,7,Regulars
30691,531,8,1190.57,1,2,2,5,Hibernating
30692,391,12,1211.59,2,4,2,8,At Risk
30693,596,8,1136.13,1,2,2,5,Hibernating
30694,21,14,1955.81,5,5,4,14,Champions
30695,217,9,646.18,3,2,1,6,Regulars
30696,99,12,1110.99,4,4,2,10,Loyal
30697,162,14,2790.65,3,5,5,13,Big Spenders
30698,793,10,1027.22,1,3,2,6,Regulars
30699,286,13,1257.08,2,4,3,9,At Risk
30700,659,12,2055.92,1,4,4,9,At Risk
30701,40,6,3601.2200000000003,5,1,5,11,Big Spenders
30702,225,17,1540.12,3,5,3,11,Regulars
30703,460,5,1056.8600000000001,1,1,2,4,Hibernating
30704,508,6,2903.69,1,1,5,7,Regulars
30705,704,10,1417.56,1,3,3,7,Regulars
30706,440,12,1051.22,2,4,2,8,At Risk
30707,162,10,840.55,3,3,1,7,Regulars
30708,308,10,2101.37,2,3,4,9,Regulars
30709,169,10,802.86,3,3,1,7,Regulars
30710,90,14,1464.15,4,5,3,12,Loyal
30711,127,9,912.7500000000001,4,2,2,8,Regulars
30712,691,6,709.76,1,1,1,3,Hibernating
30713,1140,7,516.63,1,1,1,3,Hibernating
30714,168,9,669.23,3,2,1,6,Regulars
30715,594,6,648.8799999999999,1,1,1,3,Hibernating
30716,266,7,1282.88,2,1,3,6,Regulars
30717,128,13,4408.6,4,4,5,13,Champions
30718,273,10,2578.6800000000003,2,3,5,10,Regulars
30719,694,7,2017.19,1,1,4,6,Regulars
30720,551,8,375.37,1,2,1,4,Hibernating
30721,173,9,1210.01,3,2,2,7,Regulars
30722,408,7,443.37,2,1,1,4,Hibernating
30723,218,12,1615.48,3,4,3,10,Regulars
30724,54,14,3020.79,5,5,5,15,Champions
30725,120,12,918.23,4,4,2,10,Loyal
30726,295,12,2035.22,2,4,4,10,At Risk
30727,113,17,2699.41,4,5,5,14,Champions
30728,42,13,1137.42,5,4,2,11,Loyal
30729,393,10,818.6,2,3,1,6,Regulars
30730,139,15,1829.8799999999999,4,5,4,13,Champions
30731,569,9,1209.91,1,2,2,5,Hibernating
30732,163,10,3088.54,3,3,5,11,Big Spenders
30733,463,11,4927.55,1,3,5,9,Regulars
30734,43,9,3385.38,5,2,5,12,Big Spenders
30735,16,11,1516.06,5,3,3,11,Loyal
30736,536,10,1577.39,1,3,3,7,Regulars
30737,603,11,2960.83,1,3,5,9,Regulars
30738,361,11,1171.8,2,3,2,7,Regulars
30739,168,10,989.5699999999999,3,3,2,8,Regulars
30740,449,8,1127.5,2,2,2,6,Hibernating
30741,0,10,755.2,5,3,1,9,Loyal
30742,900,5,532.61,1,1,1,3,Hibernating
30743,365,7,860.31,2,1,2,5,Hibernating
30744,107,19,2231.11,4,5,4,13,Champions
30745,460,9,1071.97,1,2,2,5,Hibernating
30746,322,13,2523.71,2,4,4,10,At Risk
30747,15,7,1077.53,5,1,2,8,Regulars
30748,38,10,695.5500000000001,5,3,1,9,Loyal
30749,659,7,2071.62,1,1,4,6,Regulars
30750,1018,9,649.6,1,2,1,4,Hibernating
30751,41,10,471.65,5,3,1,9,Loyal
30752,203,10,366.02000000000004,3,3,1,7,Regulars
30753,205,12,1822.33,3,4,4,11,Big Spenders
30754,181,8,2641.94,3,2,5,10,Big Spenders
30755,350,16,1682.82,2,5,3,10,At Risk
30756,65,9,1909.78,5,2,4,11,Big Spenders
30757,20,10,1122.97,5,3,2,10,Loyal
30758,125,19,3297.2999999999997,4,5,5,14,Champions
30759,305,10,1246.04,2,3,3,8,Regulars
30760,742,8,1992.14,1,2,4,7,Regulars
30761,156,7,891.2700000000001,3,1,2,6,Regulars
30762,454,14,2005.29,2,5,4,11,At Risk
30763,388,5,1772.8000000000002,2,1,4,7,Regulars
30764,124,9,755.95,4,2,1,7,Regulars
30765,226,12,2052.08,3,4,4,11,Big Spenders
30766,480,9,5288.53,1,2,5,8,Regulars
30767,367,12,1081.96,2,4,2,8,At Risk
30768,182,9,1972.97,3,2,4,9,Big Spenders
30769,649,9,2514.99,1,2,4,7,Regulars
30770,852,12,3454.59,1,4,5,10,At Risk
30771,561,8,2138.09,1,2,4,7,Regulars
30772,192,8,1551.38,3,2,3,8,Regulars
30773,34,13,1110.58,5,4,2,11,Loyal
30774,148,17,5761.77,3,5,5,13,Big Spenders
30775,176,12,1497.26,3,4,3,10,Regulars
30776,33,8,2703.66,5,2,5,12,Big Spenders
30777,157,7,964.01,3,1,2,6,Regulars
30778,14,7,3406.63,5,1,5,11,Big Spenders
30779,365,11,1596.76,2,3,3,8,Regulars
30780,148,10,2380.83,3,3,4,10,Big Spenders
30781,531,8,3614.1800000000003,1,2,5,8,Regulars
30782,50,7,805.3199999999999,5,1,1,7,Regulars
30783,48,13,1996.82,5,4,4,13,Champions
30784,224,10,1137.67,3,3,2,8,Regulars
30785,0,12,1322.8000000000002,5,4,3,12,Loyal
30786,370,10,2411.48,2,3,4,9,Regulars
30787,92,15,1807.83,4,5,4,13,Champions
30788,645,7,263.40999999999997,1,1,1,3,Hibernating
30789,794,8,1306.08,1,2,3,6,Regulars
30790,659,9,702.72,1,2,1,4,Hibernating
30791,351,13,1446.96,2,4,3,9,At Risk
30792,366,16,3277.81,2,5,5,12,At Risk
30793,191,13,4196.75,3,4,5,12,Big Spenders
30794,16,8,1269.92,5,2,3,10,Regulars
30795,220,14,4342.63,3,5,5,13,Big Spenders
30796,560,15,3026.9900000000002,1,5,5,11,At Risk
30797,40,12,1427.18,5,4,3,12,Loyal
30798,35,13,1424.19,5,4,3,12,Loyal
30799,335,13,1694.05,2,4,3,9,At Risk
30800,158,8,632.14,3,2,1,6,Regulars
30801,672,9,836.98,1,2,1,4,Hibernating
30802,67,18,1747.1299999999999,4,5,4,13,Champions
30803,36,11,1277.98,5,3,3,11,Loyal
30804,231,7,1918.5099999999998,3,1,4,8,Big Spenders
30805,215,11,1670.39,3,3,3,9,Regulars
30806,1405,4,325.46000000000004,1,1,1,3,Hibernating
30807,73,9,1722.5900000000001,4,2,3,9,Regulars
30808,484,12,2589.05,1,4,5,10,At Risk
30809,28,15,3579.21,5,5,5,15,Champions
30810,651,5,2201.57,1,1,4,6,Regulars
30811,383,10,1294.43,2,3,3,8,Regulars
30812,130,9,758.5699999999999,4,2,1,7,Regulars
30813,13,8,2009.6499999999999,5,2,4,11,Big Spenders
30814,560,11,1237.3600000000001,1,3,2,6,Regulars
30815,344,10,1626.0700000000002,2,3,3,8,Regulars
30816,75,11,933.13,4,3,2,9,Loyal
30817,346,12,978.91,2,4,2,8,At Risk
30818,30,11,545.8399999999999,5,3,1,9,Loyal
30819,47,8,2526.0,5,2,4,11,Big Spenders
30820,304,13,3025.21,2,4,5,11,At Risk
30821,59,16,2640.35,5,5,5,15,Champions
30822,656,10,1146.17,1,3,2,6,Regulars
30823,544,8,982.32,1,2,2,5,Hibernating
30824,571,9,1215.04,1,2,2,5,Hibernating
30825,83,8,515.78,4,2,1,7,Regulars
30826,508,7,2152.9,1,1,4,6,Regulars
30827,264,15,1830.55,2,5,4,11,At Risk
30828,465,10,1234.48,1,3,2,6,Regulars
30829,163,5,678.76,3,1,1,5,Regulars
30830,175,13,2364.36,3,4,4,11,Big Spenders
30831,58,8,897.2,5,2,2,9,Regulars
30832,261,6,605.8299999999999,2,1,1,4,Hibernating
30833,217,9,795.8199999999999,3,2,1,6,Regulars
30834,235,11,1618.04,3,3,3,9,Regulars
30835,109,15,2624.54,4,5,5,14,Champions
30836,493,11,1166.83,1,3,2,6,Regulars
30837,132,10,2697.19,4,3,5,12,Loyal
30838,237,12,2448.9900000000002,3,4,4,11,Big Spenders
30839,466,9,655.52,1,2,1,4,Hibernating
30840,232,14,4352.6900000000005,3,5,5,13,Big Spenders
30841,16,16,1307.33,5,5,3,13,Loyal
30842,197,9,910.11,3,2,2,7,Regulars
30843,16,10,2555.8500000000004,5,3,4,12,Loyal
30844,160,10,636.95,3,3,1,7,Regulars
30845,670,8,371.7,1,2,1,4,Hibernating
30846,278,8,840.6199999999999,2,2,1,5,Hibernating
30847,1099,8,613.38,1,2,1,4,Hibernating
30848,65,10,1198.78,5,3,2,10,Loyal
30849,141,6,862.76,4,1,2,7,Regulars
30850,33,12,4262.58,5,4,5,14,Champions
30851,853,8,714.71,1,2,1,4,Hibernating
30852,64,8,701.01,5,2,1,8,Regulars
30853,188,9,1456.32,3,2,3,8,Regulars
30854,198,9,481.65999999999997,3,2,1,6,Regulars
30855,309,7,460.15,2,1,1,4,Hibernating
30856,222,12,4278.53,3,4,5,12,Big Spenders
30857,154,14,2338.74,3,5,4,12,Big Spenders
30858,8,10,3077.27,5,3,5,13,Loyal
30859,121,13,1459.13,4,4,3,11,Loyal
30860,17,14,1022.48,5,5,2,12,Loyal
30861,283,11,1520.93,2,3,3,8,Regulars
30862,53,8,599.5699999999999,5,2,1,8,Regulars
30863,130,10,837.73,4,3,1,8,Loyal
30864,729,8,455.95,1,2,1,4,Hibernating
30865,399,8,715.51,2,2,1,5,Hibernating
30866,575,9,590.56,1,2,1,4,Hibernating
30867,95,12,6591.530000000001,4,4,5,13,Champions
30868,5,11,1092.4699999999998,5,3,2,10,Loyal
30869,260,7,3474.68,2,1,5,8,Regulars
30870,540,10,2397.44,1,3,4,8,Regulars
30871,560,10,1834.8100000000002,1,3,4,8,Regulars
30872,1212,8,1214.2099999999998,1,2,2,5,Hibernating
30873,230,9,1652.97,3,2,3,8,Regulars
30874,34,14,1750.18,5,5,4,14,Champions
30875,544,9,1551.1499999999999,1,2,3,6,Regulars
30876,20,9,953.63,5,2,2,9,Regulars
30877,331,12,3293.96,2,4,5,11,At Risk
30878,70,15,1746.7,4,5,4,13,Champions
30879,166,11,836.17,3,3,1,7,Regulars
30880,134,8,1082.8999999999999,4,2,2,8,Regulars
30881,752,11,1166.8500000000001,1,3,2,6,Regulars
30882,464,11,2313.94,1,3,4,8,Regulars
30883,105,15,1519.23,4,5,3,12,Loyal
30884,278,11,1346.24,2,3,3,8,Regulars
30885,159,7,1765.1699999999998,3,1,4,8,Big Spenders
30886,793,7,660.74,1,1,1,3,Hibernating
30887,420,7,1062.36,2,1,2,5,Hibernating
30888,245,6,925.3599999999999,3,1,2,6,Regulars
30889,195,12,1327.31,3,4,3,10,Regulars
30890,157,11,1413.51,3,3,3,9,Regulars
30891,525,12,1497.9099999999999,1,4,3,8,At Risk
30892,4,13,3257.38,5,4,5,14,Champions
30893,41,6,1138.87,5,1,2,8,Regulars
30894,0,6,1251.55,5,1,3,9,Regulars
30895,84,5,2831.8500000000004,4,1,5,10,Big Spenders
30896,493,10,3379.2999999999997,1,3,5,9,Regulars
30897,163,15,1877.02,3,5,4,12,Big Spenders
30898,23,6,504.39000000000004,5,1,1,7,Regulars
30899,147,11,2405.29,4,3,4,11,Loyal
30900,145,10,1124.8700000000001,4,3,2,9,Loyal
30901,330,9,1321.99,2,2,3,7,Regulars
30902,546,11,2654.52,1,3,5,9,Regulars
30903,91,9,2657.76,4,2,5,11,Big Spenders
30904,381,7,5371.68,2,1,5,8,Regulars
30905,25,11,1606.16,5,3,3,11,Loyal
30906,387,15,1692.15,2,5,3,10,At Risk
30907,361,12,937.39,2,4,2,8,At Risk
30908,524,9,951.74,1,2,2,5,Hibernating
30909,273,7,1376.02,2,1,3,6,Regulars
30910,229,9,773.8299999999999,3,2,1,6,Regulars
30911,49,10,566.99,5,3,1,9,Loyal
30912,634,4,325.88,1,1,1,3,Hibernating
30913,68,11,974.05,4,3,2,9,Loyal
30914,186,14,2787.23,3,5,5,13,Big Spenders
30915,224,6,681.99,3,1,1,5,Regulars
30916,192,14,1757.32,3,5,4,12,Big Spenders
30917,281,14,1651.65,2,5,3,10,At Risk
30918,1020,13,2105.18,1,4,4,9,At Risk
30919,480,9,1332.5,1,2,3,6,Regulars
30920,337,11,1056.48,2,3,2,7,Regulars
30921,78,8,821.75,4,2,1,7,Regulars
30922,59,14,2240.32,5,5,4,14,Champions
30923,619,10,1713.37,1,3,3,7,Regulars
30924,298,14,3533.25,2,5,5,12,At Risk
30925,463,11,1177.9,1,3,2,6,Regulars
30926,97,15,1825.54,4,5,4,13,Champions
30927,829,9,921.2099999999999,1,2,2,5,Hibernating
30928,146,16,2898.6800000000003,4,5,5,14,Champions
30929,5,11,1597.05,5,3,3,11,Loyal
30930,100,11,1643.8,4,3,3,10,Loyal
30931,85,15,2702.87,4,5,5,14,Champions
30932,313,8,3911.1899999999996,2,2,5,9,Regulars
30933,198,10,1251.78,3,3,3,9,Regulars
30934,195,10,1771.26,3,3,4,10,Big Spenders
30935,298,14,1438.41,2,5,3,10,At Risk
30936,13,10,2517.71,5,3,4,12,Loyal
30937,916,10,1271.6000000000001,1,3,3,7,Regulars
30938,46,9,1227.12,5,2,2,9,Regulars
30939,22,12,2051.86,5,4,4,13,Champions
30940,360,11,1727.55,2,3,4,9,Regulars
30941,516,5,3449.6500000000005,1,1,5,7,Regulars
30942,869,7,329.2,1,1,1,3,Hibernating
30943,603,5,1437.11,1,1,3,5,Regulars
30944,99,7,1476.72,4,1,3,8,Regulars
30945,203,9,1592.99,3,2,3,8,Regulars
30946,567,13,2117.01,1,4,4,9,At Risk
30947,53,6,423.7,5,1,1,7,Regulars
30948,61,17,2161.98,5,5,4,14,Champions
30949,583,8,1584.33,1,2,3,6,Regulars
30950,4,14,2937.9599999999996,5,5,5,15,Champions
30951,138,8,455.6,4,2,1,7,Regulars
30952,24,5,344.77000000000004,5,1,1,7,Regulars
30953,164,10,1840.56,3,3,4,10,Big Spenders
30954,187,9,2183.5,3,2,4,9,Big Spenders
30955,20,13,2392.26,5,4,4,13,Champions
30956,174,7,410.25,3,1,1,5,Regulars
30957,393,8,970.0699999999999,2,2,2,6,Hibernating
30958,43,11,3546.89,5,3,5,13,Loyal
30959,536,15,4467.38,1,5,5,11,At Risk
30960,530,9,1792.93,1,2,4,7,Regulars
30961,69,9,475.36,4,2,1,7,Regulars
30962,152,9,1124.98,3,2,2,7,Regulars
30963,235,6,335.37,3,1,1,5,Regulars
30964,608,9,878.37,1,2,2,5,Hibernating
30965,378,9,1329.05,2,2,3,7,Regulars
30966,248,8,1079.48,2,2,2,6,Hibernating
30967,367,8,720.8000000000001,2,2,1,5,Hibernating
30968,278,8,367.15,2,2,1,5,Hibernating
30969,318,7,418.94,2,1,1,4,Hibernating
30970,7,8,675.0600000000001,5,2,1,8,Regulars
30971,324,5,531.7900000000001,2,1,1,4,Hibernating
30972,165,8,2193.61,3,2,4,9,Big Spenders
30973,412,12,2218.03,2,4,4,10,At Risk
30974,235,11,2858.24,3,3,5,11,Big Spenders
30975,261,10,3432.46,2,3,5,10,Regulars
30976,333,6,807.16,2,1,1,4,Hibernating
30977,143,14,3398.6000000000004,4,5,5,14,Champions
30978,125,12,2435.74,4,4,4,12,Champions
30979,506,7,608.04,1,1,1,3,Hibernating
30980,199,7,1736.5,3,1,4,8,Big Spenders
30981,87,10,2502.35,4,3,4,11,Loyal
30982,2,13,920.15,5,4,2,11,Loyal
30983,100,7,665.4100000000001,4,1,1,6,Regulars
30984,432,12,2650.3399999999997,2,4,5,11,At Risk
30985,663,6,883.2700000000001,1,1,2,4,Hibernating
30986,160,9,970.71,3,2,2,7,Regulars
30987,70,10,1211.47,4,3,2,9,Loyal
30988,175,6,525.17,3,1,1,5,Regulars
30989,833,7,662.35,1,1,1,3,Hibernating
30990,100,10,1193.75,4,3,2,9,Loyal
30991,14,7,456.17,5,1,1,7,Regulars
30992,185,6,680.9300000000001,3,1,1,5,Regulars
30993,56,11,2504.98,5,3,4,12,Loyal
30994,259,14,1611.17,2,5,3,10,At Risk
30995,54,8,939.4,5,2,2,9,Regulars
30996,180,14,3148.65,3,5,5,13,Big Spenders
30997,66,13,1839.91,4,4,4,12,Champions
30998,561,12,757.3499999999999,1,4,1,6,At Risk
30999,903,2,226.03999999999994,1,1,1,3,Hibernating
31000,8,12,1519.87,5,4,3,12,Loyal
31001,307,10,810.79,2,3,1,6,Regulars
31002,65,11,973.05,5,3,2,10,Loyal
31003,669,9,1266.03,1,2,3,6,Regulars
31004,65,13,3531.0099999999998,5,4,5,14,Champions
31005,567,7,1199.28,1,1,2,4,Hibernating
31006,273,11,1533.04,2,3,3,8,Regulars
31007,1072,8,970.57,1,2,2,5,Hibernating
31008,131,15,1441.65,4,5,3,12,Loyal
31009,148,7,705.8299999999999,3,1,1,5,Regulars
31010,42,9,786.0600000000001,5,2,1,8,Regulars
31011,24,20,1439.85,5,5,3,13,Loyal
31012,365,9,2257.8,2,2,4,8,Regulars
31013,217,16,3169.01,3,5,5,13,Big Spenders
31014,528,11,1433.6000000000001,1,3,3,7,Regulars
31015,236,10,1872.05,3,3,4,10,Big Spenders
31016,167,9,1809.89,3,2,4,9,Big Spenders
31017,573,13,1419.7700000000002,1,4,3,8,At Risk
31018,82,16,1125.25,4,5,2,11,Loyal
31019,143,12,4446.280000000001,4,4,5,13,Champions
31020,406,6,616.55,2,1,1,4,Hibernating
31021,278,14,1611.28,2,5,3,10,At Risk
31022,9,12,5108.63,5,4,5,14,Champions
31023,213,8,3063.9999999999995,3,2,5,10,Big Spenders
31024,9,13,2505.23,5,4,4,13,Champions
31025,370,12,1165.8,2,4,2,8,At Risk
31026,286,15,2173.32,2,5,4,11,At Risk
31027,114,7,1686.54,4,1,3,8,Regulars
31028,72,7,1995.3999999999999,4,1,4,9,Big Spenders
31029,200,10,2341.5299999999997,3,3,4,10,Big Spenders
31030,481,11,1421.8,1,3,3,7,Regulars
31031,271,13,1116.55,2,4,2,8,At Risk
31032,528,4,702.11,1,1,1,3,Hibernating
31033,521,11,1677.06,1,3,3,7,Regulars
31034,2,10,2612.98,5,3,5,13,Loyal
31035,9,10,903.1800000000001,5,3,2,10,Loyal
31036,119,11,3628.49,4,3,5,12,Loyal
31037,196,9,1017.7199999999999,3,2,2,7,Regulars
31038,127,10,2200.44,4,3,4,11,Loyal
31039,85,8,607.2900000000001,4,2,1,7,Regulars
31040,234,8,1778.49,3,2,4,9,Big Spenders
31041,66,15,1372.44,4,5,3,12,Loyal
31042,38,12,960.81,5,4,2,11,Loyal
31043,30,13,3499.13,5,4,5,14,Champions
31044,127,6,829.21,4,1,1,6,Regulars
31045,283,7,1830.29,2,1,4,7,Regulars
31046,72,4,1832.95,4,1,4,9,Big Spenders
31047,195,6,616.4599999999999,3,1,1,5,Regulars
31048,215,4,504.63,3,1,1,5,Regulars
31049,128,8,1285.77,4,2,3,9,Regulars
31050,59,13,1012.84,5,4,2,11,Loyal
31051,316,10,3917.01,2,3,5,10,Regulars
31052,82,17,4280.2699999999995,4,5,5,14,Champions
31053,103,10,1910.6100000000001,4,3,4,11,Loyal
31054,59,13,1579.84,5,4,3,12,Loyal
31055,181,14,4274.79,3,5,5,13,Big Spenders
31056,144,14,1966.1399999999999,4,5,4,13,Champions
31057,0,13,2371.1,5,4,4,13,Champions
31058,71,13,4736.38,4,4,5,13,Champions
31059,1041,7,1446.07,1,1,3,5,Regulars
31060,107,10,591.86,4,3,1,8,Loyal
31061,587,10,1148.12,1,3,2,6,Regulars
31062,470,7,543.33,1,1,1,3,Hibernating
31063,116,10,1904.4299999999998,4,3,4,11,Loyal
31064,524,12,1608.3,1,4,3,8,At Risk
31065,258,7,558.83,2,1,1,4,Hibernating
31066,247,6,615.29,3,1,1,5,Regulars
31067,294,6,876.9699999999998,2,1,2,5,Hibernating
31068,16,11,1461.4,5,3,3,11,Loyal
31069,29,9,803.7,5,2,1,8,Regulars
31070,118,10,1908.99,4,3,4,11,Loyal
31071,445,16,3848.94,2,5,5,12,At Risk
31072,41,10,3682.16,5,3,5,13,Loyal
31073,164,17,2928.91,3,5,5,13,Big Spenders
31074,148,15,2049.31,3,5,4,12,Big Spenders
31075,47,20,3358.1800000000003,5,5,5,15,Champions
31076,208,8,1256.76,3,2,3,8,Regulars
31077,245,9,3002.9900000000007,3,2,5,10,Big Spenders
31078,259,10,4929.97,2,3,5,10,Regulars
31079,211,10,1937.02,3,3,4,10,Big Spenders
31080,8,11,858.67,5,3,2,10,Loyal
31081,439,11,2575.55,2,3,5,10,Regulars
31082,979,5,903.4200000000001,1,1,2,4,Hibernating
31083,624,7,748.13,1,1,1,3,Hibernating
31084,69,9,965.03,4,2,2,8,Regulars
31085,186,12,1283.29,3,4,3,10,Regulars
31086,447,7,2665.6800000000003,2,1,5,8,Regulars
31087,158,17,5059.0,3,5,5,13,Big Spenders
31088,55,8,928.61,5,2,2,9,Regulars
31089,242,4,790.92,3,1,1,5,Regulars
31090,293,9,715.73,2,2,1,5,Hibernating
31091,147,14,1237.7,4,5,2,11,Loyal
31092,870,10,1784.67,1,3,4,8,Regulars
31093,176,11,2029.71,3,3,4,10,Big Spenders
31094,100,11,2426.97,4,3,4,11,Loyal
31095,249,9,1485.21,2,2,3,7,Regulars
31096,162,11,1526.27,3,3,3,9,Regulars
31097,441,5,239.19,2,1,1,4,Hibernating
31098,1044,9,1567.44,1,2,3,6,Regulars
31099,85,10,1674.41,4,3,3,10,Loyal
31100,705,9,1362.75,1,2,3,6,Regulars
31101,96,13,1396.44,4,4,3,11,Loyal
31102,144,10,1436.3700000000001,4,3,3,10,Loyal
31103,40,8,695.44,5,2,1,8,Regulars
31104,615,12,753.5799999999999,1,4,1,6,At Risk
31105,32,6,449.53,5,1,1,7,Regulars
31106,209,10,704.91,3,3,1,7,Regulars
31107,220,15,4242.45,3,5,5,13,Big Spenders
31108,211,16,2862.1,3,5,5,13,Big Spenders
31109,444,7,1424.01,2,1,3,6,Regulars
31110,160,10,1561.73,3,3,3,9,Regulars
31111,51,13,1712.93,5,4,3,12,Loyal
31112,95,15,1916.98,4,5,4,13,Champions
31113,213,10,2520.82,3,3,4,10,Big Spenders
31114,90,10,1375.15,4,3,3,10,Loyal
31115,50,9,881.3800000000001,5,2,2,9,Regulars
31116,148,17,4944.08,3,5,5,13,Big Spenders
31117,441,15,2976.13,2,5,5,12,At Risk
31118,227,10,2889.31,3,3,5,11,Big Spenders
31119,10,10,2120.54,5,3,4,12,Loyal
31120,182,15,2342.21,3,5,4,12,Big Spenders
31121,264,11,1905.9900000000002,2,3,4,9,Regulars
31122,523,8,706.71,1,2,1,4,Hibernating
31123,132,11,2117.79,4,3,4,11,Loyal
31124,482,11,648.9,1,3,1,5,Regulars
31125,188,6,604.47,3,1,1,5,Regulars
31126,127,13,1928.99,4,4,4,12,Champions
31127,783,10,1251.64,1,3,3,7,Regulars
31128,28,10,2779.79,5,3,5,13,Loyal
31129,118,13,1419.91,4,4,3,11,Loyal
31130,51,14,4641.77,5,5,5,15,Champions
31131,297,11,1159.56,2,3,2,7,Regulars
31132,115,9,720.96,4,2,1,7,Regulars
31133,475,9,1282.16,1,2,3,6,Regulars
31134,132,6,910.38,4,1,2,7,Regulars
31135,490,12,1473.33,1,4,3,8,At Risk
31136,235,12,2740.35,3,4,5,12,Big Spenders
31137,379,8,1950.9599999999998,2,2,4,8,Regulars
31138,444,10,4808.05,2,3,5,10,Regulars
31139,529,8,824.6999999999999,1,2,1,4,Hibernating
31140,199,6,618.4,3,1,1,5,Regulars
31141,193,16,1128.92,3,5,2,10,Regulars
31142,597,6,364.78,1,1,1,3,Hibernating
31143,122,9,1809.42,4,2,4,10,Big Spenders
31144,29,12,1757.28,5,4,4,13,Champions
31145,643,12,1872.3899999999999,1,4,4,9,At Risk
31146,167,10,2102.74,3,3,4,10,Big Spenders
31147,197,7,1026.82,3,1,2,6,Regulars
31148,90,9,569.64,4,2,1,7,Regulars
31149,202,11,2279.97,3,3,4,10,Big Spenders
31150,293,11,1063.0,2,3,2,7,Regulars
31151,253,9,934.31,2,2,2,6,Hibernating
31152,328,5,2794.76,2,1,5,8,Regulars
31153,101,11,1365.24,4,3,3,10,Loyal
31154,26,17,3060.51,5,5,5,15,Champions
31155,156,10,1349.62,3,3,3,9,Regulars
31156,161,11,1393.44,3,3,3,9,Regulars
31157,475,5,2216.8,1,1,4,6,Regulars
31158,441,10,4567.07,2,3,5,10,Regulars
31159,93,8,2710.3100000000004,4,2,5,11,Big Spenders
31160,72,11,1193.75,4,3,2,9,Loyal
31161,8,8,2256.45,5,2,4,11,Big Spenders
31162,584,11,3325.3700000000003,1,3,5,9,Regulars
31163,49,11,1035.31,5,3,2,10,Loyal
31164,76,11,2111.42,4,3,4,11,Loyal
31165,141,9,1030.03,4,2,2,8,Regulars
31166,273,7,581.1,2,1,1,4,Hibernating
31167,334,7,2084.42,2,1,4,7,Regulars
31168,45,4,376.5,5,1,1,7,Regulars
31169,383,12,4918.06,2,4,5,11,At Risk
31170,471,6,723.74,1,1,1,3,Hibernating
31171,235,17,2404.55,3,5,4,12,Big Spenders
31172,100,11,3795.9300000000003,4,3,5,12,Loyal
31173,96,11,1641.3899999999999,4,3,3,10,Loyal
31174,819,10,2184.3199999999997,1,3,4,8,Regulars
31175,35,9,753.53,5,2,1,8,Regulars
31176,703,3,244.48999999999998,1,1,1,3,Hibernating
31177,216,10,2645.3700000000003,3,3,5,11,Big Spenders
31178,395,14,2651.65,2,5,5,12,At Risk
31179,172,8,947.39,3,2,2,7,Regulars
31180,181,12,1061.1100000000001,3,4,2,9,Regulars
31181,211,4,381.87,3,1,1,5,Regulars
31182,421,10,1828.1299999999999,2,3,4,9,Regulars
31183,168,15,2160.31,3,5,4,12,Big Spenders
31184,22,11,1623.6000000000001,5,3,3,11,Loyal
31185,259,12,2388.01,2,4,4,10,At Risk
31186,215,11,2085.76,3,3,4,10,Big Spenders
31187,372,13,1377.0,2,4,3,9,At Risk
31188,270,9,687.34,2,2,1,5,Hibernating
31189,816,10,1010.9699999999999,1,3,2,6,Regulars
31190,153,11,861.6600000000001,3,3,2,8,Regulars
31191,55,13,1267.88,5,4,3,12,Loyal
31192,506,9,3247.3599999999997,1,2,5,8,Regulars
31193,559,10,900.5500000000001,1,3,2,6,Regulars
31194,281,9,2622.96,2,2,5,9,Regulars
31195,66,9,1416.51,4,2,3,9,Regulars
31196,75,10,1176.49,4,3,2,9,Loyal
31197,633,7,811.12,1,1,1,3,Hibernating
31198,94,13,2432.86,4,4,4,12,Champions
31199,14,14,1788.61,5,5,4,14,Champions
31200,143,10,1708.04,4,3,3,10,Loyal
31201,14,8,534.4100000000001,5,2,1,8,Regulars
31202,29,12,3040.26,5,4,5,14,Champions
31203,49,12,3189.8500000000004,5,4,5,14,Champions
31204,33,12,4231.5199999999995,5,4,5,14,Champions
31205,103,20,2379.72,4,5,4,13,Champions
31206,538,10,1293.58,1,3,3,7,Regulars
31207,774,12,1495.3700000000001,1,4,3,8,At Risk
31208,54,7,680.81,5,1,1,7,Regulars
31209,133,10,1443.73,4,3,3,10,Loyal
31210,4,12,1149.67,5,4,2,11,Loyal
31211,161,4,244.15,3,1,1,5,Regulars
31212,0,8,1182.99,5,2,2,9,Regulars
31213,152,7,490.99,3,1,1,5,Regulars
31214,421,14,2199.5099999999998,2,5,4,11,At Risk
31215,199,15,4052.38,3,5,5,13,Big Spenders
31216,85,8,2507.38,4,2,4,10,Big Spenders
31217,1708,5,2668.2300000000005,1,1,5,7,Regulars
31218,490,12,2232.94,1,4,4,9,At Risk
31219,168,10,828.87,3,3,1,7,Regulars
31220,11,16,3414.8,5,5,5,15,Champions
31221,232,16,1808.98,3,5,4,12,Big Spenders
31222,128,18,1246.46,4,5,3,12,Loyal
31223,100,9,2574.64,4,2,5,11,Big Spenders
31224,43,13,1708.4199999999998,5,4,3,12,Loyal
31225,21,12,4134.45,5,4,5,14,Champions
31226,104,9,872.1700000000001,4,2,2,8,Regulars
31227,152,11,1473.4,3,3,3,9,Regulars
31228,453,5,1025.6100000000001,2,1,2,5,Hibernating
31229,28,11,1969.99,5,3,4,12,Loyal
31230,187,5,310.0,3,1,1,5,Regulars
31231,84,14,2902.64,4,5,5,14,Champions
31232,449,12,1468.62,2,4,3,9,At Risk
31233,333,8,1331.9900000000002,2,2,3,7,Regulars
31234,131,7,1490.9799999999998,4,1,3,8,Regulars
31235,92,14,1643.74,4,5,3,12,Loyal
31236,171,12,1981.3400000000001,3,4,4,11,Big Spenders
31237,1592,7,794.61,1,1,1,3,Hibernating
31238,321,8,1270.55,2,2,3,7,Regulars
31239,365,11,772.91,2,3,1,6,Regulars
31240,217,8,1327.0,3,2,3,8,Regulars
31241,167,9,2001.24,3,2,4,9,Big Spenders
31242,447,7,492.62,2,1,1,4,Hibernating
31243,217,7,775.11,3,1,1,5,Regulars
31244,768,5,1651.5700000000002,1,1,3,5,Regulars
31245,90,15,1954.7,4,5,4,13,Champions
31246,305,11,2675.46,2,3,5,10,Regulars
31247,285,11,5306.860000000001,2,3,5,10,Regulars
31248,54,5,590.6800000000001,5,1,1,7,Regulars
31249,175,7,1093.3600000000001,3,1,2,6,Regulars
31250,842,8,2195.98,1,2,4,7,Regulars
31251,87,12,1397.68,4,4,3,11,Loyal
31252,253,5,1120.6399999999999,2,1,2,5,Hibernating
31253,45,13,4215.09,5,4,5,14,Champions
31254,249,9,652.59,2,2,1,5,Hibernating
31255,442,11,4465.339999999999,2,3,5,10,Regulars
31256,100,7,420.78,4,1,1,6,Regulars
31257,848,8,470.59,1,2,1,4,Hibernating
31258,63,18,1492.37,5,5,3,13,Loyal
31259,0,18,2050.97,5,5,4,14,Champions
31260,551,8,1421.41,1,2,3,6,Regulars
31261,175,10,941.23,3,3,2,8,Regulars
31262,349,17,2174.86,2,5,4,11,At Risk
31263,446,8,589.78,2,2,1,5,Hibernating
31264,245,13,1401.04,3,4,3,10,Regulars
31265,410,9,621.53,2,2,1,5,Hibernating
31266,42,8,489.21,5,2,1,8,Regulars
31267,20,12,4425.17,5,4,5,14,Champions
31268,180,9,922.3700000000001,3,2,2,7,Regulars
31269,338,7,1290.05,2,1,3,6,Regulars
31270,20,14,2407.87,5,5,4,14,Champions
31271,96,7,1701.8400000000001,4,1,3,8,Regulars
31272,38,14,2725.02,5,5,5,15,Champions
31273,141,12,1797.32,4,4,4,12,Champions
31274,249,5,635.24,2,1,1,4,Hibernating
31275,0,8,563.81,5,2,1,8,Regulars
31276,128,10,1307.03,4,3,3,10,Loyal
31277,753,4,503.51,1,1,1,3,Hibernating
31278,90,14,3174.4,4,5,5,14,Champions
31279,59,18,2054.2799999999997,5,5,4,14,Champions
31280,90,11,1668.71,4,3,3,10,Loyal
31281,111,6,882.49,4,1,2,7,Regulars
31282,40,14,4175.86,5,5,5,15,Champions
31283,316,10,1379.52,2,3,3,8,Regulars
31284,90,13,934.05,4,4,2,10,Loyal
31285,203,14,3419.76,3,5,5,13,Big Spenders
31286,55,10,3347.74,5,3,5,13,Loyal
31287,175,12,1592.25,3,4,3,10,Regulars
31288,105,6,470.28000000000003,4,1,1,6,Regulars
31289,208,10,877.33,3,3,2,8,Regulars
31290,3,18,3669.56,5,5,5,15,Champions
31291,511,5,286.75,1,1,1,3,Hibernating
31292,567,13,3062.45,1,4,5,10,At Risk
31293,56,16,4162.39,5,5,5,15,Champions
31294,479,9,2861.84,1,2,5,8,Regulars
31295,90,14,1736.35,4,5,4,13,Champions
31296,22,16,4610.759999999999,5,5,5,15,Champions
31297,329,9,1929.4899999999998,2,2,4,8,Regulars
31298,1219,6,687.7099999999999,1,1,1,3,Hibernating
31299,183,11,1781.8,3,3,4,10,Big Spenders
31300,316,7,1332.12,2,1,3,6,Regulars
31301,518,15,1797.08,1,5,4,10,At Risk
31302,55,16,1605.5,5,5,3,13,Loyal
31303,603,9,926.5600000000001,1,2,2,5,Hibernating
31304,37,12,2439.8199999999997,5,4,4,13,Champions
31305,104,12,3553.04,4,4,5,13,Champions
31306,155,9,1769.6299999999999,3,2,4,9,Big Spenders
31307,91,8,853.1899999999999,4,2,2,8,Regulars
31308,75,12,3888.12,4,4,5,13,Champions
31309,793,9,1434.22,1,2,3,6,Regulars
31310,260,16,3767.6800000000003,2,5,5,12,At Risk
31311,6,16,2402.98,5,5,4,14,Champions
31312,784,6,584.71,1,1,1,3,Hibernating
31313,290,8,1909.16,2,2,4,8,Regulars
31314,58,11,1170.21,5,3,2,10,Loyal
31315,127,15,1861.0300000000002,4,5,4,13,Champions
31316,227,14,1411.56,3,5,3,11,Regulars
31317,354,15,1575.68,2,5,3,10,At Risk
31318,272,7,1145.21,2,1,2,5,Hibernating
31319,111,5,988.95,4,1,2,7,Regulars
31320,23,9,1282.21,5,2,3,10,Regulars
31321,69,13,2617.8199999999997,4,4,5,13,Champions
31322,243,12,1022.43,3,4,2,9,Regulars
31323,93,11,2048.06,4,3,4,11,Loyal
31324,266,5,916.11,2,1,2,5,Hibernating
31325,1,5,2639.85,5,1,5,11,Big Spenders
31326,196,11,1535.06,3,3,3,9,Regulars
31327,64,8,475.73,5,2,1,8,Regulars
31328,99,10,1415.1399999999999,4,3,3,10,Loyal
31329,998,6,219.14,1,1,1,3,Hibernating
31330,108,20,5117.91,4,5,5,14,Champions
31331,830,8,2902.2699999999995,1,2,5,8,Regulars
31332,159,8,1234.06,3,2,2,7,Regulars
31333,880,5,1393.1,1,1,3,5,Regulars
31334,638,9,2721.41,1,2,5,8,Regulars
31335,181,11,1516.24,3,3,3,9,Regulars
31336,418,12,1633.94,2,4,3,9,At Risk
31337,120,8,812.25,4,2,1,7,Regulars
31338,234,14,3137.81,3,5,5,13,Big Spenders
31339,216,14,1105.9,3,5,2,10,Regulars
31340,81,9,963.43,4,2,2,8,Regulars
31341,142,9,960.14,4,2,2,8,Regulars
31342,428,10,3782.15,2,3,5,10,Regulars
31343,30,4,373.90999999999997,5,1,1,7,Regulars
31344,702,8,2028.38,1,2,4,7,Regulars
31345,542,10,3019.27,1,3,5,9,Regulars
31346,317,11,1523.92,2,3,3,8,Regulars
31347,78,11,2512.2,4,3,4,11,Loyal
31348,208,8,1796.8899999999999,3,2,4,9,Big Spenders
31349,345,9,2634.1600000000003,2,2,5,9,Regulars
31350,142,9,1424.37,4,2,3,9,Regulars
31351,480,13,1774.49,1,4,4,9,At Risk
31352,52,11,1525.48,5,3,3,11,Loyal
31353,175,15,7062.84,3,5,5,13,Big Spenders
31354,45,12,1311.45,5,4,3,12,Loyal
31355,28,13,1484.97,5,4,3,12,Loyal
31356,55,16,4386.29,5,5,5,15,Champions
31357,28,9,893.7800000000001,5,2,2,9,Regulars
31358,412,8,684.9399999999999,2,2,1,5,Hibernating
31359,162,11,1067.3899999999999,3,3,2,8,Regulars
31360,286,9,607.38,2,2,1,5,Hibernating
31361,521,11,2816.16,1,3,5,9,Regulars
31362,103,12,1249.46,4,4,3,11,Loyal
31363,123,9,1160.71,4,2,2,8,Regulars
31364,513,4,551.0999999999999,1,1,1,3,Hibernating
31365,549,8,1079.95,1,2,2,5,Hibernating
31366,18,8,794.05,5,2,1,8,Regulars
31367,690,6,1344.47,1,1,3,5,Regulars
31368,198,22,1989.3500000000001,3,5,4,12,Big Spenders
31369,94,14,1444.1100000000001,4,5,3,12,Loyal
31370,1,6,751.9399999999999,5,1,1,7,Regulars
31371,757,13,1536.88,1,4,3,8,At Risk
31372,186,9,841.77,3,2,1,6,Regulars
31373,117,10,704.86,4,3,1,8,Loyal
31374,85,13,1066.68,4,4,2,10,Loyal
31375,53,17,1265.29,5,5,3,13,Loyal
31376,609,7,537.6500000000001,1,1,1,3,Hibernating
31377,55,13,1399.96,5,4,3,12,Loyal
31378,376,5,1371.91,2,1,3,6,Regulars
31379,116,10,5050.92,4,3,5,12,Loyal
31380,99,6,312.14,4,1,1,6,Regulars
31381,67,9,706.73,4,2,1,7,Regulars
31382,45,9,4586.94,5,2,5,12,Big Spenders
31383,47,11,2896.92,5,3,5,13,Loyal
31384,349,11,3333.0099999999998,2,3,5,10,Regulars
31385,197,11,1817.59,3,3,4,10,Big Spenders
31386,642,7,1038.16,1,1,2,4,Hibernating
31387,158,15,2130.37,3,5,4,12,Big Spenders
31388,112,10,1062.5,4,3,2,9,Loyal
31389,336,8,637.0,2,2,1,5,Hibernating
31390,275,12,1379.58,2,4,3,9,At Risk
31391,262,12,2790.32,2,4,5,11,At Risk
31392,926,9,2370.33,1,2,4,7,Regulars
31393,44,16,2565.2999999999997,5,5,4,14,Champions
31394,52,9,1318.75,5,2,3,10,Regulars
31395,260,7,860.5899999999999,2,1,2,5,Hibernating
31396,505,10,1988.72,1,3,4,8,Regulars
31397,243,13,917.26,3,4,2,9,Regulars
31398,640,5,461.13,1,1,1,3,Hibernating
31399,99,14,1162.29,4,5,2,11,Loyal
31400,36,14,5385.1,5,5,5,15,Champions
31401,132,14,956.8299999999999,4,5,2,11,Loyal
31402,258,12,1540.66,2,4,3,9,At Risk
31403,99,14,1252.57,4,5,3,12,Loyal
31404,31,10,1635.91,5,3,3,11,Loyal
31405,239,12,2085.76,3,4,4,11,Big Spenders
31406,376,12,2233.38,2,4,4,10,At Risk
31407,90,10,2558.14,4,3,4,11,Loyal
31408,78,16,1529.46,4,5,3,12,Loyal
31409,64,12,4149.460000000001,5,4,5,14,Champions
31410,119,14,1012.2,4,5,2,11,Loyal
31411,276,12,955.85,2,4,2,8,At Risk
31412,95,10,2380.6000000000004,4,3,4,11,Loyal
31413,337,11,2636.02,2,3,5,10,Regulars
31414,85,14,1814.88,4,5,4,13,Champions
31415,509,11,2430.96,1,3,4,8,Regulars
31416,524,9,627.64,1,2,1,4,Hibernating
31417,182,10,1008.3,3,3,2,8,Regulars
31418,8,8,902.84,5,2,2,9,Regulars
31419,169,11,933.51,3,3,2,8,Regulars
31420,51,10,1247.19,5,3,3,11,Loyal
31421,12,9,1370.8700000000001,5,2,3,10,Regulars
31422,242,9,948.12,3,2,2,7,Regulars
31423,861,7,1673.9099999999999,1,1,3,5,Regulars
31424,153,11,1836.31,3,3,4,10,Big Spenders
31425,142,10,907.1999999999999,4,3,2,9,Loyal
31426,211,9,978.43,3,2,2,7,Regulars
31427,496,10,567.23,1,3,1,5,Regulars
31428,150,10,1843.72,3,3,4,10,Big Spenders
31429,202,9,3048.34,3,2,5,10,Big Spenders
31430,173,9,1443.17,3,2,3,8,Regulars
31431,546,7,1021.7,1,1,2,4,Hibernating
31432,98,15,2411.23,4,5,4,13,Champions
31433,66,11,947.78,4,3,2,9,Loyal
31434,114,12,1115.78,4,4,2,10,Loyal
31435,344,6,1313.1399999999999,2,1,3,6,Regulars
31436,78,12,1324.8400000000001,4,4,3,11,Loyal
31437,4,9,1891.8300000000002,5,2,4,11,Big Spenders
31438,728,10,1643.3799999999999,1,3,3,7,Regulars
31439,274,6,329.83,2,1,1,4,Hibernating
31440,126,10,1121.2,4,3,2,9,Loyal
31441,255,8,1532.83,2,2,3,7,Regulars
31442,53,12,2669.25,5,4,5,14,Champions
31443,549,16,3498.3199999999997,1,5,5,11,At Risk
31444,195,9,600.08,3,2,1,6,Regulars
31445,7,14,1431.3,5,5,3,13,Loyal
31446,93,11,786.63,4,3,1,8,Loyal
31447,43,11,2119.78,5,3,4,12,Loyal
31448,1088,5,274.3,1,1,1,3,Hibernating
31449,54,13,2297.6,5,4,4,13,Champions
31450,40,14,1230.73,5,5,2,12,Loyal
31451,295,11,1168.64,2,3,2,7,Regulars
31452,277,16,2794.06,2,5,5,12,At Risk
31453,8,11,2719.4700000000003,5,3,5,13,Loyal
31454,45,7,881.13,5,1,2,8,Regulars
31455,23,13,1803.73,5,4,4,13,Champions
31456,202,7,689.71,3,1,1,5,Regulars
31457,1775,7,419.11,1,1,1,3,Hibernating
31458,34,11,1405.98,5,3,3,11,Loyal
31459,293,8,1163.71,2,2,2,6,Hibernating
31460,26,10,915.19,5,3,2,10,Loyal
31461,166,7,442.18,3,1,1,5,Regulars
31462,212,12,1537.1999999999998,3,4,3,10,Regulars
31463,159,10,2284.56,3,3,4,10,Big Spenders
31464,63,9,2456.27,5,2,4,11,Big Spenders
31465,195,11,2034.11,3,3,4,10,Big Spenders
31466,176,12,2112.23,3,4,4,11,Big Spenders
31467,29,10,851.2,5,3,2,10,Loyal
31468,556,7,1845.76,1,1,4,6,Regulars
31469,576,10,2399.79,1,3,4,8,Regulars
31470,194,11,1932.1699999999998,3,3,4,10,Big Spenders
31471,0,24,3826.4,5,5,5,15,Champions
31472,235,13,1744.46,3,4,4,11,Big Spenders
31473,32,15,2855.6800000000003,5,5,5,15,Champions
31474,556,11,4402.7,1,3,5,9,Regulars
31475,665,3,210.59999999999997,1,1,1,3,Hibernating
31476,6,16,4305.11,5,5,5,15,Champions
31477,504,10,1806.05,1,3,4,8,Regulars
31478,13,6,462.1900000000001,5,1,1,7,Regulars
31479,5,11,2774.3599999999997,5,3,5,13,Loyal
31480,240,13,1867.29,3,4,4,11,Big Spenders
31481,154,16,1831.1799999999998,3,5,4,12,Big Spenders
31482,276,8,2760.93,2,2,5,9,Regulars
31483,192,13,1883.43,3,4,4,11,Big Spenders
31484,1109,10,1517.8899999999999,1,3,3,7,Regulars
31485,126,9,3075.39,4,2,5,11,Big Spenders
31486,136,10,732.99,4,3,1,8,Loyal
31487,358,10,2259.33,2,3,4,9,Regulars
31488,146,8,823.72,4,2,1,7,Regulars
31489,46,12,4435.549999999999,5,4,5,14,Champions
31490,190,6,637.37,3,1,1,5,Regulars
31491,1602,10,1798.89,1,3,4,8,Regulars
31492,385,15,1066.54,2,5,2,9,At Risk
31493,292,10,2882.56,2,3,5,10,Regulars
31494,556,10,1126.94,1,3,2,6,Regulars
31495,70,8,1076.55,4,2,2,8,Regulars
31496,725,8,2056.89,1,2,4,7,Regulars
31497,15,13,1481.9,5,4,3,12,Loyal
31498,50,12,1825.13,5,4,4,13,Champions
31499,549,9,3711.3,1,2,5,8,Regulars
31500,2,7,483.30999999999995,5,1,1,7,Regulars
31501,131,13,1171.51,4,4,2,10,Loyal
31502,32,11,3874.0699999999997,5,3,5,13,Loyal
31503,131,11,1574.68,4,3,3,10,Loyal
31504,100,11,1078.51,4,3,2,9,Loyal
31505,658,8,839.16,1,2,1,4,Hibernating
31506,132,11,2475.2799999999997,4,3,4,11,Loyal
31507,51,9,1380.6,5,2,3,10,Regulars
31508,448,8,1323.31,2,2,3,7,Regulars
31509,341,10,4231.48,2,3,5,10,Regulars
31510,210,15,4251.049999999999,3,5,5,13,Big Spenders
31511,352,7,1049.51,2,1,2,5,Hibernating
31512,27,10,1753.41,5,3,4,12,Loyal
31513,191,12,1750.41,3,4,4,11,Big Spenders
31514,15,9,3213.91,5,2,5,12,Big Spenders
31515,439,6,307.27,2,1,1,4,Hibernating
31516,37,11,1839.84,5,3,4,12,Loyal
31517,76,11,2185.73,4,3,4,11,Loyal
31518,83,7,959.3199999999999,4,1,2,7,Regulars
31519,23,10,1280.09,5,3,3,11,Loyal
31520,541,12,1830.9499999999998,1,4,4,9,At Risk
31521,190,10,1707.5800000000002,3,3,3,9,Regulars
31522,37,18,2223.2599999999998,5,5,4,14,Champions
31523,485,11,1611.9,1,3,3,7,Regulars
31524,285,9,2355.81,2,2,4,8,Regulars
31525,305,6,1462.06,2,1,3,6,Regulars
31526,69,6,720.1,4,1,1,6,Regulars
31527,154,12,874.5999999999999,3,4,2,9,Regulars
31528,8,13,1670.75,5,4,3,12,Loyal
31529,96,18,2669.88,4,5,5,14,Champions
31530,124,13,946.27,4,4,2,10,Loyal
31531,156,10,1871.71,3,3,4,10,Big Spenders
31532,179,14,2967.19,3,5,5,13,Big Spenders
31533,138,12,1199.98,4,4,2,10,Loyal
31534,350,7,3769.71,2,1,5,8,Regulars
31535,2,8,719.14,5,2,1,8,Regulars
31536,788,5,241.57,1,1,1,3,Hibernating
31537,82,13,3123.29,4,4,5,13,Champions
31538,1580,4,2425.0,1,1,4,6,Regulars
31539,136,11,855.53,4,3,2,9,Loyal
31540,352,10,2084.9700000000003,2,3,4,9,Regulars
31541,188,11,1243.2,3,3,3,9,Regulars
31542,105,11,1294.93,4,3,3,10,Loyal
31543,9,9,1283.81,5,2,3,10,Regulars
31544,45,12,2113.4,5,4,4,13,Champions
31545,491,9,669.5799999999999,1,2,1,4,Hibernating
31546,33,17,3207.83,5,5,5,15,Champions
31547,682,6,1802.04,1,1,4,6,Regulars
31548,1236,4,551.32,1,1,1,3,Hibernating
31549,551,10,1180.27,1,3,2,6,Regulars
31550,216,5,242.99,3,1,1,5,Regulars
31551,937,8,857.46,1,2,2,5,Hibernating
31552,160,16,1349.0700000000002,3,5,3,11,Regulars
31553,30,12,3215.7799999999997,5,4,5,14,Champions
31554,1512,6,929.3599999999999,1,1,2,4,Hibernating
31555,152,6,1282.44,3,1,3,7,Regulars
31556,64,17,1963.71,5,5,4,14,Champions
31557,460,8,1706.35,1,2,3,6,Regulars
31558,13,9,1671.0,5,2,3,10,Regulars
31559,633,7,713.9,1,1,1,3,Hibernating
31560,349,13,2504.74,2,4,4,10,At Risk
31561,197,9,1083.49,3,2,2,7,Regulars
31562,16,12,1687.3600000000001,5,4,3,12,Loyal
31563,372,11,1898.74,2,3,4,9,Regulars
31564,161,13,3410.1,3,4,5,12,Big Spenders
31565,6,12,2584.37,5,4,5,14,Champions
31566,80,8,843.41,4,2,1,7,Regulars
31567,328,12,1037.96,2,4,2,8,At Risk
31568,279,10,2238.11,2,3,4,9,Regulars
31569,56,11,1889.41,5,3,4,12,Loyal
31570,501,8,551.91,1,2,1,4,Hibernating
31571,164,12,5665.77,3,4,5,12,Big Spenders
31572,504,12,1523.98,1,4,3,8,At Risk
31573,444,9,2489.73,2,2,4,8,Regulars
31574,8,8,1021.99,5,2,2,9,Regulars
31575,41,12,1218.96,5,4,2,11,Loyal
31576,673,10,729.0799999999999,1,3,1,5,Regulars
31577,59,7,749.26,5,1,1,7,Regulars
31578,514,11,1847.23,1,3,4,8,Regulars
31579,810,14,2179.2999999999997,1,5,4,10,At Risk
31580,107,12,2903.88,4,4,5,13,Champions
31581,266,8,948.65,2,2,2,6,Hibernating
31582,661,5,438.39,1,1,1,3,Hibernating
31583,602,10,1198.3,1,3,2,6,Regulars
31584,808,9,1336.31,1,2,3,6,Regulars
31585,391,11,2620.56,2,3,5,10,Regulars
31586,1,9,1446.04,5,2,3,10,Regulars
31587,962,7,1336.66,1,1,3,5,Regulars
31588,44,10,2718.73,5,3,5,13,Loyal
31589,262,6,688.1,2,1,1,4,Hibernating
31590,127,12,1930.92,4,4,4,12,Champions
31591,278,8,904.69,2,2,2,6,Hibernating
31592,985,10,924.9399999999999,1,3,2,6,Regulars
31593,18,11,1505.42,5,3,3,11,Loyal
31594,17,14,3149.19,5,5,5,15,Champions
31595,159,9,1699.7,3,2,3,8,Regulars
31596,949,2,185.98000000000002,1,1,1,3,Hibernating
31597,25,10,1393.8799999999999,5,3,3,11,Loyal
31598,55,11,3396.7599999999998,5,3,5,13,Loyal
31599,286,4,186.75,2,1,1,4,Hibernating
31600,440,11,1071.77,2,3,2,7,Regulars
31601,400,15,4283.5,2,5,5,12,At Risk
31602,22,12,1948.69,5,4,4,13,Champions
31603,566,13,2243.8,1,4,4,9,At Risk
31604,483,10,947.16,1,3,2,6,Regulars
31605,748,14,2622.11,1,5,5,11,At Risk
31606,131,10,1162.01,4,3,2,9,Loyal
31607,68,16,2170.08,4,5,4,13,Champions
31608,246,10,2545.07,3,3,4,10,Big Spenders
31609,166,12,2781.12,3,4,5,12,Big Spenders
31610,42,10,598.13,5,3,1,9,Loyal
31611,418,13,2412.77,2,4,4,10,At Risk
31612,405,14,5081.51,2,5,5,12,At Risk
31613,90,8,722.46,4,2,1,7,Regulars
31614,46,12,2533.93,5,4,4,13,Champions
31615,511,5,1916.52,1,1,4,6,Regulars
31616,720,13,1001.04,1,4,2,7,At Risk
31617,99,8,1012.55,4,2,2,8,Regulars
31618,354,9,735.2,2,2,1,5,Hibernating
31619,186,8,725.0899999999999,3,2,1,6,Regulars
31620,244,8,666.1,3,2,1,6,Regulars
31621,41,13,1228.3200000000002,5,4,2,11,Loyal
31622,285,11,946.45,2,3,2,7,Regulars
31623,32,13,1404.0,5,4,3,12,Loyal
31624,94,10,1176.1,4,3,2,9,Loyal
31625,956,5,246.02,1,1,1,3,Hibernating
31626,155,13,1033.01,3,4,2,9,Regulars
31627,71,7,2040.16,4,1,4,9,Big Spenders
31628,204,7,487.11,3,1,1,5,Regulars
31629,538,8,812.05,1,2,1,4,Hibernating
31630,85,9,1484.81,4,2,3,9,Regulars
31631,81,10,1770.6800000000003,4,3,4,11,Loyal
31632,144,13,1313.66,4,4,3,11,Loyal
31633,467,10,1282.8700000000001,1,3,3,7,Regulars
31634,545,9,890.37,1,2,2,5,Hibernating
31635,47,14,4823.41,5,5,5,15,Champions
31636,182,13,1282.22,3,4,3,10,Regulars
31637,0,19,2542.71,5,5,4,14,Champions
31638,12,12,2584.46,5,4,5,14,Champions
31639,50,8,1289.08,5,2,3,10,Regulars
31640,15,10,858.27,5,3,2,10,Loyal
31641,287,12,2583.85,2,4,5,11,At Risk
31642,732,7,831.73,1,1,1,3,Hibernating
31643,302,7,618.67,2,1,1,4,Hibernating
31644,21,10,3555.59,5,3,5,13,Loyal
31645,124,8,2123.52,4,2,4,10,Big Spenders
31646,296,12,1449.1100000000001,2,4,3,9,At Risk
31647,824,10,1014.55,1,3,2,6,Regulars
31648,126,7,434.26,4,1,1,6,Regulars
31649,920,10,2729.18,1,3,5,9,Regulars
31650,120,18,2615.58,4,5,5,14,Champions
31651,152,11,1098.46,3,3,2,8,Regulars
31652,217,16,1213.15,3,5,2,10,Regulars
31653,195,12,1918.23,3,4,4,11,Big Spenders
31654,258,7,1293.84,2,1,3,6,Regulars
31655,162,10,963.37,3,3,2,8,Regulars
31656,19,6,752.03,5,1,1,7,Regulars
31657,619,11,2779.54,1,3,5,9,Regulars
31658,70,12,2302.89,4,4,4,12,Champions
31659,1443,10,817.3199999999999,1,3,1,5,Regulars
31660,101,9,816.04,4,2,1,7,Regulars
31661,385,18,2594.43,2,5,5,12,At Risk
31662,123,10,1120.82,4,3,2,9,Loyal
31663,435,9,1198.62,2,2,2,6,Hibernating
31664,198,11,2392.91,3,3,4,10,Big Spenders
31665,116,11,3190.3300000000004,4,3,5,12,Loyal
31666,220,10,1256.52,3,3,3,9,Regulars
31667,139,12,1665.29,4,4,3,11,Loyal
31668,1207,10,597.36,1,3,1,5,Regulars
31669,453,12,1372.9,2,4,3,9,At Risk
31670,141,11,797.66,4,3,1,8,Loyal
31671,102,19,1955.6,4,5,4,13,Champions
31672,439,7,558.16,2,1,1,4,Hibernating
31673,23,13,1857.46,5,4,4,13,Champions
31674,127,9,2703.51,4,2,5,11,Big Spenders
31675,590,10,1399.92,1,3,3,7,Regulars
31676,601,13,3159.69,1,4,5,10,At Risk
31677,123,9,2676.0,4,2,5,11,Big Spenders
31678,372,10,1563.24,2,3,3,8,Regulars
31679,55,14,1915.53,5,5,4,14,Champions
31680,497,6,530.6600000000001,1,1,1,3,Hibernating
31681,258,11,1190.13,2,3,2,7,Regulars
31682,668,8,902.1600000000001,1,2,2,5,Hibernating
31683,457,9,996.6800000000001,2,2,2,6,Hibernating
31684,537,10,2024.32,1,3,4,8,Regulars
31685,82,10,4125.52,4,3,5,12,Loyal
31686,599,12,2607.47,1,4,5,10,At Risk
31687,159,5,2536.7999999999997,3,1,4,8,Big Spenders
31688,127,16,2405.16,4,5,4,13,Champions
31689,110,8,607.76,4,2,1,7,Regulars
31690,67,11,1738.16,4,3,4,11,Loyal
31691,253,9,1040.25,2,2,2,6,Hibernating
31692,488,9,1037.3,1,2,2,5,Hibernating
31693,277,11,1767.41,2,3,4,9,Regulars
31694,661,9,957.39,1,2,2,5,Hibernating
31695,155,8,1844.3799999999999,3,2,4,9,Big Spenders
31696,441,8,457.73,2,2,1,5,Hibernating
31697,551,6,1500.19,1,1,3,5,Regulars
31698,382,6,1578.1799999999998,2,1,3,6,Regulars
31699,51,8,1090.29,5,2,2,9,Regulars
31700,41,13,4054.2,5,4,5,14,Champions
31701,67,12,764.1,4,4,1,9,Loyal
31702,28,13,2327.22,5,4,4,13,Champions
31703,338,14,1117.22,2,5,2,9,At Risk
31704,44,12,1799.0900000000001,5,4,4,13,Champions
31705,478,12,3477.8599999999997,1,4,5,10,At Risk
31706,149,10,665.17,3,3,1,7,Regulars
31707,321,8,992.28,2,2,2,6,Hibernating
31708,129,8,838.36,4,2,1,7,Regulars
31709,21,13,1451.78,5,4,3,12,Loyal
31710,225,10,955.0699999999999,3,3,2,8,Regulars
31711,52,13,656.46,5,4,1,10,Loyal
31712,191,4,924.2,3,1,2,6,Regulars
31713,401,12,1606.81,2,4,3,9,At Risk
31714,68,13,3730.0299999999997,4,4,5,13,Champions
31715,131,8,663.98,4,2,1,7,Regulars
31716,201,11,1082.24,3,3,2,8,Regulars
31717,559,9,2659.86,1,2,5,8,Regulars
31718,19,12,1276.85,5,4,3,12,Loyal
31719,440,9,2092.34,2,2,4,8,Regulars
31720,7,18,2242.35,5,5,4,14,Champions
31721,88,13,1102.3600000000001,4,4,2,10,Loyal
31722,30,14,2319.5899999999997,5,5,4,14,Champions
31723,27,10,2801.5,5,3,5,13,Loyal
31724,267,11,1161.73,2,3,2,7,Regulars
31725,188,9,1098.24,3,2,2,7,Regulars
31726,18,14,4770.49,5,5,5,15,Champions
31727,144,10,1106.83,4,3,2,9,Loyal
31728,33,9,1795.9299999999998,5,2,4,11,Big Spenders
31729,167,12,5602.84,3,4,5,12,Big Spenders
31730,149,10,1163.75,3,3,2,8,Regulars
31731,119,11,3516.2200000000003,4,3,5,12,Loyal
31732,2327,2,553.0999999999999,1,1,1,3,Hibernating
31733,465,7,808.3,1,1,1,3,Hibernating
31734,516,5,650.93,1,1,1,3,Hibernating
31735,28,14,1725.22,5,5,4,14,Champions
31736,46,10,926.86,5,3,2,10,Loyal
31737,14,13,1290.31,5,4,3,12,Loyal
31738,64,4,134.72,5,1,1,7,Regulars
31739,175,8,1089.63,3,2,2,7,Regulars
31740,56,6,5418.8099999999995,5,1,5,11,Big Spenders
31741,128,11,1165.47,4,3,2,9,Loyal
31742,49,9,1502.33,5,2,3,10,Regulars
31743,440,9,1476.46,2,2,3,7,Regulars
31744,182,6,974.74,3,1,2,6,Regulars
31745,45,9,2626.55,5,2,5,12,Big Spenders
31746,484,12,2078.79,1,4,4,9,At Risk
31747,472,8,2287.59,1,2,4,7,Regulars
31748,207,10,2134.2400000000002,3,3,4,10,Big Spenders
31749,808,5,209.82999999999998,1,1,1,3,Hibernating
31750,376,12,2970.91,2,4,5,11,At Risk
31751,327,7,353.6,2,1,1,4,Hibernating
31752,550,11,2274.7,1,3,4,8,Regulars
31753,139,8,1037.39,4,2,2,8,Regulars
31754,524,16,2856.87,1,5,5,11,At Risk
31755,963,7,711.85,1,1,1,3,Hibernating
31756,394,7,873.26,2,1,2,5,Hibernating
31757,574,8,619.83,1,2,1,4,Hibernating
31758,62,11,1192.1299999999999,5,3,2,10,Loyal
31759,491,10,3889.9700000000003,1,3,5,9,Regulars
31760,65,8,564.47,5,2,1,8,Regulars
31761,99,10,4069.4100000000003,4,3,5,12,Loyal
31762,1257,8,529.33,1,2,1,4,Hibernating
31763,38,9,1352.8600000000001,5,2,3,10,Regulars
31764,698,7,370.35,1,1,1,3,Hibernating
31765,15,11,2781.42,5,3,5,13,Loyal
31766,220,9,864.83,3,2,2,7,Regulars
31767,237,7,2026.9199999999998,3,1,4,8,Big Spenders
31768,145,7,702.6,4,1,1,6,Regulars
31769,308,14,3085.17,2,5,5,12,At Risk
31770,301,7,560.3199999999999,2,1,1,4,Hibernating
31771,649,6,816.9,1,1,1,3,Hibernating
31772,74,15,2516.47,4,5,4,13,Champions
31773,28,5,925.1999999999999,5,1,2,8,Regulars
31774,28,13,3134.21,5,4,5,14,Champions
31775,337,13,1097.8,2,4,2,8,At Risk
31776,208,13,1279.65,3,4,3,10,Regulars
31777,169,13,1248.8,3,4,3,10,Regulars
31778,232,14,2584.6,3,5,5,13,Big Spenders
31779,109,13,1578.03,4,4,3,11,Loyal
31780,206,9,1279.22,3,2,3,8,Regulars
31781,114,3,148.74,4,1,1,6,Regulars
31782,383,8,839.3499999999999,2,2,1,5,Hibernating
31783,342,11,2687.2400000000002,2,3,5,10,Regulars
31784,229,13,3873.19,3,4,5,12,Big Spenders
31785,23,11,3525.67,5,3,5,13,Loyal
31786,809,6,579.61,1,1,1,3,Hibernating
31787,513,6,1029.8899999999999,1,1,2,4,Hibernating
31788,61,14,1912.9299999999998,5,5,4,14,Champions
31789,55,19,3125.52,5,5,5,15,Champions
31790,36,9,3804.04,5,2,5,12,Big Spenders
31791,256,8,1614.29,2,2,3,7,Regulars
31792,461,9,2742.03,1,2,5,8,Regulars
31793,106,10,2667.77,4,3,5,12,Loyal
31794,272,10,1595.61,2,3,3,8,Regulars
31795,260,11,1981.6,2,3,4,9,Regulars
31796,147,9,2045.3500000000001,4,2,4,10,Big Spenders
31797,282,10,1679.99,2,3,3,8,Regulars
31798,153,11,1773.8700000000001,3,3,4,10,Big Spenders
31799,8,9,775.66,5,2,1,8,Regulars
31800,394,10,3849.13,2,3,5,10,Regulars
31801,55,9,607.8,5,2,1,8,Regulars
31802,298,8,618.6700000000001,2,2,1,5,Hibernating
31803,64,7,947.72,5,1,2,8,Regulars
31804,275,8,2547.19,2,2,4,8,Regulars
31805,242,5,337.23,3,1,1,5,Regulars
31806,65,10,3232.2,5,3,5,13,Loyal
31807,741,17,5988.389999999999,1,5,5,11,At Risk
31808,298,16,1524.2,2,5,3,10,At Risk
31809,19,8,899.7099999999999,5,2,2,9,Regulars
31810,21,12,2401.84,5,4,4,13,Champions
31811,23,6,624.5,5,1,1,7,Regulars
31812,106,13,2740.55,4,4,5,13,Champions
31813,883,9,1679.15,1,2,3,6,Regulars
31814,64,11,2120.25,5,3,4,12,Loyal
31815,131,17,2152.79,4,5,4,13,Champions
31816,416,8,684.86,2,2,1,5,Hibernating
31817,7,8,2131.92,5,2,4,11,Big Spenders
31818,630,12,1198.85,1,4,2,7,At Risk
31819,142,16,3620.7200000000003,4,5,5,14,Champions
31820,963,6,1087.15,1,1,2,4,Hibernating
31821,5,8,1121.99,5,2,2,9,Regulars
31822,79,7,508.13,4,1,1,6,Regulars
31823,298,11,1583.46,2,3,3,8,Regulars
31824,473,7,1855.1,1,1,4,6,Regulars
31825,7,14,1799.1399999999999,5,5,4,14,Champions
31826,798,8,892.73,1,2,2,5,Hibernating
31827,93,13,3114.1,4,4,5,13,Champions
31828,37,13,1698.63,5,4,3,12,Loyal
31829,262,14,1748.44,2,5,4,11,At Risk
31830,353,9,492.65,2,2,1,5,Hibernating
31831,154,12,1668.46,3,4,3,10,Regulars
31832,779,7,1408.01,1,1,3,5,Regulars
31833,88,10,770.73,4,3,1,8,Loyal
31834,204,12,999.21,3,4,2,9,Regulars
31835,191,11,2950.05,3,3,5,11,Big Spenders
31836,123,15,2411.05,4,5,4,13,Champions
31837,29,15,2602.75,5,5,5,15,Champions
31838,660,11,590.08,1,3,1,5,Regulars
31839,21,8,781.05,5,2,1,8,Regulars
31840,119,14,2917.9,4,5,5,14,Champions
31841,211,10,914.95,3,3,2,8,Regulars
31842,79,10,5720.57,4,3,5,12,Loyal
31843,47,13,2475.69,5,4,4,13,Champions
31844,64,13,727.67,5,4,1,10,Loyal
31845,296,10,1272.8500000000001,2,3,3,8,Regulars
31846,67,6,1446.8100000000002,4,1,3,8,Regulars
31847,449,9,1525.18,2,2,3,7,Regulars
31848,161,17,1622.68,3,5,3,11,Regulars
31849,268,8,691.57,2,2,1,5,Hibernating
31850,669,13,1570.59,1,4,3,8,At Risk
31851,148,15,2997.99,3,5,5,13,Big Spenders
31852,354,10,3830.71,2,3,5,10,Regulars
31853,404,10,1329.28,2,3,3,8,Regulars
31854,155,13,1554.72,3,4,3,10,Regulars
31855,24,14,1342.11,5,5,3,13,Loyal
31856,135,11,3333.79,4,3,5,12,Loyal
31857,210,11,1128.97,3,3,2,8,Regulars
31858,231,9,956.11,3,2,2,7,Regulars
31859,220,8,802.08,3,2,1,6,Regulars
31860,186,8,1208.67,3,2,2,7,Regulars
31861,83,21,2520.08,4,5,4,13,Champions
31862,4,11,1670.3600000000001,5,3,3,11,Loyal
31863,107,10,719.08,4,3,1,8,Loyal
31864,0,6,957.35,5,1,2,8,Regulars
31865,4,7,589.64,5,1,1,7,Regulars
31866,574,7,1146.8200000000002,1,1,2,4,Hibernating
31867,171,10,1433.8999999999999,3,3,3,9,Regulars
31868,185,10,1734.4,3,3,4,10,Big Spenders
31869,12,8,1043.19,5,2,2,9,Regulars
31870,374,11,934.6200000000001,2,3,2,7,Regulars
31871,281,7,2652.28,2,1,5,8,Regulars
31872,157,6,1380.31,3,1,3,7,Regulars
31873,69,15,2256.27,4,5,4,13,Champions
31874,226,11,1527.83,3,3,3,9,Regulars
31875,430,7,2139.95,2,1,4,7,Regulars
31876,449,9,1594.95,2,2,3,7,Regulars
31877,263,13,1523.12,2,4,3,9,At Risk
31878,57,11,970.67,5,3,2,10,Loyal
31879,449,10,3158.1,2,3,5,10,Regulars
31880,156,12,4209.98,3,4,5,12,Big Spenders
31881,317,13,2215.92,2,4,4,10,At Risk
31882,15,13,1280.03,5,4,3,12,Loyal
31883,45,10,1464.87,5,3,3,11,Loyal
31884,294,7,435.5,2,1,1,4,Hibernating
31885,834,7,1803.01,1,1,4,6,Regulars
31886,496,8,1140.3100000000002,1,2,2,5,Hibernating
31887,569,9,2627.3,1,2,5,8,Regulars
31888,135,11,674.03,4,3,1,8,Loyal
31889,67,5,427.61,4,1,1,6,Regulars
31890,81,11,772.16,4,3,1,8,Loyal
31891,300,9,1086.72,2,2,2,6,Hibernating
31892,783,9,675.22,1,2,1,4,Hibernating
31893,848,8,2951.5299999999997,1,2,5,8,Regulars
31894,219,12,1136.8,3,4,2,9,Regulars
31895,185,12,1583.49,3,4,3,10,Regulars
31896,230,10,2097.96,3,3,4,10,Big Spenders
31897,185,13,3253.14,3,4,5,12,Big Spenders
31898,107,13,1508.99,4,4,3,11,Loyal
31899,158,11,1357.34,3,3,3,9,Regulars
31900,100,16,1640.4099999999999,4,5,3,12,Loyal
31901,699,9,1244.67,1,2,3,6,Regulars
31902,174,14,1593.21,3,5,3,11,Regulars
31903,404,7,2042.7900000000002,2,1,4,7,Regulars
31904,201,10,2844.54,3,3,5,11,Big Spenders
31905,290,9,2068.1200000000003,2,2,4,8,Regulars
31906,528,9,748.47,1,2,1,4,Hibernating
31907,40,7,556.9200000000001,5,1,1,7,Regulars
31908,126,13,1993.2299999999998,4,4,4,12,Champions
31909,114,8,1170.15,4,2,2,8,Regulars
31910,122,13,1043.93,4,4,2,10,Loyal
31911,216,18,2797.35,3,5,5,13,Big Spenders
31912,52,6,545.49,5,1,1,7,Regulars
31913,454,7,1580.12,2,1,3,6,Regulars
31914,509,8,680.0899999999999,1,2,1,4,Hibernating
31915,52,10,847.49,5,3,2,10,Loyal
31916,632,9,1485.6699999999998,1,2,3,6,Regulars
31917,896,9,1828.92,1,2,4,7,Regulars
31918,144,15,3026.01,4,5,5,14,Champions
31919,0,11,721.45,5,3,1,9,Loyal
31920,58,7,949.1800000000001,5,1,2,8,Regulars
31921,4,11,779.61,5,3,1,9,Loyal
31922,1189,7,745.92,1,1,1,3,Hibernating
31923,333,8,906.94,2,2,2,6,Hibernating
31924,498,12,4314.44,1,4,5,10,At Risk
31925,108,10,1651.41,4,3,3,10,Loyal
31926,453,15,5957.5,2,5,5,12,At Risk
31927,469,11,1691.18,1,3,3,7,Regulars
31928,191,12,1521.1,3,4,3,10,Regulars
31929,403,17,3172.88,2,5,5,12,At Risk
31930,83,13,1407.76,4,4,3,11,Loyal
31931,158,9,904.99,3,2,2,7,Regulars
31932,22,19,4025.71,5,5,5,15,Champions
31933,60,16,4112.92,5,5,5,15,Champions
31934,32,9,2178.5,5,2,4,11,Big Spenders
31935,537,15,2599.06,1,5,5,11,At Risk
31936,464,8,630.87,1,2,1,4,Hibernating
31937,14,11,1213.36,5,3,2,10,Loyal
31938,305,17,2270.63,2,5,4,11,At Risk
31939,267,8,2623.37,2,2,5,9,Regulars
31940,396,8,852.12,2,2,2,6,Hibernating
31941,344,10,1550.1,2,3,3,8,Regulars
31942,187,12,652.95,3,4,1,8,Regulars
31943,91,13,4284.11,4,4,5,13,Champions
31944,60,11,1144.79,5,3,2,10,Loyal
31945,842,6,1112.99,1,1,2,4,Hibernating
31946,207,9,682.46,3,2,1,6,Regulars
31947,48,8,2092.7,5,2,4,11,Big Spenders
31948,448,9,2174.9,2,2,4,8,Regulars
31949,126,13,1858.7,4,4,4,12,Champions
31950,168,9,4088.61,3,2,5,10,Big Spenders
31951,69,9,3547.09,4,2,5,11,Big Spenders
31952,145,10,954.55,4,3,2,9,Loyal
31953,650,8,499.97,1,2,1,4,Hibernating
31954,347,10,830.06,2,3,1,6,Regulars
31955,13,6,591.3199999999999,5,1,1,7,Regulars
31956,21,11,2063.6,5,3,4,12,Loyal
31957,441,7,2468.56,2,1,4,7,Regulars
31958,118,11,1168.97,4,3,2,9,Loyal
31959,331,10,1182.48,2,3,2,7,Regulars
31960,508,8,1151.05,1,2,2,5,Hibernating
31961,185,10,1321.9399999999998,3,3,3,9,Regulars
31962,126,11,916.49,4,3,2,9,Loyal
31963,322,8,712.0999999999999,2,2,1,5,Hibernating
31964,220,9,799.22,3,2,1,6,Regulars
31965,572,12,1880.84,1,4,4,9,At Risk
31966,366,11,3541.96,2,3,5,10,Regulars
31967,100,15,1875.68,4,5,4,13,Champions
31968,187,9,1217.33,3,2,2,7,Regulars
31969,528,7,431.03,1,1,1,3,Hibernating
31970,305,8,994.27,2,2,2,6,Hibernating
31971,512,11,488.98,1,3,1,5,Regulars
31972,116,16,4128.83,4,5,5,14,Champions
31973,109,16,3102.67,4,5,5,14,Champions
31974,332,7,1656.73,2,1,3,6,Regulars
31975,127,7,737.66,4,1,1,6,Regulars
31976,208,14,1452.28,3,5,3,11,Regulars
31977,588,13,1757.28,1,4,4,9,At Risk
31978,151,8,985.8,3,2,2,7,Regulars
31979,453,10,1193.27,2,3,2,7,Regulars
31980,571,10,871.13,1,3,2,6,Regulars
31981,242,12,3491.47,3,4,5,12,Big Spenders
31982,74,18,1441.81,4,5,3,12,Loyal
31983,477,12,1347.31,1,4,3,8,At Risk
31984,197,14,2777.47,3,5,5,13,Big Spenders
31985,60,14,5354.57,5,5,5,15,Champions
31986,225,9,1770.35,3,2,4,9,Big Spenders
31987,212,12,1951.8400000000001,3,4,4,11,Big Spenders
31988,5,7,1046.68,5,1,2,8,Regulars
31989,439,10,831.32,2,3,1,6,Regulars
31990,850,11,1802.8200000000002,1,3,4,8,Regulars
31991,255,8,1497.8600000000001,2,2,3,7,Regulars
31992,433,10,1361.54,2,3,3,8,Regulars
31993,440,12,1400.58,2,4,3,9,At Risk
31994,562,13,2832.48,1,4,5,10,At Risk
31995,119,11,2414.68,4,3,4,11,Loyal
31996,1046,7,921.1,1,1,2,4,Hibernating
31997,128,15,3731.5000000000005,4,5,5,14,Champions
31998,305,7,1153.47,2,1,2,5,Hibernating
31999,50,13,2800.15,5,4,5,14,Champions
32000,57,9,1909.56,5,2,4,11,Big Spenders
32001,278,14,2366.66,2,5,4,11,At Risk
32002,234,12,1536.1599999999999,3,4,3,10,Regulars
32003,21,8,468.6,5,2,1,8,Regulars
32004,26,17,3239.17,5,5,5,15,Champions
32005,283,8,1855.07,2,2,4,8,Regulars
32006,286,7,1542.23,2,1,3,6,Regulars
32007,150,11,1344.7,3,3,3,9,Regulars
32008,137,8,2210.88,4,2,4,10,Big Spenders
32009,135,13,1917.49,4,4,4,12,Champions
32010,166,17,2524.4,3,5,4,12,Big Spenders
32011,122,8,770.17,4,2,1,7,Regulars
32012,140,12,2759.93,4,4,5,13,Champions
32013,38,11,1184.1399999999999,5,3,2,10,Loyal
32014,248,8,2967.89,2,2,5,9,Regulars
32015,369,9,718.79,2,2,1,5,Hibernating
32016,135,15,4138.96,4,5,5,14,Champions
32017,449,15,1665.6399999999999,2,5,3,10,At Risk
32018,175,12,1443.6100000000001,3,4,3,10,Regulars
32019,670,11,3345.4500000000003,1,3,5,9,Regulars
32020,343,12,862.0799999999999,2,4,2,8,At Risk
32021,70,15,2583.13,4,5,5,14,Champions
32022,268,13,1210.51,2,4,2,8,At Risk
32023,22,10,1727.3600000000001,5,3,4,12,Loyal
32024,220,10,981.5,3,3,2,8,Regulars
32025,178,9,1358.5,3,2,3,8,Regulars
32026,2,8,660.14,5,2,1,8,Regulars
32027,263,9,827.2299999999999,2,2,1,5,Hibernating
32028,89,11,2702.42,4,3,5,12,Loyal
32029,203,8,2925.71,3,2,5,10,Big Spenders
32030,274,12,1387.3600000000001,2,4,3,9,At Risk
32031,1028,12,1268.7,1,4,3,8,At Risk
32032,50,8,700.27,5,2,1,8,Regulars
32033,84,14,2612.83,4,5,5,14,Champions
32034,399,4,735.0799999999999,2,1,1,4,Hibernating
32035,154,7,1270.67,3,1,3,7,Regulars
32036,10,14,3186.6,5,5,5,15,Champions
32037,45,14,1652.74,5,5,3,13,Loyal
32038,174,9,1340.83,3,2,3,8,Regulars
32039,214,15,1940.1200000000001,3,5,4,12,Big Spenders
32040,524,10,875.41,1,3,2,6,Regulars
32041,104,18,5381.34,4,5,5,14,Champions
32042,92,15,1816.36,4,5,4,13,Champions
32043,19,14,3386.21,5,5,5,15,Champions
32044,332,6,354.08,2,1,1,4,Hibernating
32045,226,14,3241.81,3,5,5,13,Big Spenders
32046,202,9,1632.11,3,2,3,8,Regulars
32047,84,6,841.88,4,1,1,6,Regulars
32048,1257,5,969.2,1,1,2,4,Hibernating
32049,562,4,372.0,1,1,1,3,Hibernating
32050,112,8,394.51,4,2,1,7,Regulars
32051,137,13,2661.85,4,4,5,13,Champions
32052,246,11,1307.2600000000002,3,3,3,9,Regulars
32053,56,10,3101.5299999999997,5,3,5,13,Loyal
32054,634,7,1981.7999999999997,1,1,4,6,Regulars
32055,113,12,4562.08,4,4,5,13,Champions
32056,135,12,1586.5300000000002,4,4,3,11,Loyal
32057,101,7,1235.0900000000001,4,1,2,7,Regulars
32058,189,8,1713.7600000000002,3,2,3,8,Regulars
32059,83,12,4084.1600000000003,4,4,5,13,Champions
32060,40,8,1058.72,5,2,2,9,Regulars
32061,622,11,840.3,1,3,1,5,Regulars
32062,528,11,3219.43,1,3,5,9,Regulars
32063,331,10,727.65,2,3,1,6,Regulars
32064,215,13,1645.55,3,4,3,10,Regulars
32065,50,13,2312.6400000000003,5,4,4,13,Champions
32066,79,10,1159.47,4,3,2,9,Loyal
32067,148,9,707.45,3,2,1,6,Regulars
32068,441,13,1405.69,2,4,3,9,At Risk
32069,126,11,994.8500000000001,4,3,2,9,Loyal
32070,81,10,1981.0900000000001,4,3,4,11,Loyal
32071,138,10,839.88,4,3,1,8,Loyal
32072,409,11,1439.51,2,3,3,8,Regulars
32073,67,8,921.56,4,2,2,8,Regulars
32074,98,11,1502.6200000000001,4,3,3,10,Loyal
32075,23,10,1008.47,5,3,2,10,Loyal
32076,148,17,2546.48,3,5,4,12,Big Spenders
32077,54,8,889.6500000000001,5,2,2,9,Regulars
32078,422,15,2468.69,2,5,4,11,At Risk
32079,1548,3,599.76,1,1,1,3,Hibernating
32080,14,15,3546.0399999999995,5,5,5,15,Champions
32081,72,11,2095.24,4,3,4,11,Loyal
32082,150,7,632.77,3,1,1,5,Regulars
32083,45,7,1216.88,5,1,2,8,Regulars
32084,487,8,666.13,1,2,1,4,Hibernating
32085,318,6,899.26,2,1,2,5,Hibernating
32086,185,9,1205.15,3,2,2,7,Regulars
32087,119,8,3074.8999999999996,4,2,5,11,Big Spenders
32088,561,14,1463.52,1,5,3,9,At Risk
32089,451,4,1108.06,2,1,2,5,Hibernating
32090,456,8,1541.71,2,2,3,7,Regulars
32091,134,10,3260.55,4,3,5,12,Loyal
32092,846,8,788.69,1,2,1,4,Hibernating
32093,130,12,2821.41,4,4,5,13,Champions
32094,220,8,764.2,3,2,1,6,Regulars
32095,23,16,4826.650000000001,5,5,5,15,Champions
32096,74,10,2998.04,4,3,5,12,Loyal
32097,73,7,868.86,4,1,2,7,Regulars
32098,190,5,1640.7099999999996,3,1,3,7,Regulars
32099,197,11,3651.02,3,3,5,11,Big Spenders
32100,25,7,631.86,5,1,1,7,Regulars
32101,250,12,1453.86,2,4,3,9,At Risk
32102,85,12,1769.74,4,4,4,12,Champions
32103,135,11,971.25,4,3,2,9,Loyal
32104,58,13,1428.41,5,4,3,12,Loyal
32105,331,9,1155.03,2,2,2,6,Hibernating
32106,276,16,1195.3899999999999,2,5,2,9,At Risk
32107,93,8,1251.51,4,2,3,9,Regulars
32108,428,11,1663.98,2,3,3,8,Regulars
32109,80,16,4186.01,4,5,5,14,Champions
32110,290,10,1310.38,2,3,3,8,Regulars
32111,67,6,948.48,4,1,2,7,Regulars
32112,12,12,1719.88,5,4,3,12,Loyal
32113,49,8,614.5,5,2,1,8,Regulars
32114,256,16,5074.21,2,5,5,12,At Risk
32115,146,13,1924.14,4,4,4,12,Champions
32116,56,9,3617.19,5,2,5,12,Big Spenders
32117,160,17,1484.72,3,5,3,11,Regulars
32118,24,9,3258.73,5,2,5,12,Big Spenders
32119,139,12,899.24,4,4,2,10,Loyal
32120,126,11,1100.28,4,3,2,9,Loyal
32121,74,12,875.75,4,4,2,10,Loyal
32122,9,19,2658.6,5,5,5,15,Champions
32123,122,15,4686.610000000001,4,5,5,14,Champions
32124,175,7,325.58,3,1,1,5,Regulars
32125,211,10,2955.6600000000003,3,3,5,11,Big Spenders
32126,391,10,732.91,2,3,1,6,Regulars
32127,495,9,1291.16,1,2,3,6,Regulars
32128,565,9,1892.65,1,2,4,7,Regulars
32129,140,16,3624.28,4,5,5,14,Champions
32130,221,13,2626.21,3,4,5,12,Big Spenders
32131,225,12,2353.0,3,4,4,11,Big Spenders
32132,192,11,2485.43,3,3,4,10,Big Spenders
32133,184,9,519.48,3,2,1,6,Regulars
32134,186,10,591.26,3,3,1,7,Regulars
32135,95,11,3227.1299999999997,4,3,5,12,Loyal
32136,258,8,4201.16,2,2,5,9,Regulars
32137,275,10,2866.44,2,3,5,10,Regulars
32138,129,14,2456.55,4,5,4,13,Champions
32139,383,11,3849.2400000000007,2,3,5,10,Regulars
32140,379,13,2527.52,2,4,4,10,At Risk
32141,241,22,2603.76,3,5,5,13,Big Spenders
32142,40,12,2873.7,5,4,5,14,Champions
32143,254,15,3699.93,2,5,5,12,At Risk
32144,168,12,2314.1600000000003,3,4,4,11,Big Spenders
32145,87,10,917.63,4,3,2,9,Loyal
32146,673,6,406.04999999999995,1,1,1,3,Hibernating
32147,20,7,677.76,5,1,1,7,Regulars
32148,180,14,2694.71,3,5,5,13,Big Spenders
32149,84,11,1691.69,4,3,3,10,Loyal
32150,449,5,1552.2299999999998,2,1,3,6,Regulars
32151,75,7,2152.46,4,1,4,9,Big Spenders
32152,39,6,762.47,5,1,1,7,Regulars
32153,2,14,2919.81,5,5,5,15,Champions
32154,351,9,2608.9,2,2,5,9,Regulars
32155,253,9,2048.54,2,2,4,8,Regulars
32156,39,9,1997.1599999999999,5,2,4,11,Big Spenders
32157,71,9,2751.77,4,2,5,11,Big Spenders
32158,262,11,2823.77,2,3,5,10,Regulars
32159,263,12,4862.26,2,4,5,11,At Risk
32160,43,16,1540.56,5,5,3,13,Loyal
32161,144,9,711.22,4,2,1,7,Regulars
32162,118,12,835.37,4,4,1,9,Loyal
32163,414,9,1921.24,2,2,4,8,Regulars
32164,159,4,517.2,3,1,1,5,Regulars
32165,174,11,2030.62,3,3,4,10,Big Spenders
32166,332,7,2347.75,2,1,4,7,Regulars
32167,284,8,708.59,2,2,1,5,Hibernating
32168,48,7,1257.48,5,1,3,9,Regulars
32169,321,10,3190.36,2,3,5,10,Regulars
32170,199,10,2460.74,3,3,4,10,Big Spenders
32171,179,11,1863.11,3,3,4,10,Big Spenders
32172,23,4,382.03999999999996,5,1,1,7,Regulars
32173,307,8,2798.83,2,2,5,9,Regulars
32174,418,17,1845.24,2,5,4,11,At Risk
32175,983,12,3061.33,1,4,5,10,At Risk
32176,210,12,2715.69,3,4,5,12,Big Spenders
32177,440,7,2820.0200000000004,2,1,5,8,Regulars
32178,15,14,2116.25,5,5,4,14,Champions
32179,353,7,822.8299999999999,2,1,1,4,Hibernating
32180,42,11,958.67,5,3,2,10,Loyal
32181,561,6,1101.71,1,1,2,4,Hibernating
32182,239,7,571.39,3,1,1,5,Regulars
32183,181,8,864.65,3,2,2,7,Regulars
32184,300,12,1362.0,2,4,3,9,At Risk
32185,54,8,808.4300000000001,5,2,1,8,Regulars
32186,195,10,3661.6400000000003,3,3,5,11,Big Spenders
32187,649,10,922.88,1,3,2,6,Regulars
32188,150,10,1093.02,3,3,2,8,Regulars
32189,496,11,701.3,1,3,1,5,Regulars
32190,86,13,1375.0700000000002,4,4,3,11,Loyal
32191,410,16,2529.29,2,5,4,11,At Risk
32192,26,9,2252.96,5,2,4,11,Big Spenders
32193,862,7,1961.93,1,1,4,6,Regulars
32194,127,8,1914.52,4,2,4,10,Big Spenders
32195,448,8,615.52,2,2,1,5,Hibernating
32196,101,5,406.36,4,1,1,6,Regulars
32197,975,8,685.11,1,2,1,4,Hibernating
32198,268,14,1020.59,2,5,2,9,At Risk
32199,100,9,914.34,4,2,2,8,Regulars
32200,775,9,1259.42,1,2,3,6,Regulars
32201,67,14,1472.99,4,5,3,12,Loyal
32202,119,7,1001.39,4,1,2,7,Regulars
32203,117,10,1377.63,4,3,3,10,Loyal
32204,96,10,1589.7,4,3,3,10,Loyal
32205,44,10,1824.52,5,3,4,12,Loyal
32206,43,16,3264.85,5,5,5,15,Champions
32207,166,12,937.22,3,4,2,9,Regulars
32208,21,14,2455.17,5,5,4,14,Champions
32209,68,12,2211.96,4,4,4,12,Champions
32210,281,10,976.6400000000001,2,3,2,7,Regulars
32211,53,14,3434.92,5,5,5,15,Champions
32212,59,13,5581.47,5,4,5,14,Champions
32213,85,15,1803.02,4,5,4,13,Champions
32214,67,8,1124.6100000000001,4,2,2,8,Regulars
32215,135,13,2505.12,4,4,4,12,Champions
32216,600,14,4858.93,1,5,5,11,At Risk
32217,902,12,1613.44,1,4,3,8,At Risk
32218,104,7,797.1800000000001,4,1,1,6,Regulars
32219,99,9,1697.6499999999996,4,2,3,9,Regulars
32220,298,6,1484.52,2,1,3,6,Regulars
32221,166,10,884.35,3,3,2,8,Regulars
32222,5,12,1895.6,5,4,4,13,Champions
32223,876,7,554.54,1,1,1,3,Hibernating
32224,331,14,4326.7,2,5,5,12,At Risk
32225,87,14,4398.58,4,5,5,14,Champions
32226,196,14,2011.9399999999998,3,5,4,12,Big Spenders
32227,410,5,1764.8600000000001,2,1,4,7,Regulars
32228,11,8,1345.3700000000001,5,2,3,10,Regulars
32229,92,14,4087.3799999999997,4,5,5,14,Champions
32230,25,8,651.9200000000001,5,2,1,8,Regulars
32231,1304,8,1492.61,1,2,3,6,Regulars
32232,798,12,4052.49,1,4,5,10,At Risk
32233,66,11,2422.21,4,3,4,11,Loyal
32234,438,7,526.22,2,1,1,4,Hibernating
32235,211,12,893.93,3,4,2,9,Regulars
32236,183,12,2455.1000000000004,3,4,4,11,Big Spenders
32237,818,7,736.2,1,1,1,3,Hibernating
32238,261,12,1845.93,2,4,4,10,At Risk
32239,60,12,2915.55,5,4,5,14,Champions
32240,116,9,2435.34,4,2,4,10,Big Spenders
32241,136,16,2886.3199999999997,4,5,5,14,Champions
32242,490,10,1352.8300000000002,1,3,3,7,Regulars
32243,1179,3,317.53,1,1,1,3,Hibernating
32244,297,9,1274.3500000000001,2,2,3,7,Regulars
32245,69,12,1693.54,4,4,3,11,Loyal
32246,528,13,2155.2,1,4,4,9,At Risk
32247,17,11,2181.58,5,3,4,12,Loyal
32248,50,5,2221.5,5,1,4,10,Big Spenders
32249,1203,6,1119.81,1,1,2,4,Hibernating
32250,220,8,1652.04,3,2,3,8,Regulars
32251,15,13,4166.18,5,4,5,14,Champions
32252,122,10,1487.9199999999998,4,3,3,10,Loyal
32253,0,10,1140.6399999999999,5,3,2,10,Loyal
32254,481,15,1083.07,1,5,2,8,At Risk
32255,152,6,555.3,3,1,1,5,Regulars
32256,202,12,2064.36,3,4,4,11,Big Spenders
32257,617,9,1059.52,1,2,2,5,Hibernating
32258,157,12,2749.57,3,4,5,12,Big Spenders
32259,202,14,2718.29,3,5,5,13,Big Spenders
32260,1062,7,791.6,1,1,1,3,Hibernating
32261,207,15,1186.98,3,5,2,10,Regulars
32262,59,11,1508.7,5,3,3,11,Loyal
32263,133,6,1084.48,4,1,2,7,Regulars
32264,125,10,2550.9300000000003,4,3,4,11,Loyal
32265,82,13,1123.73,4,4,2,10,Loyal
32266,395,9,1076.03,2,2,2,6,Hibernating
32267,2,6,827.4200000000001,5,1,1,7,Regulars
32268,356,12,1142.06,2,4,2,8,At Risk
32269,162,9,1170.38,3,2,2,7,Regulars
32270,110,13,1701.5900000000001,4,4,3,11,Loyal
32271,147,11,3147.66,4,3,5,12,Loyal
32272,289,9,1979.3999999999996,2,2,4,8,Regulars
32273,447,9,2884.4300000000003,2,2,5,9,Regulars
32274,376,10,1052.25,2,3,2,7,Regulars
32275,320,13,2133.05,2,4,4,10,At Risk
32276,553,10,3367.6899999999996,1,3,5,9,Regulars
32277,207,11,2341.73,3,3,4,10,Big Spenders
32278,23,17,3882.11,5,5,5,15,Champions
32279,1009,10,2624.9,1,3,5,9,Regulars
32280,5,9,2215.04,5,2,4,11,Big Spenders
32281,180,13,1747.19,3,4,4,11,Big Spenders
32282,903,8,753.51,1,2,1,4,Hibernating
32283,259,11,3490.66,2,3,5,10,Regulars
32284,268,14,2045.48,2,5,4,11,At Risk
32285,243,11,4808.650000000001,3,3,5,11,Big Spenders
32286,171,8,598.29,3,2,1,6,Regulars
32287,268,8,1348.42,2,2,3,7,Regulars
32288,130,7,2857.3599999999997,4,1,5,10,Big Spenders
32289,331,13,3222.4099999999994,2,4,5,11,At Risk
32290,348,7,1924.61,2,1,4,7,Regulars
32291,203,12,4164.55,3,4,5,12,Big Spenders
32292,121,20,2492.01,4,5,4,13,Champions
32293,193,10,917.7900000000001,3,3,2,8,Regulars
32294,89,9,867.51,4,2,2,8,Regulars
32295,589,7,2357.01,1,1,4,6,Regulars
32296,212,11,2927.52,3,3,5,11,Big Spenders
32297,59,7,453.97,5,1,1,7,Regulars
32298,219,12,2626.44,3,4,5,12,Big Spenders
32299,130,6,614.9300000000001,4,1,1,6,Regulars
32300,400,11,1445.9,2,3,3,8,Regulars
32301,273,10,1026.11,2,3,2,7,Regulars
32302,286,11,1593.71,2,3,3,8,Regulars
32303,20,13,1685.1999999999998,5,4,3,12,Loyal
32304,127,9,551.83,4,2,1,7,Regulars
32305,933,8,605.68,1,2,1,4,Hibernating
32306,425,8,1216.26,2,2,2,6,Hibernating
32307,377,9,757.9,2,2,1,5,Hibernating
32308,100,13,2353.55,4,4,4,12,Champions
32309,621,7,737.7,1,1,1,3,Hibernating
32310,107,12,2824.91,4,4,5,13,Champions
32311,70,7,1517.15,4,1,3,8,Regulars
32312,191,9,835.0799999999999,3,2,1,6,Regulars
32313,805,8,986.94,1,2,2,5,Hibernating
32314,24,11,979.49,5,3,2,10,Loyal
32315,81,13,3820.09,4,4,5,13,Champions
32316,515,7,606.59,1,1,1,3,Hibernating
32317,479,7,377.29999999999995,1,1,1,3,Hibernating
32318,234,8,1128.47,3,2,2,7,Regulars
32319,47,10,1273.8200000000002,5,3,3,11,Loyal
32320,166,10,2885.92,3,3,5,11,Big Spenders
32321,25,11,1803.03,5,3,4,12,Loyal
32322,190,9,3227.0600000000004,3,2,5,10,Big Spenders
32323,110,8,2027.54,4,2,4,10,Big Spenders
32324,812,8,988.49,1,2,2,5,Hibernating
32325,245,10,2149.39,3,3,4,10,Big Spenders
32326,113,5,728.66,4,1,1,6,Regulars
32327,578,9,2504.87,1,2,4,7,Regulars
32328,140,16,2710.36,4,5,5,14,Champions
32329,171,12,2168.79,3,4,4,11,Big Spenders
32330,622,11,1568.9199999999998,1,3,3,7,Regulars
32331,56,11,2366.0099999999998,5,3,4,12,Loyal
32332,124,10,905.1500000000001,4,3,2,9,Loyal
32333,310,10,1389.84,2,3,3,8,Regulars
32334,163,13,2756.21,3,4,5,12,Big Spenders
32335,78,10,827.36,4,3,1,8,Loyal
32336,265,6,984.39,2,1,2,5,Hibernating
32337,190,8,1138.9,3,2,2,7,Regulars
32338,16,10,1332.63,5,3,3,11,Loyal
32339,5,13,964.39,5,4,2,11,Loyal
32340,109,10,1274.05,4,3,3,10,Loyal
32341,545,6,713.1899999999999,1,1,1,3,Hibernating
32342,451,5,577.0699999999999,2,1,1,4,Hibernating
32343,280,10,865.14,2,3,2,7,Regulars
32344,110,18,1652.19,4,5,3,12,Loyal
32345,338,10,925.08,2,3,2,7,Regulars
32346,700,12,2509.62,1,4,4,9,At Risk
32347,216,10,2606.8599999999997,3,3,5,11,Big Spenders
32348,468,6,754.98,1,1,1,3,Hibernating
32349,571,8,496.25,1,2,1,4,Hibernating
32350,20,8,1229.51,5,2,2,9,Regulars
32351,163,13,1275.0700000000002,3,4,3,10,Regulars
32352,231,7,428.34,3,1,1,5,Regulars
32353,927,14,3960.1499999999996,1,5,5,11,At Risk
32354,17,13,1107.84,5,4,2,11,Loyal
32355,266,13,3230.4,2,4,5,11,At Risk
32356,93,9,3029.44,4,2,5,11,Big Spenders
32357,71,9,1090.58,4,2,2,8,Regulars
32358,456,10,1994.5,2,3,4,9,Regulars
32359,11,12,1253.17,5,4,3,12,Loyal
32360,18,8,1472.8799999999999,5,2,3,10,Regulars
32361,371,11,3979.82,2,3,5,10,Regulars
32362,16,12,1250.69,5,4,3,12,Loyal
32363,116,9,1345.0600000000002,4,2,3,9,Regulars
32364,329,13,2272.32,2,4,4,10,At Risk
32365,330,9,2434.21,2,2,4,8,Regulars
32366,329,7,857.6099999999999,2,1,2,5,Hibernating
32367,14,8,911.37,5,2,2,9,Regulars
32368,325,7,2760.65,2,1,5,8,Regulars
32369,600,6,891.56,1,1,2,4,Hibernating
32370,604,8,640.88,1,2,1,4,Hibernating
32371,4,10,1136.8,5,3,2,10,Loyal
32372,312,14,2423.69,2,5,4,11,At Risk
32373,324,13,3440.8,2,4,5,11,At Risk
32374,74,11,2416.45,4,3,4,11,Loyal
32375,112,16,1419.13,4,5,3,12,Loyal
32376,120,12,2446.64,4,4,4,12,Champions
32377,178,10,1234.91,3,3,2,8,Regulars
32378,501,11,1022.14,1,3,2,6,Regulars
32379,279,7,1078.97,2,1,2,5,Hibernating
32380,666,9,939.1800000000001,1,2,2,5,Hibernating
32381,13,8,454.72,5,2,1,8,Regulars
32382,271,8,1904.52,2,2,4,8,Regulars
32383,227,11,1483.95,3,3,3,9,Regulars
32384,250,10,692.3000000000001,2,3,1,6,Regulars
32385,77,7,1198.33,4,1,2,7,Regulars
32386,588,8,3431.76,1,2,5,8,Regulars
32387,17,11,1894.04,5,3,4,12,Loyal
32388,277,9,1050.1399999999999,2,2,2,6,Hibernating
32389,176,6,386.68,3,1,1,5,Regulars
32390,16,15,3460.4600000000005,5,5,5,15,Champions
32391,259,11,1584.83,2,3,3,8,Regulars
32392,66,13,2345.59,4,4,4,12,Champions
32393,60,19,4149.0199999999995,5,5,5,15,Champions
32394,119,9,1200.47,4,2,2,8,Regulars
32395,162,9,1576.18,3,2,3,8,Regulars
32396,278,9,1615.3700000000001,2,2,3,7,Regulars
32397,207,16,1547.4,3,5,3,11,Regulars
32398,268,8,1707.43,2,2,3,7,Regulars
32399,529,9,2051.02,1,2,4,7,Regulars
32400,264,10,1426.55,2,3,3,8,Regulars
32401,67,14,1414.72,4,5,3,12,Loyal
32402,276,13,2301.63,2,4,4,10,At Risk
32403,107,11,838.1700000000001,4,3,1,8,Loyal
32404,397,8,879.63,2,2,2,6,Hibernating
32405,171,10,1077.18,3,3,2,8,Regulars
32406,557,5,643.88,1,1,1,3,Hibernating
32407,532,12,2334.24,1,4,4,9,At Risk
32408,286,8,746.85,2,2,1,5,Hibernating
32409,819,7,556.62,1,1,1,3,Hibernating
32410,201,6,324.96999999999997,3,1,1,5,Regulars
32411,3,11,1019.77,5,3,2,10,Loyal
32412,149,10,1578.58,3,3,3,9,Regulars
32413,232,6,1426.75,3,1,3,7,Regulars
32414,130,8,1958.7,4,2,4,10,Big Spenders
32415,19,9,2696.27,5,2,5,12,Big Spenders
32416,633,10,1408.04,1,3,3,7,Regulars
32417,101,11,1729.03,4,3,4,11,Loyal
32418,467,14,4525.4800000000005,1,5,5,11,At Risk
32419,151,8,597.0,3,2,1,6,Regulars
32420,156,12,1321.05,3,4,3,10,Regulars
32421,396,8,443.75,2,2,1,5,Hibernating
32422,20,9,710.7,5,2,1,8,Regulars
32423,152,15,3054.27,3,5,5,13,Big Spenders
32424,83,16,1564.04,4,5,3,12,Loyal
32425,154,13,1864.8000000000002,3,4,4,11,Big Spenders
32426,239,12,1978.84,3,4,4,11,Big Spenders
32427,153,8,623.79,3,2,1,6,Regulars
32428,78,10,1122.06,4,3,2,9,Loyal
32429,97,7,1438.2,4,1,3,8,Regulars
32430,94,15,3273.54,4,5,5,14,Champions
32431,139,12,2790.46,4,4,5,13,Champions
32432,244,16,1360.63,3,5,3,11,Regulars
32433,120,7,531.31,4,1,1,6,Regulars
32434,156,14,1549.21,3,5,3,11,Regulars
32435,289,5,550.64,2,1,1,4,Hibernating
32436,152,12,2459.76,3,4,4,11,Big Spenders
32437,589,15,3345.39,1,5,5,11,At Risk
32438,513,7,552.1600000000001,1,1,1,3,Hibernating
32439,942,6,843.55,1,1,1,3,Hibernating
32440,24,13,1557.75,5,4,3,12,Loyal
32441,20,12,1000.03,5,4,2,11,Loyal
32442,359,16,2402.4,2,5,4,11,At Risk
32443,218,9,694.32,3,2,1,6,Regulars
32444,389,11,1643.32,2,3,3,8,Regulars
32445,111,13,1224.97,4,4,2,10,Loyal
32446,311,18,1705.43,2,5,3,10,At Risk
32447,187,6,700.86,3,1,1,5,Regulars
32448,79,12,877.4399999999999,4,4,2,10,Loyal
32449,16,11,1483.05,5,3,3,11,Loyal
32450,518,9,943.3199999999999,1,2,2,5,Hibernating
32451,225,5,760.77,3,1,1,5,Regulars
32452,164,12,2529.93,3,4,4,11,Big Spenders
32453,273,13,2663.79,2,4,5,11,At Risk
32454,165,12,5115.76,3,4,5,12,Big Spenders
32455,234,11,962.5899999999999,3,3,2,8,Regulars
32456,80,10,2439.88,4,3,4,11,Loyal
32457,24,10,1477.9299999999998,5,3,3,11,Loyal
32458,179,12,1228.93,3,4,2,9,Regulars
32459,266,13,1082.47,2,4,2,8,At Risk
32460,41,12,662.27,5,4,1,10,Loyal
32461,328,10,597.77,2,3,1,6,Regulars
32462,329,14,974.09,2,5,2,9,At Risk
32463,69,9,2495.92,4,2,4,10,Big Spenders
32464,202,12,3560.08,3,4,5,12,Big Spenders
32465,246,12,1443.9299999999998,3,4,3,10,Regulars
32466,491,12,1229.06,1,4,2,7,At Risk
32467,497,5,526.2900000000001,1,1,1,3,Hibernating
32468,748,12,3630.2999999999997,1,4,5,10,At Risk
32469,189,12,1164.36,3,4,2,9,Regulars
32470,63,10,535.48,5,3,1,9,Loyal
32471,38,12,1990.05,5,4,4,13,Champions
32472,395,15,3887.3,2,5,5,12,At Risk
32473,947,4,241.19,1,1,1,3,Hibernating
32474,637,8,633.8199999999999,1,2,1,4,Hibernating
32475,874,10,880.87,1,3,2,6,Regulars
32476,155,10,1091.4,3,3,2,8,Regulars
32477,28,18,2652.73,5,5,5,15,Champions
32478,242,11,1869.3899999999999,3,3,4,10,Big Spenders
32479,443,19,3995.63,2,5,5,12,At Risk
32480,1345,4,354.06,1,1,1,3,Hibernating
32481,477,12,1461.93,1,4,3,8,At Risk
32482,264,7,818.0,2,1,1,4,Hibernating
32483,148,8,1108.94,3,2,2,7,Regulars
32484,348,11,747.27,2,3,1,6,Regulars
32485,758,9,647.9200000000001,1,2,1,4,Hibernating
32486,292,7,522.59,2,1,1,4,Hibernating
32487,66,17,5086.07,4,5,5,14,Champions
32488,28,16,2689.48,5,5,5,15,Champions
32489,187,10,798.64,3,3,1,7,Regulars
32490,213,14,3318.85,3,5,5,13,Big Spenders
32491,391,16,4244.79,2,5,5,12,At Risk
32492,442,15,1219.69,2,5,2,9,At Risk
32493,615,12,1051.1200000000001,1,4,2,7,At Risk
32494,229,11,1606.03,3,3,3,9,Regulars
32495,71,15,2814.5,4,5,5,14,Champions
32496,283,12,1681.95,2,4,3,9,At Risk
32497,78,10,1061.52,4,3,2,9,Loyal
32498,82,11,1214.7099999999998,4,3,2,9,Loyal
32499,4,10,991.44,5,3,2,10,Loyal
32500,127,8,3593.59,4,2,5,11,Big Spenders
32501,506,5,765.4100000000001,1,1,1,3,Hibernating
32502,598,9,1538.0,1,2,3,6,Regulars
32503,26,10,719.79,5,3,1,9,Loyal
32504,19,10,879.18,5,3,2,10,Loyal
32505,389,9,904.97,2,2,2,6,Hibernating
32506,263,9,1179.94,2,2,2,6,Hibernating
32507,210,10,2419.46,3,3,4,10,Big Spenders
32508,103,10,541.6700000000001,4,3,1,8,Loyal
32509,259,12,3756.59,2,4,5,11,At Risk
32510,695,11,4881.85,1,3,5,9,Regulars
32511,137,8,1235.97,4,2,2,8,Regulars
32512,0,17,2433.04,5,5,4,14,Champions
32513,21,9,1298.46,5,2,3,10,Regulars
32514,353,14,4932.3099999999995,2,5,5,12,At Risk
32515,524,9,599.73,1,2,1,4,Hibernating
32516,52,16,4834.21,5,5,5,15,Champions
32517,866,3,191.37,1,1,1,3,Hibernating
32518,16,8,1264.5,5,2,3,10,Regulars
32519,107,12,750.79,4,4,1,9,Loyal
32520,1076,5,494.63000000000005,1,1,1,3,Hibernating
32521,125,6,793.9,4,1,1,6,Regulars
32522,1180,16,6070.030000000001,1,5,5,11,At Risk
32523,579,8,2034.4299999999998,1,2,4,7,Regulars
32524,390,14,2236.5,2,5,4,11,At Risk
32525,301,8,520.66,2,2,1,5,Hibernating
32526,139,8,1225.29,4,2,2,8,Regulars
32527,507,12,1343.91,1,4,3,8,At Risk
32528,18,14,1559.28,5,5,3,13,Loyal
32529,119,12,1654.89,4,4,3,11,Loyal
32530,690,6,337.83000000000004,1,1,1,3,Hibernating
32531,118,8,1229.66,4,2,2,8,Regulars
32532,444,16,2744.8599999999997,2,5,5,12,At Risk
32533,498,9,1017.6800000000001,1,2,2,5,Hibernating
32534,273,11,664.89,2,3,1,6,Regulars
32535,258,10,2991.83,2,3,5,10,Regulars
32536,4,8,992.73,5,2,2,9,Regulars
32537,720,6,488.7,1,1,1,3,Hibernating
32538,188,8,402.36,3,2,1,6,Regulars
32539,28,9,5711.410000000001,5,2,5,12,Big Spenders
32540,254,11,2591.7,2,3,5,10,Regulars
32541,20,13,2673.28,5,4,5,14,Champions
32542,64,11,1232.27,5,3,2,10,Loyal
32543,236,10,976.62,3,3,2,8,Regulars
32544,184,8,911.72,3,2,2,7,Regulars
32545,274,4,262.11,2,1,1,4,Hibernating
32546,166,13,3058.0600000000004,3,4,5,12,Big Spenders
32547,254,7,3358.25,2,1,5,8,Regulars
32548,100,7,520.6,4,1,1,6,Regulars
32549,221,11,1551.3400000000001,3,3,3,9,Regulars
32550,307,4,568.89,2,1,1,4,Hibernating
32551,26,13,3828.5000000000005,5,4,5,14,Champions
32552,148,3,1297.67,3,1,3,7,Regulars
32553,200,12,2003.02,3,4,4,11,Big Spenders
32554,141,10,649.55,4,3,1,8,Loyal
32555,64,14,2229.03,5,5,4,14,Champions
32556,167,12,1342.44,3,4,3,10,Regulars
32557,403,8,3158.6,2,2,5,9,Regulars
32558,129,12,1247.56,4,4,3,11,Loyal
32559,311,7,2495.95,2,1,4,7,Regulars
32560,572,8,323.95000000000005,1,2,1,4,Hibernating
32561,161,5,523.58,3,1,1,5,Regulars
32562,283,10,1151.32,2,3,2,7,Regulars
32563,630,14,999.71,1,5,2,8,At Risk
32564,35,9,902.1899999999999,5,2,2,9,Regulars
32565,88,14,2736.25,4,5,5,14,Champions
32566,191,15,3553.1099999999997,3,5,5,13,Big Spenders
32567,375,10,3262.5899999999997,2,3,5,10,Regulars
32568,100,12,2914.0699999999997,4,4,5,13,Champions
32569,468,13,3134.67,1,4,5,10,At Risk
32570,119,12,2646.31,4,4,5,13,Champions
32571,162,6,1159.98,3,1,2,6,Regulars
32572,196,13,2766.81,3,4,5,12,Big Spenders
32573,526,6,943.1500000000001,1,1,2,4,Hibernating
32574,124,11,1930.09,4,3,4,11,Loyal
32575,69,9,1240.43,4,2,2,8,Regulars
32576,389,9,1039.15,2,2,2,6,Hibernating
32577,220,11,2076.02,3,3,4,10,Big Spenders
32578,173,12,1686.54,3,4,3,10,Regulars
32579,538,10,1774.43,1,3,4,8,Regulars
32580,126,10,1030.62,4,3,2,9,Loyal
32581,133,11,3668.52,4,3,5,12,Loyal
32582,29,16,4008.07,5,5,5,15,Champions
32583,148,12,1539.8200000000002,3,4,3,10,Regulars
32584,139,16,3063.98,4,5,5,14,Champions
32585,237,12,3234.63,3,4,5,12,Big Spenders
32586,790,9,952.19,1,2,2,5,Hibernating
32587,367,10,2143.54,2,3,4,9,Regulars
32588,2026,3,177.73,1,1,1,3,Hibernating
32589,140,11,2781.67,4,3,5,12,Loyal
32590,14,12,1529.51,5,4,3,12,Loyal
32591,938,6,801.53,1,1,1,3,Hibernating
32592,284,6,713.78,2,1,1,4,Hibernating
32593,37,11,2533.2000000000003,5,3,4,12,Loyal
32594,342,8,763.59,2,2,1,5,Hibernating
32595,61,15,1672.0900000000001,5,5,3,13,Loyal
32596,1316,9,3218.1799999999994,1,2,5,8,Regulars
32597,215,8,1141.56,3,2,2,7,Regulars
32598,283,11,2571.5,2,3,4,9,Regulars
32599,101,12,1574.1599999999999,4,4,3,11,Loyal
32600,640,7,996.9399999999999,1,1,2,4,Hibernating
32601,364,11,1247.52,2,3,3,8,Regulars
32602,1203,4,1785.2,1,1,4,6,Regulars
32603,287,11,1360.47,2,3,3,8,Regulars
32604,301,8,1923.1800000000003,2,2,4,8,Regulars
32605,236,11,2920.75,3,3,5,11,Big Spenders
32606,278,11,1716.1100000000001,2,3,3,8,Regulars
32607,153,15,6893.16,3,5,5,13,Big Spenders
32608,118,6,876.21,4,1,2,7,Regulars
32609,148,12,2661.4900000000002,3,4,5,12,Big Spenders
32610,472,11,3613.31,1,3,5,9,Regulars
32611,86,5,748.4300000000001,4,1,1,6,Regulars
32612,51,13,1956.3799999999999,5,4,4,13,Champions
32613,200,11,1024.46,3,3,2,8,Regulars
32614,92,14,1802.72,4,5,4,13,Champions
32615,744,10,1138.38,1,3,2,6,Regulars
32616,72,18,4245.63,4,5,5,14,Champions
32617,161,9,2382.9,3,2,4,9,Big Spenders
32618,411,8,407.04,2,2,1,5,Hibernating
32619,114,11,2421.52,4,3,4,11,Loyal
32620,50,9,1056.58,5,2,2,9,Regulars
32621,239,13,2718.8799999999997,3,4,5,12,Big Spenders
32622,583,6,1325.0500000000002,1,1,3,5,Regulars
32623,435,11,634.23,2,3,1,6,Regulars
32624,1594,7,438.33000000000004,1,1,1,3,Hibernating
32625,101,11,2558.42,4,3,4,11,Loyal
32626,27,11,1300.49,5,3,3,11,Loyal
32627,103,13,1116.04,4,4,2,10,Loyal
32628,39,13,5411.67,5,4,5,14,Champions
32629,288,9,1144.64,2,2,2,6,Hibernating
32630,226,10,1826.37,3,3,4,10,Big Spenders
32631,34,10,997.7900000000001,5,3,2,10,Loyal
32632,656,8,1629.99,1,2,3,6,Regulars
32633,199,10,1187.84,3,3,2,8,Regulars
32634,839,14,1788.72,1,5,4,10,At Risk
32635,80,7,2991.04,4,1,5,10,Big Spenders
32636,234,9,1006.1,3,2,2,7,Regulars
32637,821,7,1230.58,1,1,2,4,Hibernating
32638,135,11,3658.16,4,3,5,12,Loyal
32639,52,12,2844.36,5,4,5,14,Champions
32640,169,9,969.82,3,2,2,7,Regulars
32641,40,16,1185.23,5,5,2,12,Loyal
32642,77,11,2593.12,4,3,5,12,Loyal
32643,22,12,5459.419999999999,5,4,5,14,Champions
32644,644,9,1044.56,1,2,2,5,Hibernating
32645,122,10,2424.08,4,3,4,11,Loyal
32646,291,16,3498.75,2,5,5,12,At Risk
32647,314,12,2809.7200000000003,2,4,5,11,At Risk
32648,259,12,2563.88,2,4,4,10,At Risk
32649,1846,2,475.52,1,1,1,3,Hibernating
32650,577,8,671.0999999999999,1,2,1,4,Hibernating
32651,259,9,1345.61,2,2,3,7,Regulars
32652,443,12,880.27,2,4,2,8,At Risk
32653,350,8,1702.75,2,2,3,7,Regulars
32654,96,9,2957.5,4,2,5,11,Big Spenders
32655,343,11,834.9499999999999,2,3,1,6,Regulars
32656,125,13,2866.56,4,4,5,13,Champions
32657,170,11,1039.25,3,3,2,8,Regulars
32658,346,8,1335.43,2,2,3,7,Regulars
32659,61,12,1459.1,5,4,3,12,Loyal
32660,87,13,2133.6,4,4,4,12,Champions
32661,123,11,1385.01,4,3,3,10,Loyal
32662,48,13,1430.73,5,4,3,12,Loyal
32663,307,7,1020.66,2,1,2,5,Hibernating
32664,232,17,3281.36,3,5,5,13,Big Spenders
32665,64,8,923.8499999999999,5,2,2,9,Regulars
32666,571,10,3454.5499999999997,1,3,5,9,Regulars
32667,309,9,1047.29,2,2,2,6,Hibernating
32668,358,6,2656.39,2,1,5,8,Regulars
32669,443,12,3541.69,2,4,5,11,At Risk
32670,10,9,2884.83,5,2,5,12,Big Spenders
32671,218,7,1397.99,3,1,3,7,Regulars
32672,144,17,6657.37,4,5,5,14,Champions
32673,496,11,749.37,1,3,1,5,Regulars
32674,291,6,1751.43,2,1,4,7,Regulars
32675,57,7,810.97,5,1,1,7,Regulars
32676,134,10,1252.2,4,3,3,10,Loyal
32677,403,6,478.99,2,1,1,4,Hibernating
32678,144,15,2115.83,4,5,4,13,Champions
32679,275,7,1678.3600000000001,2,1,3,6,Regulars
32680,160,9,1677.76,3,2,3,8,Regulars
32681,1,18,2976.52,5,5,5,15,Champions
32682,1117,4,243.91000000000003,1,1,1,3,Hibernating
32683,149,15,1244.53,3,5,3,11,Regulars
32684,308,5,1353.3400000000001,2,1,3,6,Regulars
32685,35,12,1963.49,5,4,4,13,Champions
32686,158,8,908.01,3,2,2,7,Regulars
32687,411,9,1988.19,2,2,4,8,Regulars
32688,193,12,1205.4299999999998,3,4,2,9,Regulars
32689,537,7,1370.6799999999998,1,1,3,5,Regulars
32690,49,6,363.14,5,1,1,7,Regulars
32691,60,10,1130.43,5,3,2,10,Loyal
32692,65,13,1238.59,5,4,2,11,Loyal
32693,156,14,2635.88,3,5,5,13,Big Spenders
32694,484,10,1055.58,1,3,2,6,Regulars
32695,560,3,481.41,1,1,1,3,Hibernating
32696,337,8,764.04,2,2,1,5,Hibernating
32697,134,11,1677.1100000000001,4,3,3,10,Loyal
32698,48,12,1834.05,5,4,4,13,Champions
32699,391,7,980.96,2,1,2,5,Hibernating
32700,118,9,1306.65,4,2,3,9,Regulars
32701,13,7,485.42,5,1,1,7,Regulars
32702,102,7,771.25,4,1,1,6,Regulars
32703,575,12,2818.6800000000003,1,4,5,10,At Risk
32704,186,6,247.82,3,1,1,5,Regulars
32705,463,8,1014.93,1,2,2,5,Hibernating
32706,29,11,3228.68,5,3,5,13,Loyal
32707,333,14,3825.29,2,5,5,12,At Risk
32708,502,11,1190.52,1,3,2,6,Regulars
32709,1314,6,766.14,1,1,1,3,Hibernating
32710,158,6,4423.24,3,1,5,9,Big Spenders
32711,53,12,1736.46,5,4,4,13,Champions
32712,478,7,609.88,1,1,1,3,Hibernating
32713,390,13,1436.47,2,4,3,9,At Risk
32714,1,12,3957.3700000000003,5,4,5,14,Champions
32715,920,10,2084.35,1,3,4,8,Regulars
32716,124,8,1000.51,4,2,2,8,Regulars
32717,446,9,1199.23,2,2,2,6,Hibernating
32718,58,6,343.64,5,1,1,7,Regulars
32719,143,7,532.34,4,1,1,6,Regulars
32720,1049,6,1223.34,1,1,2,4,Hibernating
32721,222,11,2740.38,3,3,5,11,Big Spenders
32722,179,9,1053.92,3,2,2,7,Regulars
32723,71,13,3110.73,4,4,5,13,Champions
32724,55,8,1037.24,5,2,2,9,Regulars
32725,202,14,2702.11,3,5,5,13,Big Spenders
32726,59,9,1660.94,5,2,3,10,Regulars
32727,120,15,3483.0499999999997,4,5,5,14,Champions
32728,191,12,750.99,3,4,1,8,Regulars
32729,124,15,2956.0299999999997,4,5,5,14,Champions
32730,333,8,2044.51,2,2,4,8,Regulars
32731,911,7,839.5500000000001,1,1,1,3,Hibernating
32732,442,13,1665.1000000000001,2,4,3,9,At Risk
32733,208,5,2920.58,3,1,5,9,Big Spenders
32734,16,11,1626.72,5,3,3,11,Loyal
32735,1940,2,211.76,1,1,1,3,Hibernating
32736,497,9,1637.41,1,2,3,6,Regulars
32737,329,8,815.21,2,2,1,5,Hibernating
32738,939,10,1658.6,1,3,3,7,Regulars
32739,124,9,1422.58,4,2,3,9,Regulars
32740,121,5,517.73,4,1,1,6,Regulars
32741,98,7,634.16,4,1,1,6,Regulars
32742,43,11,1495.48,5,3,3,11,Loyal
32743,415,11,1268.78,2,3,3,8,Regulars
32744,0,7,939.56,5,1,2,8,Regulars
32745,677,5,535.13,1,1,1,3,Hibernating
32746,105,12,2232.7200000000003,4,4,4,12,Champions
32747,140,11,3840.1600000000003,4,3,5,12,Loyal
32748,107,17,1744.47,4,5,4,13,Champions
32749,175,12,2514.9100000000003,3,4,4,11,Big Spenders
32750,139,12,1931.8400000000001,4,4,4,12,Champions
32751,121,21,4509.23,4,5,5,14,Champions
32752,144,7,737.75,4,1,1,6,Regulars
32753,34,8,901.95,5,2,2,9,Regulars
32754,11,11,796.15,5,3,1,9,Loyal
32755,288,12,1445.06,2,4,3,9,At Risk
32756,516,8,676.36,1,2,1,4,Hibernating
32757,153,13,3618.39,3,4,5,12,Big Spenders
32758,37,11,3099.57,5,3,5,13,Loyal
32759,662,3,337.37,1,1,1,3,Hibernating
32760,269,3,370.28999999999996,2,1,1,4,Hibernating
32761,261,13,1642.01,2,4,3,9,At Risk
32762,144,17,3618.5899999999997,4,5,5,14,Champions
32763,119,18,4994.240000000001,4,5,5,14,Champions
32764,232,9,1245.99,3,2,3,8,Regulars
32765,226,13,1836.29,3,4,4,11,Big Spenders
32766,625,11,1252.2,1,3,3,7,Regulars
32767,49,12,1886.7,5,4,4,13,Champions
32768,304,4,865.4399999999999,2,1,2,5,Hibernating
32769,332,8,2139.2,2,2,4,8,Regulars
32770,9,12,1061.65,5,4,2,11,Loyal
32771,137,12,1866.27,4,4,4,12,Champions
32772,44,10,2240.88,5,3,4,12,Loyal
32773,206,13,2110.37,3,4,4,11,Big Spenders
32774,422,12,2643.8,2,4,5,11,At Risk
32775,174,11,779.74,3,3,1,7,Regulars
32776,198,8,817.23,3,2,1,6,Regulars
32777,201,11,2832.12,3,3,5,11,Big Spenders
32778,192,11,3269.18,3,3,5,11,Big Spenders
32779,273,9,1688.1,2,2,3,7,Regulars
32780,483,10,576.84,1,3,1,5,Regulars
32781,7,9,2097.83,5,2,4,11,Big Spenders
32782,112,13,1905.9599999999998,4,4,4,12,Champions
32783,48,9,2602.01,5,2,5,12,Big Spenders
32784,69,9,1726.69,4,2,4,10,Big Spenders
32785,14,8,698.56,5,2,1,8,Regulars
32786,14,11,723.86,5,3,1,9,Loyal
32787,521,9,1633.07,1,2,3,6,Regulars
32788,237,14,1714.87,3,5,3,11,Regulars
32789,168,14,1619.96,3,5,3,11,Regulars
32790,175,13,2160.9,3,4,4,11,Big Spenders
32791,101,14,1682.98,4,5,3,12,Loyal
32792,108,16,1996.22,4,5,4,13,Champions
32793,325,15,1401.5900000000001,2,5,3,10,At Risk
32794,683,12,1653.22,1,4,3,8,At Risk
32795,414,14,1088.13,2,5,2,9,At Risk
32796,0,13,1410.2,5,4,3,12,Loyal
32797,83,10,2587.4700000000003,4,3,5,12,Loyal
32798,815,7,1583.63,1,1,3,5,Regulars
32799,1342,5,1654.8600000000001,1,1,3,5,Regulars
32800,558,8,2758.6899999999996,1,2,5,8,Regulars
32801,109,6,1097.24,4,1,2,7,Regulars
32802,628,10,770.75,1,3,1,5,Regulars
32803,212,10,1071.5,3,3,2,8,Regulars
32804,87,10,978.7099999999999,4,3,2,9,Loyal
32805,135,13,4333.32,4,4,5,13,Champions
32806,156,10,1597.3700000000001,3,3,3,9,Regulars
32807,512,11,951.29,1,3,2,6,Regulars
32808,99,18,1874.82,4,5,4,13,Champions
32809,717,8,650.84,1,2,1,4,Hibernating
32810,189,13,1291.98,3,4,3,10,Regulars
32811,305,6,2172.25,2,1,4,7,Regulars
32812,307,13,1243.98,2,4,3,9,At Risk
32813,193,9,791.21,3,2,1,6,Regulars
32814,143,11,3383.2799999999997,4,3,5,12,Loyal
32815,99,8,2384.43,4,2,4,10,Big Spenders
32816,448,15,4576.7,2,5,5,12,At Risk
32817,46,9,561.89,5,2,1,8,Regulars
32818,100,8,1058.87,4,2,2,8,Regulars
32819,20,14,1477.69,5,5,3,13,Loyal
32820,20,14,2183.2799999999997,5,5,4,14,Champions
32821,319,10,1465.35,2,3,3,8,Regulars
32822,156,11,2232.33,3,3,4,10,Big Spenders
32823,301,8,631.1,2,2,1,5,Hibernating
32824,145,13,1108.12,4,4,2,10,Loyal
32825,167,8,1496.96,3,2,3,8,Regulars
32826,426,8,950.72,2,2,2,6,Hibernating
32827,42,9,1170.67,5,2,2,9,Regulars
32828,122,10,1547.26,4,3,3,10,Loyal
32829,2,6,514.39,5,1,1,7,Regulars
32830,180,10,1115.5,3,3,2,8,Regulars
32831,74,17,2549.3100000000004,4,5,4,13,Champions
32832,27,12,1284.54,5,4,3,12,Loyal
32833,255,12,1341.9,2,4,3,9,At Risk
32834,447,12,2394.52,2,4,4,10,At Risk
32835,111,11,1314.09,4,3,3,10,Loyal
32836,3,9,2298.64,5,2,4,11,Big Spenders
32837,1295,3,392.5,1,1,1,3,Hibernating
32838,165,14,3852.0,3,5,5,13,Big Spenders
32839,237,12,1425.91,3,4,3,10,Regulars
32840,126,14,5134.43,4,5,5,14,Champions
32841,188,6,674.12,3,1,1,5,Regulars
32842,3,11,2495.26,5,3,4,12,Loyal
32843,584,6,831.9599999999999,1,1,1,3,Hibernating
32844,176,16,3242.19,3,5,5,13,Big Spenders
32845,99,14,3851.05,4,5,5,14,Champions
32846,300,11,1021.0200000000001,2,3,2,7,Regulars
32847,124,7,321.35,4,1,1,6,Regulars
32848,11,12,1536.5000000000002,5,4,3,12,Loyal
32849,175,16,1276.19,3,5,3,11,Regulars
32850,180,16,1725.36,3,5,4,12,Big Spenders
32851,0,18,4092.57,5,5,5,15,Champions
32852,136,13,1258.36,4,4,3,11,Loyal
32853,301,5,2225.3,2,1,4,7,Regulars
32854,484,11,1235.33,1,3,2,6,Regulars
32855,113,13,2231.65,4,4,4,12,Champions
32856,37,18,3996.72,5,5,5,15,Champions
32857,1408,5,555.47,1,1,1,3,Hibernating
32858,243,9,947.3,3,2,2,7,Regulars
32859,834,8,1248.2099999999998,1,2,3,6,Regulars
32860,575,11,2099.2200000000003,1,3,4,8,Regulars
32861,562,5,289.39,1,1,1,3,Hibernating
32862,36,12,2474.36,5,4,4,13,Champions
32863,35,18,2864.94,5,5,5,15,Champions
32864,92,12,1210.16,4,4,2,10,Loyal
32865,5,13,1460.15,5,4,3,12,Loyal
32866,1060,12,4177.08,1,4,5,10,At Risk
32867,162,15,2199.07,3,5,4,12,Big Spenders
32868,162,11,2964.32,3,3,5,11,Big Spenders
32869,113,10,827.7,4,3,1,8,Loyal
32870,234,5,442.65,3,1,1,5,Regulars
32871,646,10,1991.29,1,3,4,8,Regulars
32872,714,6,448.92,1,1,1,3,Hibernating
32873,6,8,2220.0,5,2,4,11,Big Spenders
32874,3,10,1117.51,5,3,2,10,Loyal
32875,176,11,665.9399999999999,3,3,1,7,Regulars
32876,324,11,3841.32,2,3,5,10,Regulars
32877,0,10,1992.31,5,3,4,12,Loyal
32878,196,13,2629.7599999999998,3,4,5,12,Big Spenders
32879,314,5,303.58,2,1,1,4,Hibernating
32880,206,10,2522.51,3,3,4,10,Big Spenders
32881,127,16,1105.67,4,5,2,11,Loyal
32882,249,17,6238.650000000001,2,5,5,12,At Risk
32883,65,10,844.77,5,3,1,9,Loyal
32884,941,4,383.46000000000004,1,1,1,3,Hibernating
32885,201,5,357.81,3,1,1,5,Regulars
32886,67,20,3624.3599999999997,4,5,5,14,Champions
32887,46,13,3277.21,5,4,5,14,Champions
32888,139,12,1280.31,4,4,3,11,Loyal
32889,75,13,4005.2499999999995,4,4,5,13,Champions
32890,396,14,1890.03,2,5,4,11,At Risk
32891,378,15,1743.1000000000001,2,5,4,11,At Risk
32892,903,7,652.27,1,1,1,3,Hibernating
32893,292,10,2035.59,2,3,4,9,Regulars
32894,389,5,643.53,2,1,1,4,Hibernating
32895,213,11,1489.3400000000001,3,3,3,9,Regulars
32896,209,13,3348.6800000000003,3,4,5,12,Big Spenders
32897,184,14,2329.47,3,5,4,12,Big Spenders
32898,459,9,1979.16,2,2,4,8,Regulars
32899,292,13,833.69,2,4,1,7,At Risk
32900,312,12,1134.13,2,4,2,8,At Risk
32901,60,8,889.43,5,2,2,9,Regulars
32902,108,10,1365.28,4,3,3,10,Loyal
32903,186,8,1377.55,3,2,3,8,Regulars
32904,71,20,3065.23,4,5,5,14,Champions
32905,166,9,1014.6600000000001,3,2,2,7,Regulars
32906,3,16,2299.97,5,5,4,14,Champions
32907,33,12,2015.33,5,4,4,13,Champions
32908,617,8,1682.4,1,2,3,6,Regulars
32909,4,13,4498.4,5,4,5,14,Champions
32910,669,7,840.01,1,1,1,3,Hibernating
32911,195,12,1834.93,3,4,4,11,Big Spenders
32912,386,13,2430.67,2,4,4,10,At Risk
32913,757,5,541.74,1,1,1,3,Hibernating
32914,103,13,1269.42,4,4,3,11,Loyal
32915,756,8,1139.87,1,2,2,5,Hibernating
32916,391,13,2382.9,2,4,4,10,At Risk
32917,154,15,1366.94,3,5,3,11,Regulars
32918,275,12,806.88,2,4,1,7,At Risk
32919,319,22,2770.82,2,5,5,12,At Risk
32920,608,5,496.83,1,1,1,3,Hibernating
32921,55,10,2990.4300000000003,5,3,5,13,Loyal
32922,29,8,673.14,5,2,1,8,Regulars
32923,159,17,2733.8100000000004,3,5,5,13,Big Spenders
32924,75,10,2055.23,4,3,4,11,Loyal
32925,488,9,552.88,1,2,1,4,Hibernating
32926,437,10,4405.82,2,3,5,10,Regulars
32927,546,12,1471.38,1,4,3,8,At Risk
32928,165,10,746.52,3,3,1,7,Regulars
32929,174,7,939.5400000000001,3,1,2,6,Regulars
32930,90,5,242.22,4,1,1,6,Regulars
32931,120,6,1191.64,4,1,2,7,Regulars
32932,494,9,655.37,1,2,1,4,Hibernating
32933,638,7,474.14,1,1,1,3,Hibernating
32934,97,7,3245.04,4,1,5,10,Big Spenders
32935,646,8,1215.61,1,2,2,5,Hibernating
32936,192,14,1790.89,3,5,4,12,Big Spenders
32937,25,14,1954.57,5,5,4,14,Champions
32938,49,13,3336.57,5,4,5,14,Champions
32939,366,7,3167.85,2,1,5,8,Regulars
32940,174,11,2175.63,3,3,4,10,Big Spenders
32941,54,9,861.39,5,2,2,9,Regulars
32942,774,11,4389.18,1,3,5,9,Regulars
32943,55,9,2402.2599999999998,5,2,4,11,Big Spenders
32944,165,6,2208.41,3,1,4,8,Big Spenders
32945,74,6,764.04,4,1,1,6,Regulars
32946,526,11,1277.95,1,3,3,7,Regulars
32947,3,10,974.74,5,3,2,10,Loyal
32948,50,8,1003.34,5,2,2,9,Regulars
32949,247,9,1107.6599999999999,3,2,2,7,Regulars
32950,65,6,1157.36,5,1,2,8,Regulars
32951,330,5,1113.27,2,1,2,5,Hibernating
32952,75,15,2004.8700000000001,4,5,4,13,Champions
32953,47,3,188.38,5,1,1,7,Regulars
32954,165,8,1938.53,3,2,4,9,Big Spenders
32955,482,9,1655.0000000000002,1,2,3,6,Regulars
32956,172,6,699.2,3,1,1,5,Regulars
32957,452,8,2961.3599999999997,2,2,5,9,Regulars
32958,487,7,709.52,1,1,1,3,Hibernating
32959,676,6,532.13,1,1,1,3,Hibernating
32960,897,8,1363.6299999999999,1,2,3,6,Regulars
32961,54,11,836.54,5,3,1,9,Loyal
32962,26,10,1627.25,5,3,3,11,Loyal
32963,139,14,3085.99,4,5,5,14,Champions
32964,101,14,3785.82,4,5,5,14,Champions
32965,119,5,1137.03,4,1,2,7,Regulars
32966,273,12,1789.43,2,4,4,10,At Risk
32967,99,18,8075.599999999999,4,5,5,14,Champions
32968,4,10,1038.1799999999998,5,3,2,10,Loyal
32969,791,9,1188.1499999999999,1,2,2,5,Hibernating
32970,435,16,1857.28,2,5,4,11,At Risk
32971,40,17,2378.59,5,5,4,14,Champions
32972,244,8,3261.45,3,2,5,10,Big Spenders
32973,669,4,678.83,1,1,1,3,Hibernating
32974,157,14,2798.8900000000003,3,5,5,13,Big Spenders
32975,181,11,1383.1399999999999,3,3,3,9,Regulars
32976,17,8,1872.01,5,2,4,11,Big Spenders
32977,391,7,623.5799999999999,2,1,1,4,Hibernating
32978,130,17,2039.17,4,5,4,13,Champions
32979,464,7,983.36,1,1,2,4,Hibernating
32980,6,9,876.16,5,2,2,9,Regulars
32981,194,14,2504.86,3,5,4,12,Big Spenders
32982,385,4,483.37,2,1,1,4,Hibernating
32983,361,5,574.74,2,1,1,4,Hibernating
32984,237,7,1769.5,3,1,4,8,Big Spenders
32985,877,10,872.11,1,3,2,6,Regulars
32986,253,9,1174.9299999999998,2,2,2,6,Hibernating
32987,131,6,2382.69,4,1,4,9,Big Spenders
32988,78,11,2265.19,4,3,4,11,Loyal
32989,156,9,1340.1,3,2,3,8,Regulars
32990,202,11,662.53,3,3,1,7,Regulars
32991,75,10,3029.4900000000002,4,3,5,12,Loyal
32992,1615,6,443.43000000000006,1,1,1,3,Hibernating
32993,271,13,2227.19,2,4,4,10,At Risk
32994,304,11,2345.65,2,3,4,9,Regulars
32995,441,11,846.87,2,3,2,7,Regulars
32996,1501,2,278.3,1,1,1,3,Hibernating
32997,522,13,3707.93,1,4,5,10,At Risk
32998,254,21,2270.57,2,5,4,11,At Risk
32999,14,13,1478.35,5,4,3,12,Loyal
33000,453,6,1184.99,2,1,2,5,Hibernating
33001,267,7,1078.59,2,1,2,5,Hibernating
33002,34,16,3864.5899999999997,5,5,5,15,Champions
33003,678,8,1743.76,1,2,4,7,Regulars
33004,9,14,2419.42,5,5,4,14,Champions
33005,278,12,1234.8300000000002,2,4,2,8,At Risk
33006,209,14,1465.77,3,5,3,11,Regulars
33007,459,14,5273.04,2,5,5,12,At Risk
33008,305,10,1068.71,2,3,2,7,Regulars
33009,268,7,2356.51,2,1,4,7,Regulars
33010,118,7,1240.51,4,1,2,7,Regulars
33011,17,8,1643.56,5,2,3,10,Regulars
33012,144,8,1082.57,4,2,2,8,Regulars
33013,505,14,1340.04,1,5,3,9,At Risk
33014,948,9,1745.05,1,2,4,7,Regulars
33015,16,12,2329.1099999999997,5,4,4,13,Champions
33016,233,10,1074.8799999999999,3,3,2,8,Regulars
33017,1260,6,372.53999999999996,1,1,1,3,Hibernating
33018,579,8,1987.73,1,2,4,7,Regulars
33019,239,10,2083.47,3,3,4,10,Big Spenders
33020,554,12,2124.24,1,4,4,9,At Risk
33021,315,9,2193.8799999999997,2,2,4,8,Regulars
33022,12,10,2552.64,5,3,4,12,Loyal
33023,29,7,1616.48,5,1,3,9,Regulars
33024,832,4,766.92,1,1,1,3,Hibernating
33025,156,9,2849.79,3,2,5,10,Big Spenders
33026,132,11,2779.86,4,3,5,12,Loyal
33027,152,16,4812.82,3,5,5,13,Big Spenders
33028,33,9,2843.1900000000005,5,2,5,12,Big Spenders
33029,96,18,2740.27,4,5,5,14,Champions
33030,224,14,1538.2,3,5,3,11,Regulars
33031,457,13,1597.98,2,4,3,9,At Risk
33032,235,7,1373.8899999999999,3,1,3,7,Regulars
33033,215,10,1797.1799999999998,3,3,4,10,Big Spenders
33034,129,11,3451.9599999999996,4,3,5,12,Loyal
33035,167,8,655.0500000000001,3,2,1,6,Regulars
33036,550,10,1330.23,1,3,3,7,Regulars
33037,49,6,2503.8299999999995,5,1,4,10,Big Spenders
33038,385,11,1145.3600000000001,2,3,2,7,Regulars
33039,23,6,2968.39,5,1,5,11,Big Spenders
33040,309,12,7314.19,2,4,5,11,At Risk
33041,144,9,1291.8600000000001,4,2,3,9,Regulars
33042,536,7,1510.15,1,1,3,5,Regulars
33043,124,13,2167.99,4,4,4,12,Champions
33044,120,11,4121.63,4,3,5,12,Loyal
33045,64,7,677.19,5,1,1,7,Regulars
33046,101,8,1287.57,4,2,3,9,Regulars
33047,254,8,880.0299999999999,2,2,2,6,Hibernating
33048,115,13,1528.4,4,4,3,11,Loyal
33049,166,6,1867.41,3,1,4,8,Big Spenders
33050,125,12,1208.1,4,4,2,10,Loyal
33051,323,13,3298.8,2,4,5,11,At Risk
33052,6,10,2040.29,5,3,4,12,Loyal
33053,761,5,2870.21,1,1,5,7,Regulars
33054,0,9,422.38,5,2,1,8,Regulars
33055,180,11,693.1999999999999,3,3,1,7,Regulars
33056,797,11,1413.92,1,3,3,7,Regulars
33057,156,10,891.57,3,3,2,8,Regulars
33058,74,17,4193.89,4,5,5,14,Champions
33059,8,16,2152.32,5,5,4,14,Champions
33060,99,7,1687.59,4,1,3,8,Regulars
33061,298,12,3257.93,2,4,5,11,At Risk
33062,634,14,1677.19,1,5,3,9,At Risk
33063,231,5,174.85000000000002,3,1,1,5,Regulars
33064,45,12,2193.26,5,4,4,13,Champions
33065,309,14,2239.2,2,5,4,11,At Risk
33066,144,8,1995.3,4,2,4,10,Big Spenders
33067,137,12,3108.4900000000002,4,4,5,13,Champions
33068,265,10,4314.219999999999,2,3,5,10,Regulars
33069,211,8,894.69,3,2,2,7,Regulars
33070,356,13,891.9,2,4,2,8,At Risk
33071,3,14,1809.39,5,5,4,14,Champions
33072,835,5,812.03,1,1,1,3,Hibernating
33073,75,9,3769.06,4,2,5,11,Big Spenders
33074,91,14,6113.31,4,5,5,14,Champions
33075,465,5,360.74,1,1,1,3,Hibernating
33076,651,9,1372.19,1,2,3,6,Regulars
33077,29,10,1001.55,5,3,2,10,Loyal
33078,157,14,5315.35,3,5,5,13,Big Spenders
33079,110,8,908.8100000000001,4,2,2,8,Regulars
33080,140,9,2432.75,4,2,4,10,Big Spenders
33081,629,9,485.55,1,2,1,4,Hibernating
33082,160,13,2060.53,3,4,4,11,Big Spenders
33083,816,6,413.45,1,1,1,3,Hibernating
33084,752,7,599.74,1,1,1,3,Hibernating
33085,28,7,904.16,5,1,2,8,Regulars
33086,697,7,514.6800000000001,1,1,1,3,Hibernating
33087,49,11,1011.75,5,3,2,10,Loyal
33088,94,9,914.8199999999999,4,2,2,8,Regulars
33089,766,5,365.99,1,1,1,3,Hibernating
33090,242,8,628.2,3,2,1,6,Regulars
33091,211,12,1541.8600000000001,3,4,3,10,Regulars
33092,258,9,981.25,2,2,2,6,Hibernating
33093,15,14,4274.5199999999995,5,5,5,15,Champions
33094,117,7,830.62,4,1,1,6,Regulars
33095,8,10,891.2,5,3,2,10,Loyal
33096,485,15,2392.07,1,5,4,10,At Risk
33097,434,12,2768.01,2,4,5,11,At Risk
33098,248,14,1903.1100000000001,2,5,4,11,At Risk
33099,330,6,735.63,2,1,1,4,Hibernating
33100,7,8,1602.24,5,2,3,10,Regulars
33101,21,10,753.15,5,3,1,9,Loyal
33102,316,20,2133.73,2,5,4,11,At Risk
33103,189,13,2144.84,3,4,4,11,Big Spenders
33104,748,4,353.76,1,1,1,3,Hibernating
33105,693,7,2052.54,1,1,4,6,Regulars
33106,228,6,1451.56,3,1,3,7,Regulars
33107,45,12,826.79,5,4,1,10,Loyal
33108,323,5,499.28,2,1,1,4,Hibernating
33109,727,8,3076.6,1,2,5,8,Regulars
33110,516,12,6921.349999999999,1,4,5,10,At Risk
33111,270,18,2485.26,2,5,4,11,At Risk
33112,17,11,1388.8400000000001,5,3,3,11,Loyal
33113,85,13,882.86,4,4,2,10,Loyal
33114,284,15,4175.2300000000005,2,5,5,12,At Risk
33115,590,7,511.41999999999996,1,1,1,3,Hibernating
33116,69,9,595.36,4,2,1,7,Regulars
33117,60,13,4905.49,5,4,5,14,Champions
33118,492,8,2730.83,1,2,5,8,Regulars
33119,546,13,1623.76,1,4,3,8,At Risk
33120,536,7,1267.27,1,1,3,5,Regulars
33121,23,8,626.83,5,2,1,8,Regulars
33122,223,13,1719.11,3,4,3,10,Regulars
33123,6,9,3539.0499999999997,5,2,5,12,Big Spenders
33124,124,7,958.66,4,1,2,7,Regulars
33125,747,8,2243.63,1,2,4,7,Regulars
33126,513,12,3117.72,1,4,5,10,At Risk
33127,247,11,2345.86,3,3,4,10,Big Spenders
33128,949,7,867.3199999999999,1,1,2,4,Hibernating
33129,255,12,5983.08,2,4,5,11,At Risk
33130,69,11,999.62,4,3,2,9,Loyal
33131,174,9,1570.5700000000002,3,2,3,8,Regulars
33132,61,13,1545.79,5,4,3,12,Loyal
33133,17,13,3081.32,5,4,5,14,Champions
33134,661,10,1591.97,1,3,3,7,Regulars
33135,790,10,797.45,1,3,1,5,Regulars
33136,388,11,1334.73,2,3,3,8,Regulars
33137,629,8,1079.7,1,2,2,5,Hibernating
33138,101,12,1097.08,4,4,2,10,Loyal
33139,161,9,1869.1499999999999,3,2,4,9,Big Spenders
33140,27,19,4212.55,5,5,5,15,Champions
33141,395,9,1041.1,2,2,2,6,Hibernating
33142,250,11,1836.6599999999999,2,3,4,9,Regulars
33143,430,7,2465.08,2,1,4,7,Regulars
33144,316,10,829.13,2,3,1,6,Regulars
33145,1061,8,449.96,1,2,1,4,Hibernating
33146,30,9,861.22,5,2,2,9,Regulars
33147,454,9,887.3299999999999,2,2,2,6,Hibernating
33148,290,10,1510.9,2,3,3,8,Regulars
33149,713,6,1109.1100000000001,1,1,2,4,Hibernating
33150,576,5,1277.74,1,1,3,5,Regulars
33151,744,8,913.65,1,2,2,5,Hibernating
33152,527,11,2222.64,1,3,4,8,Regulars
33153,285,14,3379.6099999999997,2,5,5,12,At Risk
33154,182,13,2769.44,3,4,5,12,Big Spenders
33155,124,9,975.3799999999999,4,2,2,8,Regulars
33156,249,16,2832.15,2,5,5,12,At Risk
33157,139,13,1439.8200000000002,4,4,3,11,Loyal
33158,73,8,2545.67,4,2,4,10,Big Spenders
33159,235,11,2752.2999999999997,3,3,5,11,Big Spenders
33160,755,7,1668.48,1,1,3,5,Regulars
33161,220,8,1025.9299999999998,3,2,2,7,Regulars
33162,265,9,1596.46,2,2,3,7,Regulars
33163,274,13,3134.89,2,4,5,11,At Risk
33164,1067,10,2691.67,1,3,5,9,Regulars
33165,1139,3,192.14,1,1,1,3,Hibernating
33166,253,7,571.4,2,1,1,4,Hibernating
33167,21,11,1435.93,5,3,3,11,Loyal
33168,102,10,876.72,4,3,2,9,Loyal
33169,64,11,992.6500000000001,5,3,2,10,Loyal
33170,20,17,4062.36,5,5,5,15,Champions
33171,928,11,2491.15,1,3,4,8,Regulars
33172,433,9,452.07,2,2,1,5,Hibernating
33173,48,8,1049.41,5,2,2,9,Regulars
33174,369,12,1618.29,2,4,3,9,At Risk
33175,391,10,1569.6200000000001,2,3,3,8,Regulars
33176,54,5,507.51,5,1,1,7,Regulars
33177,357,17,6683.32,2,5,5,12,At Risk
33178,1097,4,654.95,1,1,1,3,Hibernating
33179,68,8,1273.63,4,2,3,9,Regulars
33180,306,14,3881.0899999999997,2,5,5,12,At Risk
33181,64,12,886.3,5,4,2,11,Loyal
33182,480,11,3786.0899999999997,1,3,5,9,Regulars
33183,582,8,762.86,1,2,1,4,Hibernating
33184,249,9,1213.29,2,2,2,6,Hibernating
33185,173,8,1333.4099999999999,3,2,3,8,Regulars
33186,79,9,1031.1,4,2,2,8,Regulars
33187,100,11,1123.17,4,3,2,9,Loyal
33188,135,7,1333.22,4,1,3,8,Regulars
33189,46,7,1103.6399999999999,5,1,2,8,Regulars
33190,451,10,3362.32,2,3,5,10,Regulars
33191,383,15,2139.04,2,5,4,11,At Risk
33192,42,14,3575.21,5,5,5,15,Champions
33193,822,8,821.83,1,2,1,4,Hibernating
33194,31,10,1854.05,5,3,4,12,Loyal
33195,172,8,765.4300000000001,3,2,1,6,Regulars
33196,279,11,616.58,2,3,1,6,Regulars
33197,381,4,357.86,2,1,1,4,Hibernating
33198,77,15,4130.11,4,5,5,14,Champions
33199,1602,7,886.8,1,1,2,4,Hibernating
33200,351,10,1103.61,2,3,2,7,Regulars
33201,169,9,860.9200000000001,3,2,2,7,Regulars
33202,195,12,2033.66,3,4,4,11,Big Spenders
33203,167,17,3029.61,3,5,5,13,Big Spenders
33204,45,11,1067.68,5,3,2,10,Loyal
33205,213,7,985.76,3,1,2,6,Regulars
33206,248,7,2177.2799999999997,2,1,4,7,Regulars
33207,374,9,1373.18,2,2,3,7,Regulars
33208,46,16,2142.52,5,5,4,14,Champions
33209,560,11,1913.1499999999999,1,3,4,8,Regulars
33210,174,12,4396.73,3,4,5,12,Big Spenders
33211,29,9,959.21,5,2,2,9,Regulars
33212,5,12,1647.3500000000001,5,4,3,12,Loyal
33213,165,12,3910.42,3,4,5,12,Big Spenders
33214,338,14,2162.96,2,5,4,11,At Risk
33215,517,10,1109.63,1,3,2,6,Regulars
33216,287,8,1694.08,2,2,3,7,Regulars
33217,949,5,575.23,1,1,1,3,Hibernating
33218,47,10,1822.97,5,3,4,12,Loyal
33219,328,12,1767.75,2,4,4,10,At Risk
33220,65,10,1485.5300000000002,5,3,3,11,Loyal
33221,145,16,2597.44,4,5,5,14,Champions
33222,755,7,852.76,1,1,2,4,Hibernating
33223,203,12,1263.77,3,4,3,10,Regulars
33224,433,10,974.24,2,3,2,7,Regulars
33225,383,6,916.3399999999999,2,1,2,5,Hibernating
33226,204,12,1474.05,3,4,3,10,Regulars
33227,283,7,1321.78,2,1,3,6,Regulars
33228,71,7,716.6800000000001,4,1,1,6,Regulars
33229,391,13,5128.43,2,4,5,11,At Risk
33230,79,11,1048.46,4,3,2,9,Loyal
33231,55,10,1356.45,5,3,3,11,Loyal
33232,111,12,1075.46,4,4,2,10,Loyal
33233,247,9,2452.06,3,2,4,9,Big Spenders
33234,219,15,2178.79,3,5,4,12,Big Spenders
33235,99,11,1645.25,4,3,3,10,Loyal
33236,233,14,3685.11,3,5,5,13,Big Spenders
33237,23,14,2713.71,5,5,5,15,Champions
33238,826,9,982.6600000000001,1,2,2,5,Hibernating
33239,464,14,1945.3500000000001,1,5,4,10,At Risk
33240,38,15,1171.07,5,5,2,12,Loyal
33241,170,10,3969.28,3,3,5,11,Big Spenders
33242,16,7,1161.51,5,1,2,8,Regulars
33243,147,12,1509.49,4,4,3,11,Loyal
33244,34,10,653.86,5,3,1,9,Loyal
33245,305,9,1038.8799999999999,2,2,2,6,Hibernating
33246,249,6,1307.06,2,1,3,6,Regulars
33247,225,7,1750.5700000000002,3,1,4,8,Big Spenders
33248,61,8,910.04,5,2,2,9,Regulars
33249,155,11,3777.9,3,3,5,11,Big Spenders
33250,177,12,2199.26,3,4,4,11,Big Spenders
33251,141,11,1268.82,4,3,3,10,Loyal
33252,90,18,2733.18,4,5,5,14,Champions
33253,187,7,653.14,3,1,1,5,Regulars
33254,267,12,1151.99,2,4,2,8,At Risk
33255,54,9,2214.85,5,2,4,11,Big Spenders
33256,99,9,1143.52,4,2,2,8,Regulars
33257,619,10,1378.65,1,3,3,7,Regulars
33258,184,12,1920.8700000000001,3,4,4,11,Big Spenders
33259,268,12,2194.14,2,4,4,10,At Risk
33260,19,7,508.23,5,1,1,7,Regulars
33261,124,14,4515.5,4,5,5,14,Champions
33262,431,8,683.74,2,2,1,5,Hibernating
33263,2,11,1106.91,5,3,2,10,Loyal
33264,119,23,5128.17,4,5,5,14,Champions
33265,170,13,3271.86,3,4,5,12,Big Spenders
33266,485,8,793.42,1,2,1,4,Hibernating
33267,72,18,3814.5099999999998,4,5,5,14,Champions
33268,918,6,596.1700000000001,1,1,1,3,Hibernating
33269,195,7,1021.0200000000001,3,1,2,6,Regulars
33270,976,12,3700.68,1,4,5,10,At Risk
33271,425,8,596.69,2,2,1,5,Hibernating
33272,1095,4,313.64,1,1,1,3,Hibernating
33273,510,6,875.5,1,1,2,4,Hibernating
33274,336,20,3274.91,2,5,5,12,At Risk
33275,215,14,3901.96,3,5,5,13,Big Spenders
33276,267,8,1511.24,2,2,3,7,Regulars
33277,262,13,1453.05,2,4,3,9,At Risk
33278,461,13,2030.1399999999999,1,4,4,9,At Risk
33279,2,11,1339.75,5,3,3,11,Loyal
33280,52,9,1594.41,5,2,3,10,Regulars
33281,14,12,1644.6599999999999,5,4,3,12,Loyal
33282,117,9,2610.04,4,2,5,11,Big Spenders
33283,60,11,2462.5600000000004,5,3,4,12,Loyal
33284,76,10,3223.56,4,3,5,12,Loyal
33285,579,7,1325.08,1,1,3,5,Regulars
33286,41,14,1390.08,5,5,3,13,Loyal
33287,118,14,1309.25,4,5,3,12,Loyal
33288,193,9,694.49,3,2,1,6,Regulars
33289,57,11,1144.8,5,3,2,10,Loyal
33290,620,5,1260.37,1,1,3,5,Regulars
33291,33,13,1705.3799999999999,5,4,3,12,Loyal
33292,154,15,8104.2699999999995,3,5,5,13,Big Spenders
33293,803,9,1789.76,1,2,4,7,Regulars
33294,46,15,1653.35,5,5,3,13,Loyal
33295,153,11,3097.65,3,3,5,11,Big Spenders
33296,8,11,1310.9,5,3,3,11,Loyal
33297,118,11,1092.99,4,3,2,9,Loyal
33298,425,12,2170.15,2,4,4,10,At Risk
33299,31,12,4046.9999999999995,5,4,5,14,Champions
33300,248,13,2214.35,2,4,4,10,At Risk
33301,326,9,1211.76,2,2,2,6,Hibernating
33302,160,10,1005.38,3,3,2,8,Regulars
33303,255,10,1144.8,2,3,2,7,Regulars
33304,253,10,599.7,2,3,1,6,Regulars
33305,90,14,1667.67,4,5,3,12,Loyal
33306,655,5,957.59,1,1,2,4,Hibernating
33307,22,18,2472.93,5,5,4,14,Champions
33308,22,9,855.3499999999999,5,2,2,9,Regulars
33309,181,10,507.59999999999997,3,3,1,7,Regulars
33310,65,12,1974.01,5,4,4,13,Champions
33311,48,7,719.87,5,1,1,7,Regulars
33312,53,8,1169.16,5,2,2,9,Regulars
33313,17,5,219.43,5,1,1,7,Regulars
33314,234,12,1920.1999999999998,3,4,4,11,Big Spenders
33315,319,13,1571.02,2,4,3,9,At Risk
33316,101,9,682.09,4,2,1,7,Regulars
33317,531,6,1044.54,1,1,2,4,Hibernating
33318,522,13,4621.8,1,4,5,10,At Risk
33319,427,8,1066.69,2,2,2,6,Hibernating
33320,264,12,1325.59,2,4,3,9,At Risk
33321,108,17,3032.2200000000003,4,5,5,14,Champions
33322,451,11,1174.76,2,3,2,7,Regulars
33323,490,11,1078.05,1,3,2,6,Regulars
33324,48,16,1511.66,5,5,3,13,Loyal
33325,212,7,1127.6499999999999,3,1,2,6,Regulars
33326,318,10,1281.49,2,3,3,8,Regulars
33327,45,14,3526.46,5,5,5,15,Champions
33328,124,12,908.74,4,4,2,10,Loyal
33329,8,7,1301.82,5,1,3,9,Regulars
33330,324,10,2706.99,2,3,5,10,Regulars
33331,290,13,1572.99,2,4,3,9,At Risk
33332,38,10,1167.49,5,3,2,10,Loyal
33333,116,14,1630.59,4,5,3,12,Loyal
33334,377,4,704.43,2,1,1,4,Hibernating
33335,35,15,1757.82,5,5,4,14,Champions
33336,323,5,757.2,2,1,1,4,Hibernating
33337,213,3,607.32,3,1,1,5,Regulars
33338,40,12,2126.89,5,4,4,13,Champions
33339,46,7,844.89,5,1,2,8,Regulars
33340,378,6,386.5,2,1,1,4,Hibernating
33341,256,10,1340.15,2,3,3,8,Regulars
33342,213,7,1672.36,3,1,3,7,Regulars
33343,284,8,2575.87,2,2,5,9,Regulars
33344,131,14,1905.37,4,5,4,13,Champions
33345,3,9,1410.96,5,2,3,10,Regulars
33346,605,11,2541.9900000000002,1,3,4,8,Regulars
33347,556,7,1250.2,1,1,3,5,Regulars
33348,37,11,1916.27,5,3,4,12,Loyal
33349,391,10,948.74,2,3,2,7,Regulars
33350,57,11,2054.98,5,3,4,12,Loyal
33351,131,15,3040.61,4,5,5,14,Champions
33352,169,10,1550.17,3,3,3,9,Regulars
33353,8,8,1378.4499999999998,5,2,3,10,Regulars
33354,103,18,4735.2,4,5,5,14,Champions
33355,380,12,2412.6,2,4,4,10,At Risk
33356,3,14,1945.58,5,5,4,14,Champions
33357,64,15,1826.34,5,5,4,14,Champions
33358,890,8,741.3800000000001,1,2,1,4,Hibernating
33359,34,10,885.5799999999999,5,3,2,10,Loyal
33360,45,10,981.03,5,3,2,10,Loyal
33361,63,10,2292.25,5,3,4,12,Loyal
33362,719,6,629.4699999999999,1,1,1,3,Hibernating
33363,152,10,1397.65,3,3,3,9,Regulars
33364,262,12,1384.33,2,4,3,9,At Risk
33365,222,15,3327.58,3,5,5,13,Big Spenders
33366,68,9,3084.55,4,2,5,11,Big Spenders
33367,109,10,950.61,4,3,2,9,Loyal
33368,212,10,901.58,3,3,2,8,Regulars
33369,327,11,786.73,2,3,1,6,Regulars
33370,170,11,1294.28,3,3,3,9,Regulars
33371,30,12,1455.06,5,4,3,12,Loyal
33372,239,15,1744.0,3,5,4,12,Big Spenders
33373,186,5,4327.99,3,1,5,9,Big Spenders
33374,32,10,2609.58,5,3,5,13,Loyal
33375,1314,4,189.11999999999998,1,1,1,3,Hibernating
33376,1475,3,187.06,1,1,1,3,Hibernating
33377,1068,6,1668.4099999999999,1,1,3,5,Regulars
33378,263,9,1074.25,2,2,2,6,Hibernating
33379,62,10,1264.44,5,3,3,11,Loyal
33380,853,9,664.84,1,2,1,4,Hibernating
33381,228,12,1309.17,3,4,3,10,Regulars
33382,151,8,1071.79,3,2,2,7,Regulars
33383,20,8,710.96,5,2,1,8,Regulars
33384,5,6,335.03,5,1,1,7,Regulars
33385,298,14,2955.04,2,5,5,12,At Risk
33386,389,11,1942.11,2,3,4,9,Regulars
33387,947,13,2481.19,1,4,4,9,At Risk
33388,92,9,4175.17,4,2,5,11,Big Spenders
33389,582,11,840.66,1,3,1,5,Regulars
33390,569,9,2667.05,1,2,5,8,Regulars
33391,18,7,2027.55,5,1,4,10,Big Spenders
33392,461,5,316.3,1,1,1,3,Hibernating
33393,72,9,2208.34,4,2,4,10,Big Spenders
33394,674,10,2805.6099999999997,1,3,5,9,Regulars
33395,40,15,2618.16,5,5,5,15,Champions
33396,383,9,842.0,2,2,1,5,Hibernating
33397,170,7,577.56,3,1,1,5,Regulars
33398,139,10,2173.57,4,3,4,11,Loyal
33399,116,9,1079.73,4,2,2,8,Regulars
33400,164,6,1020.32,3,1,2,6,Regulars
33401,150,13,2337.17,3,4,4,11,Big Spenders
33402,82,10,807.4699999999999,4,3,1,8,Loyal
33403,33,12,2296.29,5,4,4,13,Champions
33404,431,12,1273.99,2,4,3,9,At Risk
33405,219,10,1191.14,3,3,2,8,Regulars
33406,292,10,1042.51,2,3,2,7,Regulars
33407,370,4,450.24,2,1,1,4,Hibernating
33408,176,14,2594.7599999999998,3,5,5,13,Big Spenders
33409,1169,9,701.89,1,2,1,4,Hibernating
33410,196,10,4354.4800000000005,3,3,5,11,Big Spenders
33411,31,7,534.63,5,1,1,7,Regulars
33412,73,11,2350.4900000000002,4,3,4,11,Loyal
33413,5,13,1127.5900000000001,5,4,2,11,Loyal
33414,294,7,503.49,2,1,1,4,Hibernating
33415,221,11,1309.63,3,3,3,9,Regulars
33416,0,13,3037.09,5,4,5,14,Champions
33417,91,14,1258.68,4,5,3,12,Loyal
33418,584,7,3460.6499999999996,1,1,5,7,Regulars
33419,599,13,1745.05,1,4,4,9,At Risk
33420,204,16,2610.02,3,5,5,13,Big Spenders
33421,4,12,4944.14,5,4,5,14,Champions
33422,92,13,1185.7,4,4,2,10,Loyal
33423,239,6,2241.48,3,1,4,8,Big Spenders
33424,326,9,1590.79,2,2,3,7,Regulars
33425,228,7,2294.9300000000003,3,1,4,8,Big Spenders
33426,321,10,988.3,2,3,2,7,Regulars
33427,377,14,2146.88,2,5,4,11,At Risk
33428,481,14,4650.2300000000005,1,5,5,11,At Risk
33429,215,18,2068.44,3,5,4,12,Big Spenders
33430,227,12,1117.6100000000001,3,4,2,9,Regulars
33431,665,7,551.59,1,1,1,3,Hibernating
33432,96,10,698.13,4,3,1,8,Loyal
33433,38,7,343.2,5,1,1,7,Regulars
33434,161,12,2902.04,3,4,5,12,Big Spenders
33435,184,9,1068.48,3,2,2,7,Regulars
33436,162,9,488.64,3,2,1,6,Regulars
33437,270,9,1024.61,2,2,2,6,Hibernating
33438,249,14,3694.8199999999997,2,5,5,12,At Risk
33439,549,11,2237.63,1,3,4,8,Regulars
33440,6,11,835.58,5,3,1,9,Loyal
33441,48,8,976.29,5,2,2,9,Regulars
33442,163,13,3763.7200000000003,3,4,5,12,Big Spenders
33443,457,9,1057.33,2,2,2,6,Hibernating
33444,371,8,1122.99,2,2,2,6,Hibernating
33445,405,10,2122.6800000000003,2,3,4,9,Regulars
33446,298,11,1715.44,2,3,3,8,Regulars
33447,92,12,2368.49,4,4,4,12,Champions
33448,277,9,1233.07,2,2,2,6,Hibernating
33449,50,8,3528.4700000000003,5,2,5,12,Big Spenders
33450,160,14,1432.08,3,5,3,11,Regulars
33451,251,7,941.9300000000001,2,1,2,5,Hibernating
33452,220,14,1279.19,3,5,3,11,Regulars
33453,228,15,1043.97,3,5,2,10,Regulars
33454,124,10,1085.0,4,3,2,9,Loyal
33455,9,17,5829.92,5,5,5,15,Champions
33456,43,10,1491.52,5,3,3,11,Loyal
33457,258,11,514.02,2,3,1,6,Regulars
33458,309,7,2349.0,2,1,4,7,Regulars
33459,310,11,1492.26,2,3,3,8,Regulars
33460,1692,4,785.5799999999999,1,1,1,3,Hibernating
33461,83,7,2954.33,4,1,5,10,Big Spenders
33462,154,9,968.17,3,2,2,7,Regulars
33463,63,9,920.26,5,2,2,9,Regulars
33464,318,8,1404.53,2,2,3,7,Regulars
33465,179,12,2729.97,3,4,5,12,Big Spenders
33466,739,6,736.71,1,1,1,3,Hibernating
33467,87,13,1693.23,4,4,3,11,Loyal
33468,151,10,1418.21,3,3,3,9,Regulars
33469,211,17,2315.1800000000003,3,5,4,12,Big Spenders
33470,3,15,1863.32,5,5,4,14,Champions
33471,37,15,3090.99,5,5,5,15,Champions
33472,490,9,2278.83,1,2,4,7,Regulars
33473,211,10,3468.35,3,3,5,11,Big Spenders
33474,165,16,1890.6100000000001,3,5,4,12,Big Spenders
33475,60,6,1322.17,5,1,3,9,Regulars
33476,485,6,566.24,1,1,1,3,Hibernating
33477,506,7,614.15,1,1,1,3,Hibernating
33478,17,12,2395.01,5,4,4,13,Champions
33479,77,11,4654.8,4,3,5,12,Loyal
33480,448,12,2307.19,2,4,4,10,At Risk
33481,264,13,1784.34,2,4,4,10,At Risk
33482,175,8,978.78,3,2,2,7,Regulars
33483,188,10,2180.02,3,3,4,10,Big Spenders
33484,650,11,1333.12,1,3,3,7,Regulars
33485,229,13,1425.16,3,4,3,10,Regulars
33486,224,12,1301.98,3,4,3,10,Regulars
33487,489,2,1251.56,1,1,3,5,Regulars
33488,107,18,4338.68,4,5,5,14,Champions
33489,315,9,1511.05,2,2,3,7,Regulars
33490,33,13,1406.6,5,4,3,12,Loyal
33491,12,16,2381.05,5,5,4,14,Champions
33492,108,16,6330.44,4,5,5,14,Champions
33493,60,4,153.45,5,1,1,7,Regulars
33494,60,17,2126.1,5,5,4,14,Champions
33495,287,8,2894.5,2,2,5,9,Regulars
33496,246,12,3108.3599999999997,3,4,5,12,Big Spenders
33497,1,12,3532.4500000000003,5,4,5,14,Champions
33498,147,9,1016.15,4,2,2,8,Regulars
33499,169,9,1072.0,3,2,2,7,Regulars
33500,527,11,1490.52,1,3,3,7,Regulars
33501,29,7,2050.83,5,1,4,10,Big Spenders
33502,91,10,2509.0899999999997,4,3,4,11,Loyal
33503,203,13,1245.05,3,4,3,10,Regulars
33504,395,11,1386.09,2,3,3,8,Regulars
33505,21,12,3488.07,5,4,5,14,Champions
33506,121,12,2578.4900000000002,4,4,5,13,Champions
33507,101,9,1448.99,4,2,3,9,Regulars
33508,534,14,777.33,1,5,1,7,At Risk
33509,143,14,2767.52,4,5,5,14,Champions
33510,108,15,4738.41,4,5,5,14,Champions
33511,85,14,1281.66,4,5,3,12,Loyal
33512,15,17,1721.03,5,5,3,13,Loyal
33513,673,9,842.06,1,2,1,4,Hibernating
33514,213,8,387.74,3,2,1,6,Regulars
33515,98,8,1205.1100000000001,4,2,2,8,Regulars
33516,99,10,600.55,4,3,1,8,Loyal
33517,426,11,2047.5300000000002,2,3,4,9,Regulars
33518,291,10,1966.53,2,3,4,9,Regulars
33519,149,12,1516.48,3,4,3,10,Regulars
33520,430,5,503.55999999999995,2,1,1,4,Hibernating
33521,76,9,609.19,4,2,1,7,Regulars
33522,52,12,810.6,5,4,1,10,Loyal
33523,367,14,1816.68,2,5,4,11,At Risk
33524,208,8,801.3900000000001,3,2,1,6,Regulars
33525,461,10,1620.25,1,3,3,7,Regulars
33526,75,15,2537.32,4,5,4,13,Champions
33527,5,12,2434.82,5,4,4,13,Champions
33528,942,8,1100.44,1,2,2,5,Hibernating
33529,102,6,734.41,4,1,1,6,Regulars
33530,477,7,221.28,1,1,1,3,Hibernating
33531,7,12,1193.57,5,4,2,11,Loyal
33532,496,7,837.1,1,1,1,3,Hibernating
33533,53,13,1894.51,5,4,4,13,Champions
33534,48,12,2191.92,5,4,4,13,Champions
33535,208,13,1328.25,3,4,3,10,Regulars
33536,120,14,1140.82,4,5,2,11,Loyal
33537,129,13,1211.92,4,4,2,10,Loyal
33538,284,10,2193.0,2,3,4,9,Regulars
33539,108,15,1860.82,4,5,4,13,Champions
33540,502,9,1393.32,1,2,3,6,Regulars
33541,6,11,1187.3,5,3,2,10,Loyal
33542,651,11,2765.2,1,3,5,9,Regulars
33543,880,10,2315.08,1,3,4,8,Regulars
33544,91,12,1476.56,4,4,3,11,Loyal
33545,295,10,1431.54,2,3,3,8,Regulars
33546,30,16,2675.74,5,5,5,15,Champions
33547,290,17,2729.6800000000003,2,5,5,12,At Risk
33548,921,7,681.3,1,1,1,3,Hibernating
33549,251,8,1013.13,2,2,2,6,Hibernating
33550,45,11,1007.63,5,3,2,10,Loyal
33551,497,10,757.52,1,3,1,5,Regulars
33552,31,12,2225.3599999999997,5,4,4,13,Champions
33553,75,10,2127.8399999999997,4,3,4,11,Loyal
33554,791,10,1427.5,1,3,3,7,Regulars
33555,50,11,982.3599999999999,5,3,2,10,Loyal
33556,342,7,2333.7,2,1,4,7,Regulars
33557,758,13,2177.7799999999997,1,4,4,9,At Risk
33558,25,4,287.08,5,1,1,7,Regulars
33559,409,7,975.84,2,1,2,5,Hibernating
33560,8,17,2146.43,5,5,4,14,Champions
33561,274,7,4258.0199999999995,2,1,5,8,Regulars
33562,231,11,1663.0,3,3,3,9,Regulars
33563,720,9,1340.88,1,2,3,6,Regulars
33564,199,12,3764.52,3,4,5,12,Big Spenders
33565,9,7,940.26,5,1,2,8,Regulars
33566,539,9,2317.3599999999997,1,2,4,7,Regulars
33567,160,13,4013.61,3,4,5,12,Big Spenders
33568,333,13,4158.5,2,4,5,11,At Risk
33569,494,5,729.1800000000001,1,1,1,3,Hibernating
33570,279,12,1036.19,2,4,2,8,At Risk
33571,448,16,3961.52,2,5,5,12,At Risk
33572,4,9,1072.04,5,2,2,9,Regulars
33573,292,9,1936.55,2,2,4,8,Regulars
33574,287,15,1978.27,2,5,4,11,At Risk
33575,171,8,844.2800000000001,3,2,1,6,Regulars
33576,455,8,1283.7,2,2,3,7,Regulars
33577,386,12,3034.78,2,4,5,11,At Risk
33578,229,13,2040.79,3,4,4,11,Big Spenders
33579,74,17,4307.0,4,5,5,14,Champions
33580,320,8,2417.12,2,2,4,8,Regulars
33581,653,7,992.02,1,1,2,4,Hibernating
33582,87,7,475.85,4,1,1,6,Regulars
33583,551,10,803.47,1,3,1,5,Regulars
33584,96,9,1022.74,4,2,2,8,Regulars
33585,502,9,1461.85,1,2,3,6,Regulars
33586,99,9,1138.3600000000001,4,2,2,8,Regulars
33587,575,12,2097.17,1,4,4,9,At Risk
33588,208,12,1643.8,3,4,3,10,Regulars
33589,446,10,1375.37,2,3,3,8,Regulars
33590,221,9,4583.19,3,2,5,10,Big Spenders
33591,238,11,656.24,3,3,1,7,Regulars
33592,563,6,718.8,1,1,1,3,Hibernating
33593,160,12,2710.71,3,4,5,12,Big Spenders
33594,193,14,1220.41,3,5,2,10,Regulars
33595,40,12,5933.68,5,4,5,14,Champions
33596,172,14,2239.41,3,5,4,12,Big Spenders
33597,1117,9,609.02,1,2,1,4,Hibernating
33598,537,6,809.11,1,1,1,3,Hibernating
33599,159,8,1981.21,3,2,4,9,Big Spenders
33600,216,9,1025.99,3,2,2,7,Regulars
33601,150,5,341.14,3,1,1,5,Regulars
33602,92,13,2349.06,4,4,4,12,Champions
33603,44,9,2932.77,5,2,5,12,Big Spenders
33604,164,8,1005.4,3,2,2,7,Regulars
33605,361,12,892.45,2,4,2,8,At Risk
33606,73,12,1416.8899999999999,4,4,3,11,Loyal
33607,693,9,786.62,1,2,1,4,Hibernating
33608,132,7,863.28,4,1,2,7,Regulars
33609,145,16,3822.5,4,5,5,14,Champions
33610,658,7,949.54,1,1,2,4,Hibernating
33611,629,9,1316.01,1,2,3,6,Regulars
33612,49,12,2603.73,5,4,5,14,Champions
33613,944,6,1502.31,1,1,3,5,Regulars
33614,506,17,3451.92,1,5,5,11,At Risk
33615,114,12,3523.27,4,4,5,13,Champions
33616,198,8,1147.9499999999998,3,2,2,7,Regulars
33617,431,12,1710.6799999999998,2,4,3,9,At Risk
33618,1005,13,2144.15,1,4,4,9,At Risk
33619,543,13,3267.16,1,4,5,10,At Risk
33620,78,13,1272.29,4,4,3,11,Loyal
33621,160,6,1931.4,3,1,4,8,Big Spenders
33622,135,10,1929.26,4,3,4,11,Loyal
33623,167,10,1159.67,3,3,2,8,Regulars
33624,53,13,1699.56,5,4,3,12,Loyal
33625,1409,7,4413.33,1,1,5,7,Regulars
33626,260,10,1499.1000000000001,2,3,3,8,Regulars
33627,670,7,1050.9,1,1,2,4,Hibernating
33628,112,9,494.2,4,2,1,7,Regulars
33629,125,5,517.3100000000001,4,1,1,6,Regulars
33630,55,10,2537.69,5,3,4,12,Loyal
33631,274,8,800.45,2,2,1,5,Hibernating
33632,241,13,1575.0600000000002,3,4,3,10,Regulars
33633,378,9,1251.21,2,2,3,7,Regulars
33634,308,16,2557.9599999999996,2,5,4,11,At Risk
33635,77,9,2207.46,4,2,4,10,Big Spenders
33636,651,10,855.64,1,3,2,6,Regulars
33637,1180,2,59.32,1,1,1,3,Hibernating
33638,248,10,805.4699999999999,2,3,1,6,Regulars
33639,460,12,753.64,1,4,1,6,At Risk
33640,693,8,3268.44,1,2,5,8,Regulars
33641,210,9,2590.83,3,2,5,10,Big Spenders
33642,116,8,752.74,4,2,1,7,Regulars
33643,45,10,981.71,5,3,2,10,Loyal
33644,670,9,1183.46,1,2,2,5,Hibernating
33645,47,6,369.27000000000004,5,1,1,7,Regulars
33646,225,5,691.86,3,1,1,5,Regulars
33647,267,8,756.14,2,2,1,5,Hibernating
33648,26,11,1766.3000000000002,5,3,4,12,Loyal
33649,763,10,2460.37,1,3,4,8,Regulars
33650,270,10,740.06,2,3,1,6,Regulars
33651,434,11,2601.77,2,3,5,10,Regulars
33652,65,11,3503.14,5,3,5,13,Loyal
33653,533,12,2339.97,1,4,4,9,At Risk
33654,164,9,1638.03,3,2,3,8,Regulars
33655,515,16,5170.82,1,5,5,11,At Risk
33656,277,8,812.8299999999999,2,2,1,5,Hibernating
33657,302,15,1635.44,2,5,3,10,At Risk
33658,35,16,1484.33,5,5,3,13,Loyal
33659,990,6,966.5600000000001,1,1,2,4,Hibernating
33660,379,12,2195.53,2,4,4,10,At Risk
33661,113,8,467.76,4,2,1,7,Regulars
33662,773,14,1707.72,1,5,3,9,At Risk
33663,16,12,908.0,5,4,2,11,Loyal
33664,485,13,3669.83,1,4,5,10,At Risk
33665,14,14,2066.9199999999996,5,5,4,14,Champions
33666,225,11,3639.5699999999997,3,3,5,11,Big Spenders
33667,79,13,2894.11,4,4,5,13,Champions
33668,234,12,2270.21,3,4,4,11,Big Spenders
33669,525,11,1120.93,1,3,2,6,Regulars
33670,277,13,2311.86,2,4,4,10,At Risk
33671,3,10,794.13,5,3,1,9,Loyal
33672,197,11,930.48,3,3,2,8,Regulars
33673,191,9,1503.6100000000001,3,2,3,8,Regulars
33674,60,12,1105.53,5,4,2,11,Loyal
33675,66,10,1833.88,4,3,4,11,Loyal
33676,853,7,1059.24,1,1,2,4,Hibernating
33677,118,11,1679.25,4,3,3,10,Loyal
33678,159,14,2504.8199999999997,3,5,4,12,Big Spenders
33679,242,6,677.76,3,1,1,5,Regulars
33680,386,10,1340.16,2,3,3,8,Regulars
33681,27,6,944.2700000000001,5,1,2,8,Regulars
33682,109,6,1076.7,4,1,2,7,Regulars
33683,502,10,3426.1600000000003,1,3,5,9,Regulars
33684,93,14,3599.67,4,5,5,14,Champions
33685,377,8,1288.77,2,2,3,7,Regulars
33686,84,17,2100.63,4,5,4,13,Champions
33687,687,12,980.97,1,4,2,7,At Risk
33688,483,11,1222.97,1,3,2,6,Regulars
33689,214,11,3268.79,3,3,5,11,Big Spenders
33690,182,14,2638.12,3,5,5,13,Big Spenders
33691,6,12,4245.74,5,4,5,14,Champions
33692,556,11,1337.47,1,3,3,7,Regulars
33693,500,13,2330.54,1,4,4,9,At Risk
33694,303,15,2914.81,2,5,5,12,At Risk
33695,694,13,1561.91,1,4,3,8,At Risk
33696,188,12,1041.94,3,4,2,9,Regulars
33697,42,13,1425.3700000000001,5,4,3,12,Loyal
33698,36,8,685.3499999999999,5,2,1,8,Regulars
33699,345,6,843.21,2,1,1,4,Hibernating
33700,100,11,3680.7,4,3,5,12,Loyal
33701,162,18,3324.2799999999997,3,5,5,13,Big Spenders
33702,528,14,1840.6799999999998,1,5,4,10,At Risk
33703,147,13,1105.66,4,4,2,10,Loyal
33704,26,10,407.85,5,3,1,9,Loyal
33705,103,12,4909.34,4,4,5,13,Champions
33706,286,8,1186.1499999999999,2,2,2,6,Hibernating
33707,75,13,1675.5300000000002,4,4,3,11,Loyal
33708,41,9,714.24,5,2,1,8,Regulars
33709,28,15,3238.31,5,5,5,15,Champions
33710,64,11,1222.91,5,3,2,10,Loyal
33711,453,15,1985.32,2,5,4,11,At Risk
33712,809,20,8293.13,1,5,5,11,At Risk
33713,1,9,1389.08,5,2,3,10,Regulars
33714,99,12,1927.95,4,4,4,12,Champions
33715,224,10,1040.1200000000001,3,3,2,8,Regulars
33716,571,7,732.84,1,1,1,3,Hibernating
33717,59,10,1354.32,5,3,3,11,Loyal
33718,720,3,373.34000000000003,1,1,1,3,Hibernating
33719,238,10,812.7,3,3,1,7,Regulars
33720,53,8,1880.3500000000001,5,2,4,11,Big Spenders
33721,303,11,1664.57,2,3,3,8,Regulars
33722,220,9,3074.65,3,2,5,10,Big Spenders
33723,588,12,2694.94,1,4,5,10,At Risk
33724,796,10,1330.84,1,3,3,7,Regulars
33725,58,11,2508.84,5,3,4,12,Loyal
33726,171,12,3525.0,3,4,5,12,Big Spenders
33727,181,12,3588.6899999999996,3,4,5,12,Big Spenders
33728,48,9,2164.55,5,2,4,11,Big Spenders
33729,149,12,2335.1099999999997,3,4,4,11,Big Spenders
33730,169,15,1841.73,3,5,4,12,Big Spenders
33731,1043,8,855.04,1,2,2,5,Hibernating
33732,170,12,849.1,3,4,2,9,Regulars
33733,449,10,2087.5099999999998,2,3,4,9,Regulars
33734,330,9,2495.79,2,2,4,8,Regulars
33735,206,11,1719.68,3,3,3,9,Regulars
33736,522,10,3315.5699999999997,1,3,5,9,Regulars
33737,525,7,236.50000000000003,1,1,1,3,Hibernating
33738,526,10,1967.4,1,3,4,8,Regulars
33739,84,12,1407.54,4,4,3,11,Loyal
33740,320,9,2588.79,2,2,5,9,Regulars
33741,7,10,1183.96,5,3,2,10,Loyal
33742,84,9,856.1,4,2,2,8,Regulars
33743,15,17,5508.05,5,5,5,15,Champions
33744,67,16,5515.05,4,5,5,14,Champions
33745,95,5,300.59000000000003,4,1,1,6,Regulars
33746,152,11,2731.31,3,3,5,11,Big Spenders
33747,67,7,3446.01,4,1,5,10,Big Spenders
33748,147,13,1216.3,4,4,2,10,Loyal
33749,69,10,856.2,4,3,2,9,Loyal
33750,313,18,1935.6999999999998,2,5,4,11,At Risk
33751,558,5,538.83,1,1,1,3,Hibernating
33752,245,9,2158.65,3,2,4,9,Big Spenders
33753,819,6,873.98,1,1,2,4,Hibernating
33754,48,8,1229.4900000000002,5,2,2,9,Regulars
33755,48,12,3303.3100000000004,5,4,5,14,Champions
33756,96,8,3116.32,4,2,5,11,Big Spenders
33757,318,9,889.99,2,2,2,6,Hibernating
33758,208,8,1247.6899999999998,3,2,3,8,Regulars
33759,440,17,1209.41,2,5,2,9,At Risk
33760,48,12,2062.48,5,4,4,13,Champions
33761,20,11,3310.18,5,3,5,13,Loyal
33762,775,8,587.51,1,2,1,4,Hibernating
33763,473,6,882.25,1,1,2,4,Hibernating
33764,213,8,485.96000000000004,3,2,1,6,Regulars
33765,694,12,1006.71,1,4,2,7,At Risk
33766,269,10,1606.24,2,3,3,8,Regulars
33767,6,12,2823.31,5,4,5,14,Champions
33768,42,13,1146.49,5,4,2,11,Loyal
33769,164,10,974.26,3,3,2,8,Regulars
33770,463,12,2048.0099999999998,1,4,4,9,At Risk
33771,300,7,3094.91,2,1,5,8,Regulars
33772,39,10,1479.69,5,3,3,11,Loyal
33773,9,13,4209.69,5,4,5,14,Champions
33774,179,13,1831.51,3,4,4,11,Big Spenders
33775,83,11,1300.12,4,3,3,10,Loyal
33776,108,9,2805.1,4,2,5,11,Big Spenders
33777,154,10,1206.91,3,3,2,8,Regulars
33778,180,9,951.1600000000001,3,2,2,7,Regulars
33779,443,9,690.62,2,2,1,5,Hibernating
33780,85,6,445.75,4,1,1,6,Regulars
33781,159,16,5213.46,3,5,5,13,Big Spenders
33782,65,12,2261.0099999999998,5,4,4,13,Champions
33783,216,10,2799.12,3,3,5,11,Big Spenders
33784,189,10,1093.4199999999998,3,3,2,8,Regulars
33785,573,6,934.81,1,1,2,4,Hibernating
33786,640,10,677.95,1,3,1,5,Regulars
33787,33,15,2762.87,5,5,5,15,Champions
33788,638,3,546.55,1,1,1,3,Hibernating
33789,361,14,1977.83,2,5,4,11,At Risk
33790,350,10,1661.91,2,3,3,8,Regulars
33791,822,9,846.8100000000001,1,2,2,5,Hibernating
33792,47,7,715.15,5,1,1,7,Regulars
33793,993,6,707.12,1,1,1,3,Hibernating
33794,349,14,2001.03,2,5,4,11,At Risk
33795,298,11,1384.37,2,3,3,8,Regulars
33796,540,8,1600.09,1,2,3,6,Regulars
33797,199,13,1549.49,3,4,3,10,Regulars
33798,179,14,1518.59,3,5,3,11,Regulars
33799,246,10,996.42,3,3,2,8,Regulars
33800,3,9,1714.65,5,2,3,10,Regulars
33801,478,17,3528.3900000000003,1,5,5,11,At Risk
33802,370,13,1546.1399999999999,2,4,3,9,At Risk
33803,54,11,809.1999999999999,5,3,1,9,Loyal
33804,151,9,1346.02,3,2,3,8,Regulars
33805,259,6,1085.76,2,1,2,5,Hibernating
33806,274,9,3286.82,2,2,5,9,Regulars
33807,161,11,879.54,3,3,2,8,Regulars
33808,165,11,1404.69,3,3,3,9,Regulars
33809,210,3,576.69,3,1,1,5,Regulars
33810,43,13,2679.79,5,4,5,14,Champions
33811,426,13,3044.63,2,4,5,11,At Risk
33812,26,18,3556.62,5,5,5,15,Champions
33813,225,11,2031.97,3,3,4,10,Big Spenders
33814,75,4,225.92,4,1,1,6,Regulars
33815,1022,8,782.84,1,2,1,4,Hibernating
33816,230,9,1064.95,3,2,2,7,Regulars
33817,682,6,1199.92,1,1,2,4,Hibernating
33818,55,15,1853.04,5,5,4,14,Champions
33819,85,12,2135.86,4,4,4,12,Champions
33820,413,12,3113.16,2,4,5,11,At Risk
33821,205,10,3922.42,3,3,5,11,Big Spenders
33822,75,11,1969.75,4,3,4,11,Loyal
33823,217,12,1752.01,3,4,4,11,Big Spenders
33824,257,8,2998.11,2,2,5,9,Regulars
33825,220,8,524.75,3,2,1,6,Regulars
33826,1431,7,500.23,1,1,1,3,Hibernating
33827,385,7,632.19,2,1,1,4,Hibernating
33828,496,5,570.13,1,1,1,3,Hibernating
33829,697,7,563.44,1,1,1,3,Hibernating
33830,296,5,201.24,2,1,1,4,Hibernating
33831,281,9,1051.01,2,2,2,6,Hibernating
33832,12,13,4030.2499999999995,5,4,5,14,Champions
33833,41,11,2505.7400000000002,5,3,4,12,Loyal
33834,316,6,1836.35,2,1,4,7,Regulars
33835,126,14,4566.610000000001,4,5,5,14,Champions
33836,550,8,2600.7999999999997,1,2,5,8,Regulars
33837,651,14,1562.53,1,5,3,9,At Risk
33838,717,9,2778.56,1,2,5,8,Regulars
33839,109,12,1107.52,4,4,2,10,Loyal
33840,357,8,2516.05,2,2,4,8,Regulars
33841,28,9,3668.4300000000003,5,2,5,12,Big Spenders
33842,207,11,2861.43,3,3,5,11,Big Spenders
33843,145,9,946.01,4,2,2,8,Regulars
33844,189,8,672.78,3,2,1,6,Regulars
33845,530,10,1273.5,1,3,3,7,Regulars
33846,32,11,1699.77,5,3,3,11,Loyal
33847,362,12,2022.4,2,4,4,10,At Risk
33848,811,13,1640.17,1,4,3,8,At Risk
33849,172,12,2498.14,3,4,4,11,Big Spenders
33850,398,10,1227.1,2,3,2,7,Regulars
33851,175,8,489.37,3,2,1,6,Regulars
33852,22,15,2006.9499999999998,5,5,4,14,Champions
33853,5,12,4306.37,5,4,5,14,Champions
33854,125,9,1375.81,4,2,3,9,Regulars
33855,405,5,395.57,2,1,1,4,Hibernating
33856,492,14,2213.71,1,5,4,10,At Risk
33857,161,6,829.11,3,1,1,5,Regulars
33858,273,15,3417.01,2,5,5,12,At Risk
33859,34,9,1825.0200000000002,5,2,4,11,Big Spenders
33860,183,11,1215.93,3,3,2,8,Regulars
33861,1022,6,422.28,1,1,1,3,Hibernating
33862,140,9,1930.8700000000001,4,2,4,10,Big Spenders
33863,632,9,649.57,1,2,1,4,Hibernating
33864,622,13,1160.11,1,4,2,7,At Risk
33865,378,12,2459.4900000000002,2,4,4,10,At Risk
33866,393,8,1008.53,2,2,2,6,Hibernating
33867,152,15,3027.42,3,5,5,13,Big Spenders
33868,12,9,994.98,5,2,2,9,Regulars
33869,387,8,2819.9900000000002,2,2,5,9,Regulars
33870,65,16,3995.54,5,5,5,15,Champions
33871,42,7,490.27000000000004,5,1,1,7,Regulars
33872,167,8,1570.96,3,2,3,8,Regulars
33873,153,14,2392.17,3,5,4,12,Big Spenders
33874,1227,8,2170.9700000000003,1,2,4,7,Regulars
33875,904,13,2701.7400000000002,1,4,5,10,At Risk
33876,323,10,937.6700000000001,2,3,2,7,Regulars
33877,186,13,2278.56,3,4,4,11,Big Spenders
33878,146,8,2467.86,4,2,4,10,Big Spenders
33879,99,11,1418.63,4,3,3,10,Loyal
33880,213,8,730.1,3,2,1,6,Regulars
33881,149,10,1677.23,3,3,3,9,Regulars
33882,82,5,1166.87,4,1,2,7,Regulars
33883,502,17,3420.26,1,5,5,11,At Risk
33884,272,15,5202.04,2,5,5,12,At Risk
33885,194,10,2101.7,3,3,4,10,Big Spenders
33886,552,6,736.37,1,1,1,3,Hibernating
33887,144,7,582.26,4,1,1,6,Regulars
33888,567,9,3035.22,1,2,5,8,Regulars
33889,55,10,1645.55,5,3,3,11,Loyal
33890,665,11,625.0,1,3,1,5,Regulars
33891,59,8,1297.96,5,2,3,10,Regulars
33892,190,13,4284.26,3,4,5,12,Big Spenders
33893,69,18,2376.39,4,5,4,13,Champions
33894,359,11,1336.58,2,3,3,8,Regulars
33895,371,10,774.13,2,3,1,6,Regulars
33896,213,10,1259.53,3,3,3,9,Regulars
33897,889,8,2136.4,1,2,4,7,Regulars
33898,48,6,1115.97,5,1,2,8,Regulars
33899,487,10,1041.27,1,3,2,6,Regulars
33900,104,11,2668.18,4,3,5,12,Loyal
33901,1105,8,877.64,1,2,2,5,Hibernating
33902,545,10,918.4399999999999,1,3,2,6,Regulars
33903,83,10,2686.6099999999997,4,3,5,12,Loyal
33904,223,10,982.11,3,3,2,8,Regulars
33905,190,11,888.84,3,3,2,8,Regulars
33906,251,12,3041.43,2,4,5,11,At Risk
33907,181,7,1005.5699999999999,3,1,2,6,Regulars
33908,159,10,1920.3700000000001,3,3,4,10,Big Spenders
33909,221,14,1448.01,3,5,3,11,Regulars
33910,337,14,3043.7200000000003,2,5,5,12,At Risk
33911,204,9,1215.8799999999999,3,2,2,7,Regulars
33912,664,14,2103.92,1,5,4,10,At Risk
33913,295,12,2164.36,2,4,4,10,At Risk
33914,220,9,4252.23,3,2,5,10,Big Spenders
33915,74,10,2024.8899999999999,4,3,4,11,Loyal
33916,173,12,1464.99,3,4,3,10,Regulars
33917,221,12,889.98,3,4,2,9,Regulars
33918,247,8,803.62,3,2,1,6,Regulars
33919,229,16,1756.12,3,5,4,12,Big Spenders
33920,236,11,1022.61,3,3,2,8,Regulars
33921,598,9,853.06,1,2,2,5,Hibernating
33922,253,11,2376.9700000000003,2,3,4,9,Regulars
33923,213,7,867.02,3,1,2,6,Regulars
33924,216,6,2323.88,3,1,4,8,Big Spenders
33925,76,9,738.15,4,2,1,7,Regulars
33926,281,9,1229.13,2,2,2,6,Hibernating
33927,592,6,706.71,1,1,1,3,Hibernating
33928,748,7,562.05,1,1,1,3,Hibernating
33929,348,10,1397.04,2,3,3,8,Regulars
33930,246,5,843.8199999999999,3,1,1,5,Regulars
33931,264,8,822.26,2,2,1,5,Hibernating
33932,497,7,788.4,1,1,1,3,Hibernating
33933,48,12,1449.28,5,4,3,12,Loyal
33934,491,4,1285.8400000000001,1,1,3,5,Regulars
33935,868,11,1589.76,1,3,3,7,Regulars
33936,218,9,1056.0,3,2,2,7,Regulars
33937,208,8,1276.75,3,2,3,8,Regulars
33938,282,16,1040.13,2,5,2,9,At Risk
33939,252,4,304.40999999999997,2,1,1,4,Hibernating
33940,22,13,1305.54,5,4,3,12,Loyal
33941,233,8,953.73,3,2,2,7,Regulars
33942,75,10,1289.21,4,3,3,10,Loyal
33943,744,10,1027.1,1,3,2,6,Regulars
33944,314,9,998.0200000000001,2,2,2,6,Hibernating
33945,671,6,901.51,1,1,2,4,Hibernating
33946,392,6,548.78,2,1,1,4,Hibernating
33947,69,9,907.86,4,2,2,8,Regulars
33948,293,17,2142.77,2,5,4,11,At Risk
33949,127,8,1905.5,4,2,4,10,Big Spenders
33950,170,8,1722.56,3,2,3,8,Regulars
33951,27,15,1459.53,5,5,3,13,Loyal
33952,878,12,1770.96,1,4,4,9,At Risk
33953,386,6,1092.52,2,1,2,5,Hibernating
33954,345,10,2822.84,2,3,5,10,Regulars
33955,174,12,1249.74,3,4,3,10,Regulars
33956,32,14,4835.3099999999995,5,5,5,15,Champions
33957,195,12,928.61,3,4,2,9,Regulars
33958,756,8,840.22,1,2,1,4,Hibernating
33959,171,10,1449.31,3,3,3,9,Regulars
33960,157,18,4161.97,3,5,5,13,Big Spenders
33961,244,9,1794.8400000000001,3,2,4,9,Big Spenders
33962,185,8,598.1,3,2,1,6,Regulars
33963,221,8,1335.45,3,2,3,8,Regulars
33964,151,11,4529.400000000001,3,3,5,11,Big Spenders
33965,495,10,1464.77,1,3,3,7,Regulars
33966,100,11,1449.3700000000001,4,3,3,10,Loyal
33967,90,10,1500.56,4,3,3,10,Loyal
33968,627,10,882.7,1,3,2,6,Regulars
33969,339,7,752.56,2,1,1,4,Hibernating
33970,27,14,1622.77,5,5,3,13,Loyal
33971,116,15,2946.43,4,5,5,14,Champions
33972,2,10,5715.71,5,3,5,13,Loyal
33973,13,9,2093.64,5,2,4,11,Big Spenders
33974,504,13,1302.3,1,4,3,8,At Risk
33975,156,9,1328.42,3,2,3,8,Regulars
33976,127,8,667.44,4,2,1,7,Regulars
33977,126,12,1809.35,4,4,4,12,Champions
33978,6,9,723.3399999999999,5,2,1,8,Regulars
33979,36,15,1855.46,5,5,4,14,Champions
33980,227,9,1710.1,3,2,3,8,Regulars
33981,1,11,1298.92,5,3,3,11,Loyal
33982,227,6,659.52,3,1,1,5,Regulars
33983,639,6,606.37,1,1,1,3,Hibernating
33984,80,11,922.07,4,3,2,9,Loyal
33985,388,9,2816.5099999999998,2,2,5,9,Regulars
33986,377,12,1520.79,2,4,3,9,At Risk
33987,94,11,1331.5700000000002,4,3,3,10,Loyal
33988,261,15,1780.58,2,5,4,11,At Risk
33989,148,12,1815.68,3,4,4,11,Big Spenders
33990,837,7,651.28,1,1,1,3,Hibernating
33991,929,8,1464.96,1,2,3,6,Regulars
33992,129,14,2630.36,4,5,5,14,Champions
33993,113,10,679.9599999999999,4,3,1,8,Loyal
33994,740,6,519.76,1,1,1,3,Hibernating
33995,43,10,1348.31,5,3,3,11,Loyal
33996,121,9,3183.18,4,2,5,11,Big Spenders
33997,5,12,1445.32,5,4,3,12,Loyal
33998,245,11,1193.42,3,3,2,8,Regulars
33999,975,4,391.61,1,1,1,3,Hibernating
34000,18,8,1196.1799999999998,5,2,2,9,Regulars
34001,10,7,605.42,5,1,1,7,Regulars
34002,21,14,4061.02,5,5,5,15,Champions
34003,128,7,716.44,4,1,1,6,Regulars
34004,340,8,1431.26,2,2,3,7,Regulars
34005,82,9,1755.09,4,2,4,10,Big Spenders
34006,305,6,319.95,2,1,1,4,Hibernating
34007,885,10,2825.33,1,3,5,9,Regulars
34008,388,8,1212.36,2,2,2,6,Hibernating
34009,182,8,1367.77,3,2,3,8,Regulars
34010,444,12,4300.35,2,4,5,11,At Risk
34011,458,9,1373.6000000000001,2,2,3,7,Regulars
34012,256,14,2041.4,2,5,4,11,At Risk
34013,2060,6,269.15999999999997,1,1,1,3,Hibernating
34014,52,4,950.2700000000001,5,1,2,8,Regulars
34015,187,8,1435.15,3,2,3,8,Regulars
34016,93,10,2734.8199999999997,4,3,5,12,Loyal
34017,30,7,628.14,5,1,1,7,Regulars
34018,851,10,1497.36,1,3,3,7,Regulars
34019,22,10,895.9499999999999,5,3,2,10,Loyal
34020,54,9,3458.1,5,2,5,12,Big Spenders
34021,385,10,1517.44,2,3,3,8,Regulars
34022,231,8,880.8599999999999,3,2,2,7,Regulars
34023,226,6,1516.1399999999999,3,1,3,7,Regulars
34024,359,11,1247.52,2,3,3,8,Regulars
34025,110,6,2227.46,4,1,4,9,Big Spenders
34026,283,9,2405.05,2,2,4,8,Regulars
34027,1323,6,515.74,1,1,1,3,Hibernating
34028,1101,8,1619.6299999999999,1,2,3,6,Regulars
34029,382,15,2828.9,2,5,5,12,At Risk
34030,163,10,736.7,3,3,1,7,Regulars
34031,216,13,1622.08,3,4,3,10,Regulars
34032,604,16,2285.24,1,5,4,10,At Risk
34033,398,8,885.68,2,2,2,6,Hibernating
34034,156,9,3273.68,3,2,5,10,Big Spenders
34035,330,11,1108.49,2,3,2,7,Regulars
34036,248,13,1477.12,2,4,3,9,At Risk
34037,28,8,2263.47,5,2,4,11,Big Spenders
34038,278,15,1020.24,2,5,2,9,At Risk
34039,730,6,745.22,1,1,1,3,Hibernating
34040,58,14,1482.81,5,5,3,13,Loyal
34041,476,9,1084.39,1,2,2,5,Hibernating
34042,358,13,1972.42,2,4,4,10,At Risk
34043,159,6,465.61,3,1,1,5,Regulars
34044,61,14,4354.8,5,5,5,15,Champions
34045,145,14,1506.05,4,5,3,12,Loyal
34046,27,11,1589.33,5,3,3,11,Loyal
34047,75,8,959.47,4,2,2,8,Regulars
34048,568,7,1023.06,1,1,2,4,Hibernating
34049,442,11,1810.91,2,3,4,9,Regulars
34050,335,9,537.09,2,2,1,5,Hibernating
34051,654,15,1736.6399999999999,1,5,4,10,At Risk
34052,114,17,1526.41,4,5,3,12,Loyal
34053,111,12,4034.4,4,4,5,13,Champions
34054,167,16,2462.7400000000002,3,5,4,12,Big Spenders
34055,509,17,1840.9,1,5,4,10,At Risk
34056,201,7,1173.88,3,1,2,6,Regulars
34057,489,18,1563.73,1,5,3,9,At Risk
34058,794,8,1400.23,1,2,3,6,Regulars
34059,445,11,1321.05,2,3,3,8,Regulars
34060,672,10,1158.16,1,3,2,6,Regulars
34061,440,9,1248.1299999999999,2,2,3,7,Regulars
34062,121,16,6794.56,4,5,5,14,Champions
34063,127,12,1581.79,4,4,3,11,Loyal
34064,448,14,1471.24,2,5,3,10,At Risk
34065,1446,8,1310.65,1,2,3,6,Regulars
34066,958,8,542.67,1,2,1,4,Hibernating
34067,697,7,1221.23,1,1,2,4,Hibernating
34068,266,8,992.21,2,2,2,6,Hibernating
34069,162,10,1281.93,3,3,3,9,Regulars
34070,148,5,757.01,3,1,1,5,Regulars
34071,185,8,339.93,3,2,1,6,Regulars
34072,213,11,1315.1,3,3,3,9,Regulars
34073,1067,4,344.17,1,1,1,3,Hibernating
34074,452,8,930.41,2,2,2,6,Hibernating
34075,12,10,1411.67,5,3,3,11,Loyal
34076,803,7,724.68,1,1,1,3,Hibernating
34077,64,13,2752.39,5,4,5,14,Champions
34078,142,11,1139.5900000000001,4,3,2,9,Loyal
34079,416,6,423.57,2,1,1,4,Hibernating
34080,246,5,2155.55,3,1,4,8,Big Spenders
34081,191,12,4061.3799999999997,3,4,5,12,Big Spenders
34082,599,7,735.6800000000001,1,1,1,3,Hibernating
34083,68,2,141.75,4,1,1,6,Regulars
34084,1145,12,3144.1800000000003,1,4,5,10,At Risk
34085,445,10,821.1399999999999,2,3,1,6,Regulars
34086,185,9,3033.6,3,2,5,10,Big Spenders
34087,455,8,1727.85,2,2,4,8,Regulars
34088,30,13,1452.99,5,4,3,12,Loyal
34089,488,9,863.63,1,2,2,5,Hibernating
34090,188,13,3026.51,3,4,5,12,Big Spenders
34091,751,5,361.86,1,1,1,3,Hibernating
34092,104,15,2761.39,4,5,5,14,Champions
34093,21,15,1967.13,5,5,4,14,Champions
34094,540,13,2394.33,1,4,4,9,At Risk
34095,191,8,683.11,3,2,1,6,Regulars
34096,265,14,2594.5699999999997,2,5,5,12,At Risk
34097,441,16,2637.14,2,5,5,12,At Risk
34098,401,11,1501.77,2,3,3,8,Regulars
34099,118,13,1586.04,4,4,3,11,Loyal
34100,148,11,1969.19,3,3,4,10,Big Spenders
34101,819,7,463.65999999999997,1,1,1,3,Hibernating
34102,94,10,1131.23,4,3,2,9,Loyal
34103,228,7,557.88,3,1,1,5,Regulars
34104,156,12,4133.75,3,4,5,12,Big Spenders
34105,7,10,1047.2,5,3,2,10,Loyal
34106,75,8,1254.27,4,2,3,9,Regulars
34107,398,5,507.79999999999995,2,1,1,4,Hibernating
34108,44,5,227.1,5,1,1,7,Regulars
34109,92,12,959.11,4,4,2,10,Loyal
34110,229,15,2474.9700000000003,3,5,4,12,Big Spenders
34111,142,17,2485.96,4,5,4,13,Champions
34112,60,8,2176.7699999999995,5,2,4,11,Big Spenders
34113,171,9,1863.2,3,2,4,9,Big Spenders
34114,186,11,1746.41,3,3,4,10,Big Spenders
34115,2761,1,8.74,1,1,1,3,Hibernating
34116,164,10,2840.28,3,3,5,11,Big Spenders
34117,19,11,2204.05,5,3,4,12,Loyal
34118,408,11,1457.48,2,3,3,8,Regulars
34119,71,18,2887.99,4,5,5,14,Champions
34120,99,5,1856.96,4,1,4,9,Big Spenders
34121,138,12,3508.12,4,4,5,13,Champions
34122,57,14,1068.65,5,5,2,12,Loyal
34123,53,15,1225.87,5,5,2,12,Loyal
34124,376,7,906.98,2,1,2,5,Hibernating
34125,226,16,5175.24,3,5,5,13,Big Spenders
34126,85,11,1726.6000000000001,4,3,4,11,Loyal
34127,138,9,1012.59,4,2,2,8,Regulars
34128,237,16,2207.4,3,5,4,12,Big Spenders
34129,241,11,900.19,3,3,2,8,Regulars
34130,19,13,2835.15,5,4,5,14,Champions
34131,80,17,4032.37,4,5,5,14,Champions
34132,313,12,3257.2200000000003,2,4,5,11,At Risk
34133,656,13,1158.94,1,4,2,7,At Risk
34134,461,8,1207.49,1,2,2,5,Hibernating
34135,387,7,1096.6499999999999,2,1,2,5,Hibernating
34136,619,10,771.16,1,3,1,5,Regulars
34137,580,12,1535.5700000000002,1,4,3,8,At Risk
34138,228,12,4723.63,3,4,5,12,Big Spenders
34139,118,12,817.74,4,4,1,9,Loyal
34140,130,10,772.48,4,3,1,8,Loyal
34141,241,7,1363.85,3,1,3,7,Regulars
34142,119,12,1387.91,4,4,3,11,Loyal
34143,134,5,2173.5099999999998,4,1,4,9,Big Spenders
34144,1485,5,1079.62,1,1,2,4,Hibernating
34145,83,13,2753.4700000000003,4,4,5,13,Champions
34146,127,10,1564.86,4,3,3,10,Loyal
34147,220,7,801.9300000000001,3,1,1,5,Regulars
34148,124,14,4230.33,4,5,5,14,Champions
34149,7,4,343.49,5,1,1,7,Regulars
34150,148,11,1131.65,3,3,2,8,Regulars
34151,1181,6,1017.1399999999999,1,1,2,4,Hibernating
34152,172,9,1416.59,3,2,3,8,Regulars
34153,407,11,988.44,2,3,2,7,Regulars
34154,311,13,2345.66,2,4,4,10,At Risk
34155,280,13,5075.67,2,4,5,11,At Risk
34156,304,13,1155.58,2,4,2,8,At Risk
34157,249,11,1020.05,2,3,2,7,Regulars
34158,207,10,1001.0699999999999,3,3,2,8,Regulars
34159,10,17,2257.23,5,5,4,14,Champions
34160,267,9,1149.9899999999998,2,2,2,6,Hibernating
34161,92,11,1911.21,4,3,4,11,Loyal
34162,348,7,840.26,2,1,1,4,Hibernating
34163,156,11,1339.6299999999999,3,3,3,9,Regulars
34164,52,14,1494.09,5,5,3,13,Loyal
34165,53,8,1418.75,5,2,3,10,Regulars
34166,746,11,1211.1299999999999,1,3,2,6,Regulars
34167,173,7,856.67,3,1,2,6,Regulars
34168,1302,6,647.73,1,1,1,3,Hibernating
34169,218,19,2776.29,3,5,5,13,Big Spenders
34170,325,10,2098.89,2,3,4,9,Regulars
34171,235,10,2655.54,3,3,5,11,Big Spenders
34172,111,6,2574.5299999999997,4,1,5,10,Big Spenders
34173,338,5,1907.3399999999997,2,1,4,7,Regulars
34174,122,15,1668.33,4,5,3,12,Loyal
34175,609,12,2380.85,1,4,4,9,At Risk
34176,52,8,722.33,5,2,1,8,Regulars
34177,437,12,935.5,2,4,2,8,At Risk
34178,741,12,1497.48,1,4,3,8,At Risk
34179,209,8,1362.35,3,2,3,8,Regulars
34180,214,10,1520.06,3,3,3,9,Regulars
34181,305,13,2111.21,2,4,4,10,At Risk
34182,587,10,1529.8400000000001,1,3,3,7,Regulars
34183,1248,2,174.19,1,1,1,3,Hibernating
34184,184,14,1970.07,3,5,4,12,Big Spenders
34185,235,11,1366.48,3,3,3,9,Regulars
34186,99,13,4214.68,4,4,5,13,Champions
34187,55,10,3470.8,5,3,5,13,Loyal
34188,166,15,3241.66,3,5,5,13,Big Spenders
34189,601,13,1558.8700000000001,1,4,3,8,At Risk
34190,34,6,787.47,5,1,1,7,Regulars
34191,615,8,712.31,1,2,1,4,Hibernating
34192,590,11,1205.6399999999999,1,3,2,6,Regulars
34193,15,7,575.03,5,1,1,7,Regulars
34194,165,7,517.08,3,1,1,5,Regulars
34195,199,8,1011.6800000000001,3,2,2,7,Regulars
34196,512,8,788.21,1,2,1,4,Hibernating
34197,973,13,1765.0,1,4,4,9,At Risk
34198,286,9,1609.82,2,2,3,7,Regulars
34199,33,17,2104.06,5,5,4,14,Champions
34200,574,16,2028.27,1,5,4,10,At Risk
34201,475,12,2116.86,1,4,4,9,At Risk
34202,383,11,1280.78,2,3,3,8,Regulars
34203,245,7,1682.7600000000002,3,1,3,7,Regulars
34204,26,15,1863.28,5,5,4,14,Champions
34205,384,5,608.0,2,1,1,4,Hibernating
34206,212,10,1521.93,3,3,3,9,Regulars
34207,638,7,1519.87,1,1,3,5,Regulars
34208,515,5,1817.72,1,1,4,6,Regulars
34209,295,7,350.76,2,1,1,4,Hibernating
34210,560,6,295.01,1,1,1,3,Hibernating
34211,17,14,1624.42,5,5,3,13,Loyal
34212,60,12,1609.15,5,4,3,12,Loyal
34213,208,8,3644.11,3,2,5,10,Big Spenders
34214,365,7,543.0699999999999,2,1,1,4,Hibernating
34215,341,12,1148.37,2,4,2,8,At Risk
34216,13,12,1322.78,5,4,3,12,Loyal
34217,217,14,2917.94,3,5,5,13,Big Spenders
34218,175,10,1433.21,3,3,3,9,Regulars
34219,116,7,927.97,4,1,2,7,Regulars
34220,355,11,1813.98,2,3,4,9,Regulars
34221,191,9,896.52,3,2,2,7,Regulars
34222,52,6,840.47,5,1,1,7,Regulars
34223,224,8,805.78,3,2,1,6,Regulars
34224,201,12,3915.37,3,4,5,12,Big Spenders
34225,504,9,3134.6299999999997,1,2,5,8,Regulars
34226,98,9,919.9,4,2,2,8,Regulars
34227,54,13,1514.31,5,4,3,12,Loyal
34228,266,5,2170.98,2,1,4,7,Regulars
34229,139,11,2720.76,4,3,5,12,Loyal
34230,1,9,843.38,5,2,1,8,Regulars
34231,404,9,642.26,2,2,1,5,Hibernating
34232,25,17,1624.94,5,5,3,13,Loyal
34233,28,10,3115.71,5,3,5,13,Loyal
34234,192,11,4081.0299999999997,3,3,5,11,Big Spenders
34235,562,10,2598.89,1,3,5,9,Regulars
34236,399,5,797.0,2,1,1,4,Hibernating
34237,42,16,2099.9,5,5,4,14,Champions
34238,4,13,1277.24,5,4,3,12,Loyal
34239,42,12,2165.23,5,4,4,13,Champions
34240,229,9,1077.6599999999999,3,2,2,7,Regulars
34241,206,10,2289.48,3,3,4,10,Big Spenders
34242,196,8,1200.44,3,2,2,7,Regulars
34243,152,14,2078.06,3,5,4,12,Big Spenders
34244,129,13,1646.73,4,4,3,11,Loyal
34245,165,10,1159.7,3,3,2,8,Regulars
34246,35,14,1735.49,5,5,4,14,Champions
34247,173,13,2098.69,3,4,4,11,Big Spenders
34248,44,9,510.82,5,2,1,8,Regulars
34249,342,9,672.08,2,2,1,5,Hibernating
34250,505,10,1210.3600000000001,1,3,2,6,Regulars
34251,488,17,1650.62,1,5,3,9,At Risk
34252,234,11,1731.85,3,3,4,10,Big Spenders
34253,853,9,2272.27,1,2,4,7,Regulars
34254,48,11,2092.25,5,3,4,12,Loyal
34255,37,13,1192.61,5,4,2,11,Loyal
34256,104,7,1444.58,4,1,3,8,Regulars
34257,649,11,1146.8,1,3,2,6,Regulars
34258,329,13,1701.52,2,4,3,9,At Risk
34259,477,7,803.9200000000001,1,1,1,3,Hibernating
34260,551,4,293.74,1,1,1,3,Hibernating
34261,187,7,3046.15,3,1,5,9,Big Spenders
34262,119,11,1470.96,4,3,3,10,Loyal
34263,351,13,1333.7199999999998,2,4,3,9,At Risk
34264,7,11,1442.1100000000001,5,3,3,11,Loyal
34265,172,14,1232.09,3,5,2,10,Regulars
34266,312,14,4089.13,2,5,5,12,At Risk
34267,599,10,1148.14,1,3,2,6,Regulars
34268,144,10,1404.99,4,3,3,10,Loyal
34269,223,7,1541.16,3,1,3,7,Regulars
34270,18,15,4359.67,5,5,5,15,Champions
34271,188,5,240.23000000000002,3,1,1,5,Regulars
34272,395,13,1840.42,2,4,4,10,At Risk
34273,33,18,2730.1,5,5,5,15,Champions
34274,192,11,1046.41,3,3,2,8,Regulars
34275,483,9,2114.51,1,2,4,7,Regulars
34276,977,4,736.14,1,1,1,3,Hibernating
34277,59,19,1521.41,5,5,3,13,Loyal
34278,6,10,2318.06,5,3,4,12,Loyal
34279,114,10,1184.18,4,3,2,9,Loyal
34280,84,9,1507.17,4,2,3,9,Regulars
34281,156,9,2422.52,3,2,4,9,Big Spenders
34282,90,18,1783.8,4,5,4,13,Champions
34283,335,13,1782.95,2,4,4,10,At Risk
34284,524,8,1401.74,1,2,3,6,Regulars
34285,1610,6,398.42,1,1,1,3,Hibernating
34286,18,11,2282.9,5,3,4,12,Loyal
34287,199,12,4096.92,3,4,5,12,Big Spenders
34288,551,6,459.6,1,1,1,3,Hibernating
34289,68,7,1227.4499999999998,4,1,2,7,Regulars
34290,306,11,2491.81,2,3,4,9,Regulars
34291,293,14,3339.3,2,5,5,12,At Risk
34292,555,9,1300.79,1,2,3,6,Regulars
34293,88,12,1512.45,4,4,3,11,Loyal
34294,97,7,2391.9700000000003,4,1,4,9,Big Spenders
34295,164,9,1455.44,3,2,3,8,Regulars
34296,10,8,6111.81,5,2,5,12,Big Spenders
34297,465,8,562.59,1,2,1,4,Hibernating
34298,161,6,2383.44,3,1,4,8,Big Spenders
34299,331,14,3974.66,2,5,5,12,At Risk
34300,341,17,4835.51,2,5,5,12,At Risk
34301,152,14,913.6,3,5,2,10,Regulars
34302,534,11,2662.2000000000003,1,3,5,9,Regulars
34303,698,8,532.7,1,2,1,4,Hibernating
34304,124,14,614.25,4,5,1,10,Loyal
34305,300,16,3813.16,2,5,5,12,At Risk
34306,108,13,2696.76,4,4,5,13,Champions
34307,124,5,579.5699999999999,4,1,1,6,Regulars
34308,42,12,1513.53,5,4,3,12,Loyal
34309,35,12,969.22,5,4,2,11,Loyal
34310,674,6,438.24,1,1,1,3,Hibernating
34311,202,11,1281.0,3,3,3,9,Regulars
34312,526,10,1959.87,1,3,4,8,Regulars
34313,479,13,2386.23,1,4,4,9,At Risk
34314,271,15,3925.35,2,5,5,12,At Risk
34315,15,6,385.17,5,1,1,7,Regulars
34316,164,6,2926.71,3,1,5,9,Big Spenders
34317,338,10,1559.71,2,3,3,8,Regulars
34318,228,14,1259.63,3,5,3,11,Regulars
34319,179,11,1223.1,3,3,2,8,Regulars
34320,16,11,2091.14,5,3,4,12,Loyal
34321,262,4,1648.69,2,1,3,6,Regulars
34322,144,12,2886.3500000000004,4,4,5,13,Champions
34323,119,14,1391.2999999999997,4,5,3,12,Loyal
34324,292,8,356.16,2,2,1,5,Hibernating
34325,604,9,1051.61,1,2,2,5,Hibernating
34326,363,10,1219.08,2,3,2,7,Regulars
34327,207,13,2834.69,3,4,5,12,Big Spenders
34328,122,5,315.15,4,1,1,6,Regulars
34329,531,8,546.4200000000001,1,2,1,4,Hibernating
34330,132,13,2702.01,4,4,5,13,Champions
34331,213,16,2727.3,3,5,5,13,Big Spenders
34332,519,8,939.1400000000001,1,2,2,5,Hibernating
34333,127,11,4023.55,4,3,5,12,Loyal
34334,190,7,2023.7600000000002,3,1,4,8,Big Spenders
34335,86,6,700.91,4,1,1,6,Regulars
34336,263,9,1328.65,2,2,3,7,Regulars
34337,76,10,1828.0,4,3,4,11,Loyal
34338,260,14,4616.88,2,5,5,12,At Risk
34339,329,13,5160.78,2,4,5,11,At Risk
34340,322,10,3352.2,2,3,5,10,Regulars
34341,85,15,4617.32,4,5,5,14,Champions
34342,188,10,812.81,3,3,1,7,Regulars
34343,75,6,342.89000000000004,4,1,1,6,Regulars
34344,302,10,887.66,2,3,2,7,Regulars
34345,238,13,1756.54,3,4,4,11,Big Spenders
34346,85,17,1652.58,4,5,3,12,Loyal
34347,141,15,3859.07,4,5,5,14,Champions
34348,251,10,1782.17,2,3,4,9,Regulars
34349,291,12,2949.13,2,4,5,11,At Risk
34350,613,9,1181.76,1,2,2,5,Hibernating
34351,444,7,2582.57,2,1,5,8,Regulars
34352,467,7,3014.85,1,1,5,7,Regulars
34353,235,12,1446.02,3,4,3,10,Regulars
34354,30,11,1253.51,5,3,3,11,Loyal
34355,434,10,3522.25,2,3,5,10,Regulars
34356,425,8,650.81,2,2,1,5,Hibernating
34357,899,9,2297.66,1,2,4,7,Regulars
34358,111,11,1247.42,4,3,3,10,Loyal
34359,391,11,1657.69,2,3,3,8,Regulars
34360,404,9,1983.18,2,2,4,8,Regulars
34361,34,10,799.13,5,3,1,9,Loyal
34362,205,6,635.86,3,1,1,5,Regulars
34363,52,14,2793.5600000000004,5,5,5,15,Champions
34364,202,16,1428.2,3,5,3,11,Regulars
34365,173,7,685.49,3,1,1,5,Regulars
34366,742,8,769.47,1,2,1,4,Hibernating
34367,574,9,1127.07,1,2,2,5,Hibernating
34368,103,12,837.69,4,4,1,9,Loyal
34369,218,7,644.7900000000001,3,1,1,5,Regulars
34370,57,21,3204.4700000000003,5,5,5,15,Champions
34371,426,11,1859.71,2,3,4,9,Regulars
34372,205,9,520.1800000000001,3,2,1,6,Regulars
34373,65,5,512.63,5,1,1,7,Regulars
34374,56,13,1035.53,5,4,2,11,Loyal
34375,10,13,2272.4300000000003,5,4,4,13,Champions
34376,69,12,2081.97,4,4,4,12,Champions
34377,27,9,1090.55,5,2,2,9,Regulars
34378,422,10,1032.6699999999998,2,3,2,7,Regulars
34379,61,9,877.03,5,2,2,9,Regulars
34380,245,14,1385.67,3,5,3,11,Regulars
34381,45,14,1800.86,5,5,4,14,Champions
34382,670,7,1019.01,1,1,2,4,Hibernating
34383,199,13,4689.58,3,4,5,12,Big Spenders
34384,42,7,787.01,5,1,1,7,Regulars
34385,66,9,1412.1,4,2,3,9,Regulars
34386,49,16,7116.84,5,5,5,15,Champions
34387,1163,10,843.7499999999999,1,3,1,5,Regulars
34388,311,8,528.35,2,2,1,5,Hibernating
34389,42,12,1886.67,5,4,4,13,Champions
34390,72,19,2587.6099999999997,4,5,5,14,Champions
34391,171,12,1740.12,3,4,4,11,Big Spenders
34392,180,5,696.55,3,1,1,5,Regulars
34393,405,6,706.38,2,1,1,4,Hibernating
34394,49,11,1452.83,5,3,3,11,Loyal
34395,1031,6,2434.04,1,1,4,6,Regulars
34396,90,8,398.17,4,2,1,7,Regulars
34397,192,9,1715.6599999999999,3,2,3,8,Regulars
34398,124,10,832.79,4,3,1,8,Loyal
34399,12,15,1856.82,5,5,4,14,Champions
34400,93,10,1345.62,4,3,3,10,Loyal
34401,64,8,2553.77,5,2,4,11,Big Spenders
34402,122,13,1961.39,4,4,4,12,Champions
34403,653,12,2013.11,1,4,4,9,At Risk
34404,122,19,2564.57,4,5,4,13,Champions
34405,420,15,2698.32,2,5,5,12,At Risk
34406,153,9,3183.3799999999997,3,2,5,10,Big Spenders
34407,220,12,2728.37,3,4,5,12,Big Spenders
34408,49,16,1464.59,5,5,3,13,Loyal
34409,21,15,4738.97,5,5,5,15,Champions
34410,20,13,1400.06,5,4,3,12,Loyal
34411,44,13,1617.6599999999999,5,4,3,12,Loyal
34412,183,9,1256.79,3,2,3,8,Regulars
34413,333,8,813.4899999999999,2,2,1,5,Hibernating
34414,193,9,738.72,3,2,1,6,Regulars
34415,165,10,661.28,3,3,1,7,Regulars
34416,16,8,1118.02,5,2,2,9,Regulars
34417,45,15,2722.8,5,5,5,15,Champions
34418,53,10,1196.01,5,3,2,10,Loyal
34419,270,10,1705.68,2,3,3,8,Regulars
34420,65,13,1940.8200000000002,5,4,4,13,Champions
34421,124,13,4048.4,4,4,5,13,Champions
34422,383,10,1526.67,2,3,3,8,Regulars
34423,130,9,772.06,4,2,1,7,Regulars
34424,19,11,1210.61,5,3,2,10,Loyal
34425,288,11,1502.75,2,3,3,8,Regulars
34426,341,8,1840.65,2,2,4,8,Regulars
34427,120,8,785.78,4,2,1,7,Regulars
34428,536,7,1212.3,1,1,2,4,Hibernating
34429,270,7,2140.56,2,1,4,7,Regulars
34430,6,9,1561.8100000000002,5,2,3,10,Regulars
34431,442,11,1307.0500000000002,2,3,3,8,Regulars
34432,13,11,2488.51,5,3,4,12,Loyal
34433,363,12,1351.97,2,4,3,9,At Risk
34434,520,11,1129.53,1,3,2,6,Regulars
34435,614,3,608.3499999999999,1,1,1,3,Hibernating
34436,95,15,4299.26,4,5,5,14,Champions
34437,152,9,984.24,3,2,2,7,Regulars
34438,556,7,850.06,1,1,2,4,Hibernating
34439,104,11,1420.63,4,3,3,10,Loyal
34440,86,9,1286.53,4,2,3,9,Regulars
34441,352,10,1232.79,2,3,2,7,Regulars
34442,647,8,429.17,1,2,1,4,Hibernating
34443,294,11,774.4,2,3,1,6,Regulars
34444,48,9,823.71,5,2,1,8,Regulars
34445,416,7,1213.8200000000002,2,1,2,5,Hibernating
34446,28,10,797.2,5,3,1,9,Loyal
34447,1489,8,1365.0,1,2,3,6,Regulars
34448,3,5,360.06,5,1,1,7,Regulars
34449,165,18,2875.2,3,5,5,13,Big Spenders
34450,367,10,4139.86,2,3,5,10,Regulars
34451,100,16,4721.82,4,5,5,14,Champions
34452,166,16,1747.65,3,5,4,12,Big Spenders
34453,319,12,3086.79,2,4,5,11,At Risk
34454,246,5,268.6,3,1,1,5,Regulars
34455,245,18,3699.3999999999996,3,5,5,13,Big Spenders
34456,263,8,1589.65,2,2,3,7,Regulars
34457,449,10,2111.94,2,3,4,9,Regulars
34458,434,7,2342.65,2,1,4,7,Regulars
34459,31,12,3919.54,5,4,5,14,Champions
34460,61,11,1021.86,5,3,2,10,Loyal
34461,223,13,848.64,3,4,2,9,Regulars
34462,90,10,933.73,4,3,2,9,Loyal
34463,228,6,1011.47,3,1,2,6,Regulars
34464,658,7,561.6,1,1,1,3,Hibernating
34465,154,14,3374.3799999999997,3,5,5,13,Big Spenders
34466,399,9,861.15,2,2,2,6,Hibernating
34467,44,15,3740.62,5,5,5,15,Champions
34468,666,7,580.15,1,1,1,3,Hibernating
34469,133,16,1743.26,4,5,4,13,Champions
34470,350,5,213.04000000000002,2,1,1,4,Hibernating
34471,72,7,656.53,4,1,1,6,Regulars
34472,57,13,2227.88,5,4,4,13,Champions
34473,218,8,514.94,3,2,1,6,Regulars
34474,180,11,3335.2400000000002,3,3,5,11,Big Spenders
34475,265,8,1312.38,2,2,3,7,Regulars
34476,540,8,843.35,1,2,1,4,Hibernating
34477,202,8,1101.51,3,2,2,7,Regulars
34478,947,7,451.0,1,1,1,3,Hibernating
34479,342,16,3374.56,2,5,5,12,At Risk
34480,64,15,4698.09,5,5,5,15,Champions
34481,326,15,2286.52,2,5,4,11,At Risk
34482,55,11,2440.92,5,3,4,12,Loyal
34483,306,10,845.73,2,3,2,7,Regulars
34484,778,7,1577.79,1,1,3,5,Regulars
34485,526,6,877.51,1,1,2,4,Hibernating
34486,114,7,2262.04,4,1,4,9,Big Spenders
34487,390,8,525.63,2,2,1,5,Hibernating
34488,217,11,4727.07,3,3,5,11,Big Spenders
34489,306,9,3158.1,2,2,5,9,Regulars
34490,2,8,3609.37,5,2,5,12,Big Spenders
34491,48,13,2108.42,5,4,4,13,Champions
34492,22,12,961.01,5,4,2,11,Loyal
34493,33,10,1424.3899999999999,5,3,3,11,Loyal
34494,236,14,3416.58,3,5,5,13,Big Spenders
34495,4,8,2108.71,5,2,4,11,Big Spenders
34496,194,10,1528.3999999999999,3,3,3,9,Regulars
34497,70,9,1275.58,4,2,3,9,Regulars
34498,20,13,1701.35,5,4,3,12,Loyal
34499,643,13,641.34,1,4,1,6,At Risk
34500,19,11,1999.6,5,3,4,12,Loyal
34501,23,3,616.23,5,1,1,7,Regulars
34502,23,19,4774.59,5,5,5,15,Champions
34503,894,9,1755.37,1,2,4,7,Regulars
34504,45,13,3651.1600000000003,5,4,5,14,Champions
34505,4,9,1290.12,5,2,3,10,Regulars
34506,42,9,640.4,5,2,1,8,Regulars
34507,502,5,538.92,1,1,1,3,Hibernating
34508,552,9,2957.43,1,2,5,8,Regulars
34509,195,4,908.1700000000001,3,1,2,6,Regulars
34510,209,8,490.76,3,2,1,6,Regulars
34511,331,10,1443.85,2,3,3,8,Regulars
34512,376,11,2507.38,2,3,4,9,Regulars
34513,133,7,1421.0099999999998,4,1,3,8,Regulars
34514,640,7,3791.59,1,1,5,7,Regulars
34515,379,7,776.91,2,1,1,4,Hibernating
34516,288,8,1060.42,2,2,2,6,Hibernating
34517,101,9,3100.75,4,2,5,11,Big Spenders
34518,249,6,600.35,2,1,1,4,Hibernating
34519,204,10,2690.2400000000002,3,3,5,11,Big Spenders
34520,684,10,2172.3,1,3,4,8,Regulars
34521,90,8,2289.66,4,2,4,10,Big Spenders
34522,120,13,1135.73,4,4,2,10,Loyal
34523,179,6,1125.6399999999999,3,1,2,6,Regulars
34524,740,8,845.8299999999999,1,2,2,5,Hibernating
34525,76,13,1473.45,4,4,3,11,Loyal
34526,182,9,1657.1,3,2,3,8,Regulars
34527,206,11,1195.84,3,3,2,8,Regulars
34528,228,8,1604.85,3,2,3,8,Regulars
34529,275,13,2667.04,2,4,5,11,At Risk
34530,38,10,2593.63,5,3,5,13,Loyal
34531,458,8,2017.16,2,2,4,8,Regulars
34532,338,7,890.26,2,1,2,5,Hibernating
34533,45,12,1845.67,5,4,4,13,Champions
34534,382,11,3128.59,2,3,5,10,Regulars
34535,18,8,352.13,5,2,1,8,Regulars
34536,65,12,5528.8,5,4,5,14,Champions
34537,84,9,3209.88,4,2,5,11,Big Spenders
34538,315,15,1092.93,2,5,2,9,At Risk
34539,431,5,491.56,2,1,1,4,Hibernating
34540,42,9,878.65,5,2,2,9,Regulars
34541,64,7,561.4000000000001,5,1,1,7,Regulars
34542,54,10,2489.25,5,3,4,12,Loyal
34543,57,10,3145.0,5,3,5,13,Loyal
34544,605,4,1109.65,1,1,2,4,Hibernating
34545,417,16,2091.1000000000004,2,5,4,11,At Risk
34546,469,14,3158.65,1,5,5,11,At Risk
34547,65,11,2571.8500000000004,5,3,4,12,Loyal
34548,188,10,2114.19,3,3,4,10,Big Spenders
34549,358,10,3236.1300000000006,2,3,5,10,Regulars
34550,358,11,1712.31,2,3,3,8,Regulars
34551,331,7,1493.0199999999998,2,1,3,6,Regulars
34552,125,9,630.97,4,2,1,7,Regulars
34553,121,8,1117.54,4,2,2,8,Regulars
34554,143,8,1774.19,4,2,4,10,Big Spenders
34555,1613,5,535.45,1,1,1,3,Hibernating
34556,29,11,3194.48,5,3,5,13,Loyal
34557,38,11,1776.71,5,3,4,12,Loyal
34558,477,9,1408.52,1,2,3,6,Regulars
34559,188,12,1391.05,3,4,3,10,Regulars
34560,164,9,979.4000000000001,3,2,2,7,Regulars
34561,351,4,177.59999999999997,2,1,1,4,Hibernating
34562,170,12,6096.18,3,4,5,12,Big Spenders
34563,50,7,3040.16,5,1,5,11,Big Spenders
34564,140,8,863.99,4,2,2,8,Regulars
34565,455,12,3130.69,2,4,5,11,At Risk
34566,329,5,622.27,2,1,1,4,Hibernating
34567,25,13,1270.69,5,4,3,12,Loyal
34568,290,16,2875.91,2,5,5,12,At Risk
34569,385,12,4206.53,2,4,5,11,At Risk
34570,402,8,983.19,2,2,2,6,Hibernating
34571,112,13,1319.5700000000002,4,4,3,11,Loyal
34572,196,8,1468.61,3,2,3,8,Regulars
34573,5,15,2630.65,5,5,5,15,Champions
34574,730,10,927.91,1,3,2,6,Regulars
34575,222,9,1780.64,3,2,4,9,Big Spenders
34576,103,8,1264.13,4,2,3,9,Regulars
34577,486,14,1673.4,1,5,3,9,At Risk
34578,253,11,1597.73,2,3,3,8,Regulars
34579,189,10,2424.79,3,3,4,10,Big Spenders
34580,122,14,4102.67,4,5,5,14,Champions
34581,154,12,1851.9099999999999,3,4,4,11,Big Spenders
34582,167,12,1808.0700000000002,3,4,4,11,Big Spenders
34583,815,8,852.79,1,2,2,5,Hibernating
34584,436,9,1463.21,2,2,3,7,Regulars
34585,730,10,5463.6900000000005,1,3,5,9,Regulars
34586,219,6,2006.37,3,1,4,8,Big Spenders
34587,451,11,1639.36,2,3,3,8,Regulars
34588,8,10,1444.28,5,3,3,11,Loyal
34589,236,7,845.91,3,1,2,6,Regulars
34590,33,7,1007.3399999999999,5,1,2,8,Regulars
34591,37,10,582.8,5,3,1,9,Loyal
34592,50,12,1629.8899999999999,5,4,3,12,Loyal
34593,601,6,3325.04,1,1,5,7,Regulars
34594,468,9,930.28,1,2,2,5,Hibernating
34595,89,9,3268.2,4,2,5,11,Big Spenders
34596,15,15,1974.62,5,5,4,14,Champions
34597,524,4,1330.47,1,1,3,5,Regulars
34598,323,9,1316.24,2,2,3,7,Regulars
34599,211,11,2493.69,3,3,4,10,Big Spenders
34600,37,12,2014.77,5,4,4,13,Champions
34601,152,10,1393.93,3,3,3,9,Regulars
34602,56,13,1538.01,5,4,3,12,Loyal
34603,101,10,1018.21,4,3,2,9,Loyal
34604,113,8,2039.1399999999999,4,2,4,10,Big Spenders
34605,1245,5,560.23,1,1,1,3,Hibernating
34606,247,13,4449.08,3,4,5,12,Big Spenders
34607,183,4,442.28,3,1,1,5,Regulars
34608,160,9,1019.32,3,2,2,7,Regulars
34609,450,11,1957.06,2,3,4,9,Regulars
34610,106,12,1655.04,4,4,3,11,Loyal
34611,311,11,1087.6399999999999,2,3,2,7,Regulars
34612,568,17,2074.84,1,5,4,10,At Risk
34613,111,10,3062.6299999999997,4,3,5,12,Loyal
34614,283,20,2581.39,2,5,5,12,At Risk
34615,14,13,1765.27,5,4,4,13,Champions
34616,236,7,2001.41,3,1,4,8,Big Spenders
34617,61,18,2929.0499999999997,5,5,5,15,Champions
34618,81,9,439.48,4,2,1,7,Regulars
34619,16,10,1669.1399999999999,5,3,3,11,Loyal
34620,920,14,2466.13,1,5,4,10,At Risk
34621,593,13,1734.81,1,4,4,9,At Risk
34622,741,8,3792.95,1,2,5,8,Regulars
34623,323,13,1780.6599999999999,2,4,4,10,At Risk
34624,792,8,1718.0700000000002,1,2,3,6,Regulars
34625,124,9,2476.3,4,2,4,10,Big Spenders
34626,138,10,2696.89,4,3,5,12,Loyal
34627,362,7,1492.44,2,1,3,6,Regulars
34628,417,7,569.43,2,1,1,4,Hibernating
34629,482,7,1054.7800000000002,1,1,2,4,Hibernating
34630,41,9,2284.33,5,2,4,11,Big Spenders
34631,177,6,852.26,3,1,2,6,Regulars
34632,152,9,585.84,3,2,1,6,Regulars
34633,209,12,1343.54,3,4,3,10,Regulars
34634,502,15,4546.93,1,5,5,11,At Risk
34635,590,7,1549.74,1,1,3,5,Regulars
34636,335,9,2829.2,2,2,5,9,Regulars
34637,821,9,1062.67,1,2,2,5,Hibernating
34638,3,9,1391.91,5,2,3,10,Regulars
34639,578,11,1361.06,1,3,3,7,Regulars
34640,503,14,2431.73,1,5,4,10,At Risk
34641,257,6,477.64,2,1,1,4,Hibernating
34642,331,11,1377.32,2,3,3,8,Regulars
34643,111,16,1182.79,4,5,2,11,Loyal
34644,83,11,1052.43,4,3,2,9,Loyal
34645,100,9,1249.77,4,2,3,9,Regulars
34646,495,8,1562.95,1,2,3,6,Regulars
34647,334,11,3118.9399999999996,2,3,5,10,Regulars
34648,1050,10,669.42,1,3,1,5,Regulars
34649,178,14,2370.0600000000004,3,5,4,12,Big Spenders
34650,120,7,568.58,4,1,1,6,Regulars
34651,308,7,881.3999999999999,2,1,2,5,Hibernating
34652,404,9,1016.63,2,2,2,6,Hibernating
34653,6,17,3887.33,5,5,5,15,Champions
34654,31,11,1684.93,5,3,3,11,Loyal
34655,147,19,1662.93,4,5,3,12,Loyal
34656,1196,5,741.24,1,1,1,3,Hibernating
34657,12,11,1334.96,5,3,3,11,Loyal
34658,101,7,807.95,4,1,1,6,Regulars
34659,90,5,1712.37,4,1,3,8,Regulars
34660,113,13,1188.57,4,4,2,10,Loyal
34661,440,12,1567.0700000000002,2,4,3,9,At Risk
34662,19,12,1421.82,5,4,3,12,Loyal
34663,7,7,650.08,5,1,1,7,Regulars
34664,101,8,1188.9,4,2,2,8,Regulars
34665,91,14,2379.62,4,5,4,13,Champions
34666,41,10,1671.34,5,3,3,11,Loyal
34667,125,14,1556.72,4,5,3,12,Loyal
34668,503,7,761.33,1,1,1,3,Hibernating
34669,66,8,783.59,4,2,1,7,Regulars
34670,1031,11,1313.04,1,3,3,7,Regulars
34671,272,18,3013.86,2,5,5,12,At Risk
34672,170,11,1347.6100000000001,3,3,3,9,Regulars
34673,333,10,806.0799999999999,2,3,1,6,Regulars
34674,649,10,2718.0,1,3,5,9,Regulars
34675,8,12,2459.66,5,4,4,13,Champions
34676,202,6,877.53,3,1,2,6,Regulars
34677,719,11,925.64,1,3,2,6,Regulars
34678,696,9,1313.87,1,2,3,6,Regulars
34679,57,8,1564.69,5,2,3,10,Regulars
34680,298,5,661.54,2,1,1,4,Hibernating
34681,28,11,2281.76,5,3,4,12,Loyal
34682,351,9,1848.7099999999998,2,2,4,8,Regulars
34683,261,14,1721.1299999999999,2,5,3,10,At Risk
34684,44,12,1448.84,5,4,3,12,Loyal
34685,49,9,1597.65,5,2,3,10,Regulars
34686,78,11,2233.94,4,3,4,11,Loyal
34687,372,11,4745.790000000001,2,3,5,10,Regulars
34688,308,13,3706.5499999999997,2,4,5,11,At Risk
34689,310,16,1872.99,2,5,4,11,At Risk
34690,48,10,5026.27,5,3,5,13,Loyal
34691,166,8,1377.35,3,2,3,8,Regulars
34692,250,13,2203.69,2,4,4,10,At Risk
34693,197,12,1436.29,3,4,3,10,Regulars
34694,61,8,1141.15,5,2,2,9,Regulars
34695,156,10,3253.1600000000003,3,3,5,11,Big Spenders
34696,56,9,1021.46,5,2,2,9,Regulars
34697,288,11,1306.48,2,3,3,8,Regulars
34698,17,9,282.12,5,2,1,8,Regulars
34699,696,6,256.5,1,1,1,3,Hibernating
34700,359,13,1175.7300000000002,2,4,2,8,At Risk
34701,277,9,1314.49,2,2,3,7,Regulars
34702,889,6,1336.81,1,1,3,5,Regulars
34703,153,7,2256.7,3,1,4,8,Big Spenders
34704,84,5,561.05,4,1,1,6,Regulars
34705,150,10,2297.37,3,3,4,10,Big Spenders
34706,127,8,1341.0,4,2,3,9,Regulars
34707,113,4,528.38,4,1,1,6,Regulars
34708,402,10,722.09,2,3,1,6,Regulars
34709,161,15,1819.29,3,5,4,12,Big Spenders
34710,376,9,1411.91,2,2,3,7,Regulars
34711,149,7,1368.83,3,1,3,7,Regulars
34712,220,10,761.47,3,3,1,7,Regulars
34713,633,17,1205.91,1,5,2,8,At Risk
34714,86,8,733.84,4,2,1,7,Regulars
34715,98,7,1690.36,4,1,3,8,Regulars
34716,141,13,1628.19,4,4,3,11,Loyal
34717,131,9,2051.59,4,2,4,10,Big Spenders
34718,553,7,656.56,1,1,1,3,Hibernating
34719,0,15,1661.31,5,5,3,13,Loyal
34720,105,11,1205.6,4,3,2,9,Loyal
34721,50,10,3950.15,5,3,5,13,Loyal
34722,390,9,3945.71,2,2,5,9,Regulars
34723,135,9,1885.06,4,2,4,10,Big Spenders
34724,19,11,1154.65,5,3,2,10,Loyal
34725,131,9,1977.81,4,2,4,10,Big Spenders
34726,2,19,2695.7999999999997,5,5,5,15,Champions
34727,202,10,1067.66,3,3,2,8,Regulars
34728,347,6,1171.77,2,1,2,5,Hibernating
34729,113,10,1420.6499999999999,4,3,3,10,Loyal
34730,29,8,2442.0,5,2,4,11,Big Spenders
34731,104,16,7879.41,4,5,5,14,Champions
34732,222,6,4117.74,3,1,5,9,Big Spenders
34733,28,9,1191.4099999999999,5,2,2,9,Regulars
34734,287,10,3575.7400000000002,2,3,5,10,Regulars
34735,531,10,2166.99,1,3,4,8,Regulars
34736,173,11,1236.21,3,3,2,8,Regulars
34737,125,12,1584.12,4,4,3,11,Loyal
34738,66,7,753.18,4,1,1,6,Regulars
34739,611,9,1899.28,1,2,4,7,Regulars
34740,786,9,2357.63,1,2,4,7,Regulars
34741,305,12,3054.97,2,4,5,11,At Risk
34742,392,11,1487.21,2,3,3,8,Regulars
34743,29,5,402.4,5,1,1,7,Regulars
34744,528,7,1215.43,1,1,2,4,Hibernating
34745,4,19,4967.49,5,5,5,15,Champions
34746,225,19,2078.28,3,5,4,12,Big Spenders
34747,298,9,2944.4299999999994,2,2,5,9,Regulars
34748,160,14,2006.85,3,5,4,12,Big Spenders
34749,674,9,704.54,1,2,1,4,Hibernating
34750,512,12,1739.5,1,4,4,9,At Risk
34751,48,8,2507.4700000000003,5,2,4,11,Big Spenders
34752,355,17,1401.46,2,5,3,10,At Risk
34753,721,8,2559.2,1,2,4,7,Regulars
34754,577,12,1491.31,1,4,3,8,At Risk
34755,374,9,778.69,2,2,1,5,Hibernating
34756,7,10,980.0300000000001,5,3,2,10,Loyal
34757,395,10,1202.8,2,3,2,7,Regulars
34758,175,18,4585.96,3,5,5,13,Big Spenders
34759,391,13,2240.54,2,4,4,10,At Risk
34760,76,11,827.0799999999999,4,3,1,8,Loyal
34761,208,15,1505.42,3,5,3,11,Regulars
34762,1386,9,1900.5800000000002,1,2,4,7,Regulars
34763,111,14,1665.28,4,5,3,12,Loyal
34764,319,11,686.59,2,3,1,6,Regulars
34765,132,5,718.79,4,1,1,6,Regulars
34766,89,7,3100.1,4,1,5,10,Big Spenders
34767,464,11,2347.5099999999998,1,3,4,8,Regulars
34768,2,19,3158.96,5,5,5,15,Champions
34769,42,11,1535.77,5,3,3,11,Loyal
34770,1040,5,595.3399999999999,1,1,1,3,Hibernating
34771,358,9,1438.35,2,2,3,7,Regulars
34772,0,6,758.69,5,1,1,7,Regulars
34773,316,8,941.19,2,2,2,6,Hibernating
34774,65,5,331.29,5,1,1,7,Regulars
34775,316,9,2552.3900000000003,2,2,4,8,Regulars
34776,228,9,585.85,3,2,1,6,Regulars
34777,629,8,762.08,1,2,1,4,Hibernating
34778,439,13,1451.24,2,4,3,9,At Risk
34779,490,9,962.05,1,2,2,5,Hibernating
34780,58,15,1018.58,5,5,2,12,Loyal
34781,52,12,2019.4399999999998,5,4,4,13,Champions
34782,526,6,929.4599999999999,1,1,2,4,Hibernating
34783,16,17,3551.3399999999997,5,5,5,15,Champions
34784,10,12,884.3,5,4,2,11,Loyal
34785,47,12,1861.54,5,4,4,13,Champions
34786,7,7,980.65,5,1,2,8,Regulars
34787,110,15,2445.6,4,5,4,13,Champions
34788,94,10,3427.55,4,3,5,12,Loyal
34789,44,11,623.1800000000001,5,3,1,9,Loyal
34790,1310,8,869.18,1,2,2,5,Hibernating
34791,540,8,2634.27,1,2,5,8,Regulars
34792,942,10,607.0600000000001,1,3,1,5,Regulars
34793,158,7,636.85,3,1,1,5,Regulars
34794,872,14,3343.84,1,5,5,11,At Risk
34795,992,8,727.23,1,2,1,4,Hibernating
34796,1252,8,1094.92,1,2,2,5,Hibernating
34797,245,9,1079.57,3,2,2,7,Regulars
34798,361,9,582.11,2,2,1,5,Hibernating
34799,226,14,3108.91,3,5,5,13,Big Spenders
34800,190,13,1191.15,3,4,2,9,Regulars
34801,1109,8,1906.55,1,2,4,7,Regulars
34802,178,10,1354.75,3,3,3,9,Regulars
34803,87,12,3056.06,4,4,5,13,Champions
34804,148,12,1107.82,3,4,2,9,Regulars
34805,348,11,3264.31,2,3,5,10,Regulars
34806,47,9,1165.76,5,2,2,9,Regulars
34807,273,8,1415.4,2,2,3,7,Regulars
34808,1046,9,1107.99,1,2,2,5,Hibernating
34809,248,11,2809.18,2,3,5,10,Regulars
34810,81,7,1461.59,4,1,3,8,Regulars
34811,315,7,1635.26,2,1,3,6,Regulars
34812,212,9,1599.0,3,2,3,8,Regulars
34813,262,8,1252.3200000000002,2,2,3,7,Regulars
34814,261,11,1052.41,2,3,2,7,Regulars
34815,274,5,471.29,2,1,1,4,Hibernating
34816,199,11,1841.0500000000002,3,3,4,10,Big Spenders
34817,656,12,3303.2599999999998,1,4,5,10,At Risk
34818,155,9,1344.0700000000002,3,2,3,8,Regulars
34819,23,6,830.6600000000001,5,1,1,7,Regulars
34820,205,10,1917.08,3,3,4,10,Big Spenders
34821,61,9,672.5500000000001,5,2,1,8,Regulars
34822,333,7,679.97,2,1,1,4,Hibernating
34823,231,4,497.65000000000003,3,1,1,5,Regulars
34824,78,6,1610.28,4,1,3,8,Regulars
34825,301,11,2400.66,2,3,4,9,Regulars
34826,50,12,3085.27,5,4,5,14,Champions
34827,335,7,2044.06,2,1,4,7,Regulars
34828,88,12,1387.28,4,4,3,11,Loyal
34829,220,11,2150.72,3,3,4,10,Big Spenders
34830,74,5,3122.29,4,1,5,10,Big Spenders
34831,1052,12,3464.3500000000004,1,4,5,10,At Risk
34832,9,15,3548.5,5,5,5,15,Champions
34833,561,10,638.21,1,3,1,5,Regulars
34834,156,5,1170.88,3,1,2,6,Regulars
34835,26,11,1108.48,5,3,2,10,Loyal
34836,279,7,550.95,2,1,1,4,Hibernating
34837,64,8,955.39,5,2,2,9,Regulars
34838,107,11,955.3299999999999,4,3,2,9,Loyal
34839,522,8,255.61,1,2,1,4,Hibernating
34840,216,12,3415.5,3,4,5,12,Big Spenders
34841,113,10,2194.9,4,3,4,11,Loyal
34842,153,7,3188.5899999999997,3,1,5,9,Big Spenders
34843,9,15,4528.33,5,5,5,15,Champions
34844,38,14,2597.76,5,5,5,15,Champions
34845,4,8,970.79,5,2,2,9,Regulars
34846,151,9,1163.45,3,2,2,7,Regulars
34847,313,8,940.24,2,2,2,6,Hibernating
34848,209,13,3242.62,3,4,5,12,Big Spenders
34849,337,7,845.87,2,1,2,5,Hibernating
34850,160,5,963.7700000000002,3,1,2,6,Regulars
34851,69,14,4039.2200000000003,4,5,5,14,Champions
34852,6,8,642.53,5,2,1,8,Regulars
34853,520,12,1420.69,1,4,3,8,At Risk
34854,231,10,785.25,3,3,1,7,Regulars
34855,247,11,1513.02,3,3,3,9,Regulars
34856,1048,6,1557.45,1,1,3,5,Regulars
34857,484,13,2299.66,1,4,4,9,At Risk
34858,322,4,361.97999999999996,2,1,1,4,Hibernating
34859,90,8,818.85,4,2,1,7,Regulars
34860,6,20,4523.62,5,5,5,15,Champions
34861,118,12,876.36,4,4,2,10,Loyal
34862,433,8,584.9,2,2,1,5,Hibernating
34863,551,10,1714.58,1,3,3,7,Regulars
34864,66,10,1608.41,4,3,3,10,Loyal
34865,155,11,1644.2399999999998,3,3,3,9,Regulars
34866,292,7,1855.89,2,1,4,7,Regulars
34867,567,10,1130.75,1,3,2,6,Regulars
34868,517,9,2294.09,1,2,4,7,Regulars
34869,361,13,944.47,2,4,2,8,At Risk
34870,383,14,1103.22,2,5,2,9,At Risk
34871,227,11,1363.3500000000001,3,3,3,9,Regulars
34872,403,11,1823.5700000000002,2,3,4,9,Regulars
34873,37,16,4295.94,5,5,5,15,Champions
34874,25,14,2471.26,5,5,4,14,Champions
34875,492,11,1873.44,1,3,4,8,Regulars
34876,2,10,5225.78,5,3,5,13,Loyal
34877,189,4,530.01,3,1,1,5,Regulars
34878,404,7,659.93,2,1,1,4,Hibernating
34879,523,7,2804.65,1,1,5,7,Regulars
34880,238,9,1536.2800000000002,3,2,3,8,Regulars
34881,12,8,2587.79,5,2,5,12,Big Spenders
34882,89,12,2415.88,4,4,4,12,Champions
34883,119,9,2622.42,4,2,5,11,Big Spenders
34884,38,10,1563.12,5,3,3,11,Loyal
34885,68,14,1889.3400000000001,4,5,4,13,Champions
34886,94,7,516.55,4,1,1,6,Regulars
34887,18,12,1848.42,5,4,4,13,Champions
34888,68,11,4040.55,4,3,5,12,Loyal
34889,142,10,788.5999999999999,4,3,1,8,Loyal
34890,245,4,814.57,3,1,1,5,Regulars
34891,403,6,546.4100000000001,2,1,1,4,Hibernating
34892,717,10,4060.9199999999996,1,3,5,9,Regulars
34893,734,7,419.19,1,1,1,3,Hibernating
34894,241,10,779.67,3,3,1,7,Regulars
34895,103,12,1727.8899999999999,4,4,4,12,Champions
34896,32,13,1577.19,5,4,3,12,Loyal
34897,1375,9,784.6999999999999,1,2,1,4,Hibernating
34898,1223,5,3702.36,1,1,5,7,Regulars
34899,16,8,651.78,5,2,1,8,Regulars
34900,1478,3,585.25,1,1,1,3,Hibernating
34901,269,8,627.52,2,2,1,5,Hibernating
34902,211,11,1243.31,3,3,3,9,Regulars
34903,101,11,2521.59,4,3,4,11,Loyal
34904,3,5,1960.79,5,1,4,10,Big Spenders
34905,8,11,2967.38,5,3,5,13,Loyal
34906,21,6,1860.8899999999999,5,1,4,10,Big Spenders
34907,382,13,5081.87,2,4,5,11,At Risk
34908,175,10,1128.15,3,3,2,8,Regulars
34909,19,13,4306.41,5,4,5,14,Champions
34910,1029,7,403.41999999999996,1,1,1,3,Hibernating
34911,466,10,1729.48,1,3,4,8,Regulars
34912,36,8,1132.8600000000001,5,2,2,9,Regulars
34913,84,12,1113.66,4,4,2,10,Loyal
34914,90,13,1227.27,4,4,2,10,Loyal
34915,492,10,1256.6799999999998,1,3,3,7,Regulars
34916,307,10,793.12,2,3,1,6,Regulars
34917,528,8,792.69,1,2,1,4,Hibernating
34918,285,6,2674.0,2,1,5,8,Regulars
34919,308,12,3029.1,2,4,5,11,At Risk
34920,408,15,5855.27,2,5,5,12,At Risk
34921,377,16,2954.5299999999997,2,5,5,12,At Risk
34922,234,10,792.08,3,3,1,7,Regulars
34923,231,10,3632.1600000000003,3,3,5,11,Big Spenders
34924,128,8,717.3299999999999,4,2,1,7,Regulars
34925,279,10,1044.61,2,3,2,7,Regulars
34926,243,11,1485.27,3,3,3,9,Regulars
34927,453,9,3858.4300000000003,2,2,5,9,Regulars
34928,302,15,1296.25,2,5,3,10,At Risk
34929,87,15,5505.2699999999995,4,5,5,14,Champions
34930,110,15,1611.69,4,5,3,12,Loyal
34931,65,7,596.13,5,1,1,7,Regulars
34932,140,11,770.34,4,3,1,8,Loyal
34933,75,10,1770.49,4,3,4,11,Loyal
34934,39,14,2398.42,5,5,4,14,Champions
34935,693,9,1379.06,1,2,3,6,Regulars
34936,128,8,1381.6399999999999,4,2,3,9,Regulars
34937,9,13,1149.99,5,4,2,11,Loyal
34938,106,11,1686.33,4,3,3,10,Loyal
34939,69,12,1868.38,4,4,4,12,Champions
34940,96,11,1483.88,4,3,3,10,Loyal
34941,170,9,983.13,3,2,2,7,Regulars
34942,159,8,670.62,3,2,1,6,Regulars
34943,132,12,1933.75,4,4,4,12,Champions
34944,631,7,924.82,1,1,2,4,Hibernating
34945,506,9,772.36,1,2,1,4,Hibernating
34946,94,7,2327.7000000000003,4,1,4,9,Big Spenders
34947,154,9,2454.6400000000003,3,2,4,9,Big Spenders
34948,207,13,2158.09,3,4,4,11,Big Spenders
34949,332,7,1894.3700000000001,2,1,4,7,Regulars
34950,150,7,1265.96,3,1,3,7,Regulars
34951,101,7,655.52,4,1,1,6,Regulars
34952,492,4,703.3,1,1,1,3,Hibernating
34953,242,13,2140.64,3,4,4,11,Big Spenders
34954,196,11,1001.93,3,3,2,8,Regulars
34955,38,12,2163.4900000000002,5,4,4,13,Champions
34956,274,17,2187.58,2,5,4,11,At Risk
34957,835,6,1752.26,1,1,4,6,Regulars
34958,4,9,675.03,5,2,1,8,Regulars
34959,309,9,1952.41,2,2,4,8,Regulars
34960,169,11,1742.57,3,3,4,10,Big Spenders
34961,486,12,707.04,1,4,1,6,At Risk
34962,231,7,791.82,3,1,1,5,Regulars
34963,512,11,759.1,1,3,1,5,Regulars
34964,48,11,1513.39,5,3,3,11,Loyal
34965,104,12,2186.85,4,4,4,12,Champions
34966,17,10,1493.02,5,3,3,11,Loyal
34967,37,8,1086.42,5,2,2,9,Regulars
34968,162,13,1458.22,3,4,3,10,Regulars
34969,78,9,1982.07,4,2,4,10,Big Spenders
34970,475,6,896.28,1,1,2,4,Hibernating
34971,453,10,1531.53,2,3,3,8,Regulars
34972,625,6,417.9,1,1,1,3,Hibernating
34973,93,9,973.13,4,2,2,8,Regulars
34974,66,11,1207.84,4,3,2,9,Loyal
34975,803,6,718.8100000000001,1,1,1,3,Hibernating
34976,124,14,1602.85,4,5,3,12,Loyal
34977,158,7,397.21,3,1,1,5,Regulars
34978,605,15,2833.52,1,5,5,11,At Risk
34979,146,12,4067.52,4,4,5,13,Champions
34980,520,6,562.8,1,1,1,3,Hibernating
34981,123,16,6314.63,4,5,5,14,Champions
34982,88,13,897.76,4,4,2,10,Loyal
34983,341,10,1235.96,2,3,2,7,Regulars
34984,109,10,955.9,4,3,2,9,Loyal
34985,80,6,302.82,4,1,1,6,Regulars
34986,99,13,4548.110000000001,4,4,5,13,Champions
34987,190,14,1848.01,3,5,4,12,Big Spenders
34988,545,6,615.91,1,1,1,3,Hibernating
34989,166,12,1742.1599999999999,3,4,4,11,Big Spenders
34990,169,8,1056.02,3,2,2,7,Regulars
34991,537,9,1196.3100000000002,1,2,2,5,Hibernating
34992,271,11,1855.27,2,3,4,9,Regulars
34993,603,9,2613.97,1,2,5,8,Regulars
34994,0,20,1943.04,5,5,4,14,Champions
34995,194,15,2136.0899999999997,3,5,4,12,Big Spenders
34996,217,17,1682.54,3,5,3,11,Regulars
34997,441,10,1162.01,2,3,2,7,Regulars
34998,95,11,1763.55,4,3,4,11,Loyal
34999,1228,9,835.5600000000001,1,2,1,4,Hibernating
35000,166,8,694.79,3,2,1,6,Regulars
35001,455,10,1112.51,2,3,2,7,Regulars
35002,263,15,3010.2,2,5,5,12,At Risk
35003,184,12,1877.6200000000001,3,4,4,11,Big Spenders
35004,183,13,1243.68,3,4,3,10,Regulars
35005,180,7,739.66,3,1,1,5,Regulars
35006,335,12,2164.6,2,4,4,10,At Risk
35007,437,6,806.6099999999999,2,1,1,4,Hibernating
35008,132,13,1176.66,4,4,2,10,Loyal
35009,106,7,2055.24,4,1,4,9,Big Spenders
35010,324,15,1006.37,2,5,2,9,At Risk
35011,311,10,3749.48,2,3,5,10,Regulars
35012,592,13,1328.42,1,4,3,8,At Risk
35013,138,7,3326.29,4,1,5,10,Big Spenders
35014,16,13,1707.02,5,4,3,12,Loyal
35015,833,11,1471.94,1,3,3,7,Regulars
35016,219,11,2741.52,3,3,5,11,Big Spenders
35017,133,15,2054.85,4,5,4,13,Champions
35018,505,9,3142.93,1,2,5,8,Regulars
35019,358,9,919.52,2,2,2,6,Hibernating
35020,2,7,449.74,5,1,1,7,Regulars
35021,430,11,2312.77,2,3,4,9,Regulars
35022,878,10,991.87,1,3,2,6,Regulars
35023,812,6,920.51,1,1,2,4,Hibernating
35024,121,18,4295.82,4,5,5,14,Champions
35025,600,11,1256.8,1,3,3,7,Regulars
35026,397,16,4935.3,2,5,5,12,At Risk
35027,294,13,3065.33,2,4,5,11,At Risk
35028,45,13,3630.3,5,4,5,14,Champions
35029,1331,9,1273.43,1,2,3,6,Regulars
35030,854,6,391.53,1,1,1,3,Hibernating
35031,269,15,2007.1999999999998,2,5,4,11,At Risk
35032,84,10,1090.04,4,3,2,9,Loyal
35033,298,9,1084.8,2,2,2,6,Hibernating
35034,160,9,1841.1100000000001,3,2,4,9,Big Spenders
35035,656,10,954.77,1,3,2,6,Regulars
35036,30,13,5474.009999999999,5,4,5,14,Champions
35037,139,11,1580.7800000000002,4,3,3,10,Loyal
35038,162,13,1595.12,3,4,3,10,Regulars
35039,18,9,1745.8000000000002,5,2,4,11,Big Spenders
35040,185,10,3091.6099999999997,3,3,5,11,Big Spenders
35041,218,12,1171.01,3,4,2,9,Regulars
35042,62,11,976.02,5,3,2,10,Loyal
35043,933,7,2282.8599999999997,1,1,4,6,Regulars
35044,644,8,1597.0700000000002,1,2,3,6,Regulars
35045,656,7,1256.44,1,1,3,5,Regulars
35046,226,11,830.8199999999999,3,3,1,7,Regulars
35047,268,9,2440.01,2,2,4,8,Regulars
35048,366,11,1383.3799999999999,2,3,3,8,Regulars
35049,138,10,3729.64,4,3,5,12,Loyal
35050,314,10,827.47,2,3,1,6,Regulars
35051,90,10,808.2,4,3,1,8,Loyal
35052,73,13,2549.04,4,4,4,12,Champions
35053,6,15,1294.13,5,5,3,13,Loyal
35054,25,11,1238.93,5,3,2,10,Loyal
35055,974,6,1394.06,1,1,3,5,Regulars
35056,40,13,2008.98,5,4,4,13,Champions
35057,105,13,2536.5,4,4,4,12,Champions
35058,278,8,3421.1800000000003,2,2,5,9,Regulars
35059,85,18,2764.2599999999998,4,5,5,14,Champions
35060,224,6,903.2900000000001,3,1,2,6,Regulars
35061,343,9,799.9,2,2,1,5,Hibernating
35062,203,9,1151.6599999999999,3,2,2,7,Regulars
35063,75,11,820.94,4,3,1,8,Loyal
35064,498,8,2154.57,1,2,4,7,Regulars
35065,465,7,530.9300000000001,1,1,1,3,Hibernating
35066,443,10,1207.01,2,3,2,7,Regulars
35067,225,10,1429.35,3,3,3,9,Regulars
35068,978,6,1391.49,1,1,3,5,Regulars
35069,68,12,3071.27,4,4,5,13,Champions
35070,153,12,1158.99,3,4,2,9,Regulars
35071,333,8,2432.98,2,2,4,8,Regulars
35072,232,7,783.81,3,1,1,5,Regulars
35073,2,9,1140.1,5,2,2,9,Regulars
35074,274,13,2033.09,2,4,4,10,At Risk
35075,74,16,4966.74,4,5,5,14,Champions
35076,12,16,2242.76,5,5,4,14,Champions
35077,110,14,1917.2899999999997,4,5,4,13,Champions
35078,14,12,2645.19,5,4,5,14,Champions
35079,337,9,2681.63,2,2,5,9,Regulars
35080,107,15,7205.599999999999,4,5,5,14,Champions
35081,120,15,1635.75,4,5,3,12,Loyal
35082,68,9,1070.77,4,2,2,8,Regulars
35083,148,10,4989.57,3,3,5,11,Big Spenders
35084,33,12,2048.35,5,4,4,13,Champions
35085,357,7,1802.1599999999999,2,1,4,7,Regulars
35086,375,4,171.92,2,1,1,4,Hibernating
35087,583,6,1044.99,1,1,2,4,Hibernating
35088,107,16,5644.110000000001,4,5,5,14,Champions
35089,429,7,914.29,2,1,2,5,Hibernating
35090,108,9,420.53999999999996,4,2,1,7,Regulars
35091,300,7,663.55,2,1,1,4,Hibernating
35092,165,10,1438.78,3,3,3,9,Regulars
35093,122,13,1685.13,4,4,3,11,Loyal
35094,124,6,752.54,4,1,1,6,Regulars
35095,50,15,2579.59,5,5,5,15,Champions
35096,1082,3,340.23999999999995,1,1,1,3,Hibernating
35097,370,15,4512.639999999999,2,5,5,12,At Risk
35098,208,12,2113.05,3,4,4,11,Big Spenders
35099,266,12,853.58,2,4,2,8,At Risk
35100,27,17,3366.35,5,5,5,15,Champions
35101,208,8,705.85,3,2,1,6,Regulars
35102,159,9,1229.1799999999998,3,2,2,7,Regulars
35103,139,6,323.06,4,1,1,6,Regulars
35104,65,15,1239.68,5,5,2,12,Loyal
35105,1047,6,1132.01,1,1,2,4,Hibernating
35106,144,10,2332.53,4,3,4,11,Loyal
35107,76,13,1566.77,4,4,3,11,Loyal
35108,606,4,1168.47,1,1,2,4,Hibernating
35109,150,9,769.5,3,2,1,6,Regulars
35110,224,14,1249.17,3,5,3,11,Regulars
35111,50,7,1012.23,5,1,2,8,Regulars
35112,156,17,1537.06,3,5,3,11,Regulars
35113,28,10,2451.05,5,3,4,12,Loyal
35114,318,12,1510.17,2,4,3,9,At Risk
35115,73,7,576.93,4,1,1,6,Regulars
35116,311,8,1274.26,2,2,3,7,Regulars
35117,568,8,707.78,1,2,1,4,Hibernating
35118,810,7,843.9399999999999,1,1,1,3,Hibernating
35119,52,15,2301.34,5,5,4,14,Champions
35120,536,11,2341.83,1,3,4,8,Regulars
35121,427,8,1537.42,2,2,3,7,Regulars
35122,531,12,1322.9099999999999,1,4,3,8,At Risk
35123,128,10,2300.07,4,3,4,11,Loyal
35124,1049,7,903.45,1,1,2,4,Hibernating
35125,65,15,2156.32,5,5,4,14,Champions
35126,348,6,1287.79,2,1,3,6,Regulars
35127,157,8,1081.99,3,2,2,7,Regulars
35128,127,6,350.25,4,1,1,6,Regulars
35129,432,10,1170.91,2,3,2,7,Regulars
35130,604,10,757.29,1,3,1,5,Regulars
35131,60,8,2391.92,5,2,4,11,Big Spenders
35132,193,15,1264.81,3,5,3,11,Regulars
35133,733,8,667.81,1,2,1,4,Hibernating
35134,896,7,632.6,1,1,1,3,Hibernating
35135,405,8,2620.64,2,2,5,9,Regulars
35136,266,11,719.79,2,3,1,6,Regulars
35137,233,14,1502.23,3,5,3,11,Regulars
35138,234,13,1702.98,3,4,3,10,Regulars
35139,80,15,1953.76,4,5,4,13,Champions
35140,355,10,1172.08,2,3,2,7,Regulars
35141,30,15,5252.65,5,5,5,15,Champions
35142,272,11,1660.04,2,3,3,8,Regulars
35143,214,11,1050.6499999999999,3,3,2,8,Regulars
35144,444,11,885.24,2,3,2,7,Regulars
35145,165,12,725.32,3,4,1,8,Regulars
35146,209,9,4194.650000000001,3,2,5,10,Big Spenders
35147,180,10,2262.39,3,3,4,10,Big Spenders
35148,389,12,4755.969999999999,2,4,5,11,At Risk
35149,563,7,969.58,1,1,2,4,Hibernating
35150,207,6,849.95,3,1,2,6,Regulars
35151,124,13,1463.6799999999998,4,4,3,11,Loyal
35152,213,13,2079.8399999999997,3,4,4,11,Big Spenders
35153,40,10,1201.14,5,3,2,10,Loyal
35154,172,11,2276.26,3,3,4,10,Big Spenders
35155,263,12,2067.5299999999997,2,4,4,10,At Risk
35156,23,7,1052.54,5,1,2,8,Regulars
35157,2,17,1548.1599999999999,5,5,3,13,Loyal
35158,215,8,1143.47,3,2,2,7,Regulars
35159,330,9,586.29,2,2,1,5,Hibernating
35160,1,13,4195.03,5,4,5,14,Champions
35161,493,10,1987.5400000000002,1,3,4,8,Regulars
35162,188,15,3029.3100000000004,3,5,5,13,Big Spenders
35163,410,14,2689.46,2,5,5,12,At Risk
35164,46,9,1308.1,5,2,3,10,Regulars
35165,734,9,3089.99,1,2,5,8,Regulars
35166,23,11,1388.98,5,3,3,11,Loyal
35167,128,15,1580.79,4,5,3,12,Loyal
35168,281,14,3691.37,2,5,5,12,At Risk
35169,949,14,3800.29,1,5,5,11,At Risk
35170,235,5,457.30000000000007,3,1,1,5,Regulars
35171,267,6,1929.56,2,1,4,7,Regulars
35172,170,7,1705.54,3,1,3,7,Regulars
35173,61,16,2182.19,5,5,4,14,Champions
35174,48,10,745.96,5,3,1,9,Loyal
35175,1084,5,674.86,1,1,1,3,Hibernating
35176,602,6,730.71,1,1,1,3,Hibernating
35177,142,12,2425.34,4,4,4,12,Champions
35178,99,12,1011.47,4,4,2,10,Loyal
35179,600,8,2763.21,1,2,5,8,Regulars
35180,215,8,2791.4100000000003,3,2,5,10,Big Spenders
35181,126,9,1045.07,4,2,2,8,Regulars
35182,177,10,1408.48,3,3,3,9,Regulars
35183,124,13,3286.94,4,4,5,13,Champions
35184,302,6,2075.29,2,1,4,7,Regulars
35185,25,16,2359.5099999999998,5,5,4,14,Champions
35186,174,7,1586.5300000000002,3,1,3,7,Regulars
35187,380,11,2255.5099999999998,2,3,4,9,Regulars
35188,1039,11,901.95,1,3,2,6,Regulars
35189,40,12,1404.22,5,4,3,12,Loyal
35190,215,13,3058.02,3,4,5,12,Big Spenders
35191,303,10,575.21,2,3,1,6,Regulars
35192,49,9,990.58,5,2,2,9,Regulars
35193,174,13,2651.9500000000003,3,4,5,12,Big Spenders
35194,601,9,1856.8400000000001,1,2,4,7,Regulars
35195,429,7,1070.51,2,1,2,5,Hibernating
35196,52,17,1273.15,5,5,3,13,Loyal
35197,10,11,2311.91,5,3,4,12,Loyal
35198,22,12,1220.76,5,4,2,11,Loyal
35199,123,12,1183.68,4,4,2,10,Loyal
35200,563,6,337.73,1,1,1,3,Hibernating
35201,871,8,4422.7,1,2,5,8,Regulars
35202,498,10,1861.6100000000001,1,3,4,8,Regulars
35203,198,9,2757.48,3,2,5,10,Big Spenders
35204,245,10,1181.3799999999999,3,3,2,8,Regulars
35205,236,12,1411.75,3,4,3,10,Regulars
35206,87,12,828.65,4,4,1,9,Loyal
35207,166,7,4260.92,3,1,5,9,Big Spenders
35208,162,13,1811.3400000000001,3,4,4,11,Big Spenders
35209,1722,5,382.69,1,1,1,3,Hibernating
35210,147,9,918.66,4,2,2,8,Regulars
35211,193,6,670.84,3,1,1,5,Regulars
35212,469,14,3389.77,1,5,5,11,At Risk
35213,268,10,589.51,2,3,1,6,Regulars
35214,585,8,1459.75,1,2,3,6,Regulars
35215,37,12,1604.25,5,4,3,12,Loyal
35216,337,11,4644.860000000001,2,3,5,10,Regulars
35217,79,9,882.3499999999999,4,2,2,8,Regulars
35218,326,6,833.84,2,1,1,4,Hibernating
35219,721,7,1416.03,1,1,3,5,Regulars
35220,505,8,2359.7,1,2,4,7,Regulars
35221,191,5,588.68,3,1,1,5,Regulars
35222,130,13,4128.63,4,4,5,13,Champions
35223,83,9,1227.2199999999998,4,2,2,8,Regulars
35224,105,14,1398.4499999999998,4,5,3,12,Loyal
35225,214,7,3305.6099999999997,3,1,5,9,Big Spenders
35226,361,13,944.6899999999999,2,4,2,8,At Risk
35227,310,8,937.76,2,2,2,6,Hibernating
35228,30,9,994.33,5,2,2,9,Regulars
35229,437,6,2963.24,2,1,5,8,Regulars
35230,77,13,2899.42,4,4,5,13,Champions
35231,9,5,776.9699999999999,5,1,1,7,Regulars
35232,68,18,3435.81,4,5,5,14,Champions
35233,15,17,2697.34,5,5,5,15,Champions
35234,282,14,1292.81,2,5,3,10,At Risk
35235,527,13,1867.21,1,4,4,9,At Risk
35236,0,14,2360.09,5,5,4,14,Champions
35237,267,8,1300.99,2,2,3,7,Regulars
35238,1692,4,296.03999999999996,1,1,1,3,Hibernating
35239,53,17,2224.42,5,5,4,14,Champions
35240,166,11,2648.4100000000003,3,3,5,11,Big Spenders
35241,907,7,679.14,1,1,1,3,Hibernating
35242,401,8,530.57,2,2,1,5,Hibernating
35243,116,15,1469.66,4,5,3,12,Loyal
35244,224,14,1605.03,3,5,3,11,Regulars
35245,44,7,236.68,5,1,1,7,Regulars
35246,511,5,914.7399999999999,1,1,2,4,Hibernating
35247,26,15,1569.4,5,5,3,13,Loyal
35248,167,8,1251.1399999999999,3,2,3,8,Regulars
35249,265,6,722.26,2,1,1,4,Hibernating
35250,320,7,653.44,2,1,1,4,Hibernating
35251,186,10,2591.68,3,3,5,11,Big Spenders
35252,69,11,4046.29,4,3,5,12,Loyal
35253,104,13,2187.39,4,4,4,12,Champions
35254,425,10,3894.62,2,3,5,10,Regulars
35255,27,18,3009.8,5,5,5,15,Champions
35256,356,9,2272.34,2,2,4,8,Regulars
35257,282,13,2459.2299999999996,2,4,4,10,At Risk
35258,346,10,1590.52,2,3,3,8,Regulars
35259,139,5,304.03,4,1,1,6,Regulars
35260,288,12,1673.84,2,4,3,9,At Risk
35261,623,11,2909.21,1,3,5,9,Regulars
35262,231,7,1332.34,3,1,3,7,Regulars
35263,79,13,1027.98,4,4,2,10,Loyal
35264,799,10,1638.08,1,3,3,7,Regulars
35265,275,11,2271.2,2,3,4,9,Regulars
35266,149,9,711.06,3,2,1,6,Regulars
35267,122,7,638.83,4,1,1,6,Regulars
35268,345,9,1053.04,2,2,2,6,Hibernating
35269,139,6,601.5899999999999,4,1,1,6,Regulars
35270,94,9,677.6,4,2,1,7,Regulars
35271,156,8,1894.0,3,2,4,9,Big Spenders
35272,78,10,698.49,4,3,1,8,Loyal
35273,201,11,1144.81,3,3,2,8,Regulars
35274,620,4,102.71999999999997,1,1,1,3,Hibernating
35275,454,16,3059.46,2,5,5,12,At Risk
35276,34,11,1367.91,5,3,3,11,Loyal
35277,409,14,2309.53,2,5,4,11,At Risk
35278,160,11,2425.67,3,3,4,10,Big Spenders
35279,164,12,1474.43,3,4,3,10,Regulars
35280,345,13,1856.44,2,4,4,10,At Risk
35281,116,10,1462.93,4,3,3,10,Loyal
35282,399,15,2300.75,2,5,4,11,At Risk
35283,124,16,2984.5099999999998,4,5,5,14,Champions
35284,111,11,1340.72,4,3,3,10,Loyal
35285,23,16,1672.95,5,5,3,13,Loyal
35286,102,10,1288.15,4,3,3,10,Loyal
35287,79,17,3725.7200000000003,4,5,5,14,Champions
35288,99,9,1101.53,4,2,2,8,Regulars
35289,105,15,1398.97,4,5,3,12,Loyal
35290,204,4,300.88,3,1,1,5,Regulars
35291,661,8,918.44,1,2,2,5,Hibernating
35292,1684,5,480.97,1,1,1,3,Hibernating
35293,234,7,359.07,3,1,1,5,Regulars
35294,314,10,2317.3599999999997,2,3,4,9,Regulars
35295,219,8,1259.8,3,2,3,8,Regulars
35296,314,9,745.31,2,2,1,5,Hibernating
35297,167,7,1913.72,3,1,4,8,Big Spenders
35298,254,12,1345.4,2,4,3,9,At Risk
35299,141,12,830.15,4,4,1,9,Loyal
35300,231,8,589.78,3,2,1,6,Regulars
35301,232,7,2474.06,3,1,4,8,Big Spenders
35302,650,8,2043.2900000000002,1,2,4,7,Regulars
35303,48,15,3206.12,5,5,5,15,Champions
35304,720,4,229.54,1,1,1,3,Hibernating
35305,458,6,1442.3300000000002,2,1,3,6,Regulars
35306,42,12,1564.18,5,4,3,12,Loyal
35307,53,9,1226.56,5,2,2,9,Regulars
35308,508,11,2381.75,1,3,4,8,Regulars
35309,627,6,1359.3799999999999,1,1,3,5,Regulars
35310,101,11,2339.33,4,3,4,11,Loyal
35311,127,13,1404.43,4,4,3,11,Loyal
35312,96,4,103.68999999999998,4,1,1,6,Regulars
35313,57,7,889.31,5,1,2,8,Regulars
35314,42,14,959.77,5,5,2,12,Loyal
35315,250,11,2966.28,2,3,5,10,Regulars
35316,212,8,2405.32,3,2,4,9,Big Spenders
35317,489,9,1405.09,1,2,3,6,Regulars
35318,253,12,1763.4,2,4,4,10,At Risk
35319,11,12,3208.0,5,4,5,14,Champions
35320,1,12,1085.48,5,4,2,11,Loyal
35321,119,12,1532.44,4,4,3,11,Loyal
35322,139,11,4808.62,4,3,5,12,Loyal
35323,7,11,1948.81,5,3,4,12,Loyal
35324,139,12,1006.64,4,4,2,10,Loyal
35325,213,10,1393.81,3,3,3,9,Regulars
35326,13,16,2052.66,5,5,4,14,Champions
35327,129,14,1823.73,4,5,4,13,Champions
35328,102,14,2351.69,4,5,4,13,Champions
35329,2,9,1043.1100000000001,5,2,2,9,Regulars
35330,43,10,4149.84,5,3,5,13,Loyal
35331,148,14,739.9,3,5,1,9,Regulars
35332,1075,8,1875.1799999999998,1,2,4,7,Regulars
35333,190,13,3429.3,3,4,5,12,Big Spenders
35334,21,9,1279.47,5,2,3,10,Regulars
35335,841,16,3077.15,1,5,5,11,At Risk
35336,52,9,1482.6200000000001,5,2,3,10,Regulars
35337,193,10,756.32,3,3,1,7,Regulars
35338,487,13,4172.03,1,4,5,10,At Risk
35339,176,9,865.79,3,2,2,7,Regulars
35340,8,17,1098.96,5,5,2,12,Loyal
35341,95,14,1168.24,4,5,2,11,Loyal
35342,274,6,820.36,2,1,1,4,Hibernating
35343,120,9,1194.42,4,2,2,8,Regulars
35344,278,13,728.29,2,4,1,7,At Risk
35345,1144,8,616.25,1,2,1,4,Hibernating
35346,132,12,899.37,4,4,2,10,Loyal
35347,149,8,713.37,3,2,1,6,Regulars
35348,76,13,1812.69,4,4,4,12,Champions
35349,231,7,870.18,3,1,2,6,Regulars
35350,211,8,2813.44,3,2,5,10,Big Spenders
35351,35,13,1415.96,5,4,3,12,Loyal
35352,90,8,1146.19,4,2,2,8,Regulars
35353,556,8,1363.33,1,2,3,6,Regulars
35354,457,13,1752.92,2,4,4,10,At Risk
35355,120,13,2719.9100000000003,4,4,5,13,Champions
35356,172,9,1191.99,3,2,2,7,Regulars
35357,236,11,1590.99,3,3,3,9,Regulars
35358,8,14,3043.94,5,5,5,15,Champions
35359,15,17,2165.7000000000003,5,5,4,14,Champions
35360,26,5,799.47,5,1,1,7,Regulars
35361,469,12,810.8599999999999,1,4,1,6,At Risk
35362,48,10,1052.6,5,3,2,10,Loyal
35363,152,10,1561.19,3,3,3,9,Regulars
35364,419,11,1448.71,2,3,3,8,Regulars
35365,154,11,1704.18,3,3,3,9,Regulars
35366,790,7,1034.43,1,1,2,4,Hibernating
35367,19,12,1163.67,5,4,2,11,Loyal
35368,40,17,2327.89,5,5,4,14,Champions
35369,234,11,3553.8499999999995,3,3,5,11,Big Spenders
35370,90,11,2254.28,4,3,4,11,Loyal
35371,481,21,3192.0,1,5,5,11,At Risk
35372,47,11,1814.1,5,3,4,12,Loyal
35373,855,5,399.89,1,1,1,3,Hibernating
35374,546,9,2483.07,1,2,4,7,Regulars
35375,542,10,2390.42,1,3,4,8,Regulars
35376,81,14,1830.3300000000002,4,5,4,13,Champions
35377,164,11,1372.14,3,3,3,9,Regulars
35378,327,8,670.06,2,2,1,5,Hibernating
35379,81,9,1915.6100000000001,4,2,4,10,Big Spenders
35380,237,15,2091.31,3,5,4,12,Big Spenders
35381,478,7,802.76,1,1,1,3,Hibernating
35382,209,16,1066.35,3,5,2,10,Regulars
35383,454,9,948.01,2,2,2,6,Hibernating
35384,173,6,702.34,3,1,1,5,Regulars
35385,89,8,804.02,4,2,1,7,Regulars
35386,114,15,2864.2,4,5,5,14,Champions
35387,58,11,1334.9,5,3,3,11,Loyal
35388,264,19,3409.1499999999996,2,5,5,12,At Risk
35389,364,5,3085.76,2,1,5,8,Regulars
35390,45,9,2546.03,5,2,4,11,Big Spenders
35391,208,11,1163.84,3,3,2,8,Regulars
35392,29,13,1062.72,5,4,2,11,Loyal
35393,940,8,905.27,1,2,2,5,Hibernating
35394,670,10,2460.4,1,3,4,8,Regulars
35395,218,10,2655.97,3,3,5,11,Big Spenders
35396,420,5,439.71,2,1,1,4,Hibernating
35397,360,10,5920.09,2,3,5,10,Regulars
35398,140,12,822.9100000000001,4,4,1,9,Loyal
35399,8,12,1010.84,5,4,2,11,Loyal
35400,122,13,2129.88,4,4,4,12,Champions
35401,15,13,857.27,5,4,2,11,Loyal
35402,368,9,891.62,2,2,2,6,Hibernating
35403,385,10,2508.68,2,3,4,9,Regulars
35404,65,13,1983.79,5,4,4,13,Champions
35405,7,17,1594.3400000000001,5,5,3,13,Loyal
35406,20,12,1542.94,5,4,3,12,Loyal
35407,601,12,1705.76,1,4,3,8,At Risk
35408,288,7,814.54,2,1,1,4,Hibernating
35409,808,6,409.41999999999996,1,1,1,3,Hibernating
35410,46,9,922.1,5,2,2,9,Regulars
35411,212,9,1857.94,3,2,4,9,Big Spenders
35412,608,13,5104.32,1,4,5,10,At Risk
35413,461,9,844.99,1,2,2,5,Hibernating
35414,254,12,6901.45,2,4,5,11,At Risk
35415,51,15,2815.39,5,5,5,15,Champions
35416,630,11,1393.16,1,3,3,7,Regulars
35417,530,13,2445.25,1,4,4,9,At Risk
35418,194,15,3251.9,3,5,5,13,Big Spenders
35419,169,9,2128.78,3,2,4,9,Big Spenders
35420,21,6,446.27,5,1,1,7,Regulars
35421,1025,6,682.5400000000001,1,1,1,3,Hibernating
35422,351,5,1006.6000000000001,2,1,2,5,Hibernating
35423,54,12,4787.13,5,4,5,14,Champions
35424,226,11,1718.25,3,3,3,9,Regulars
35425,202,11,1773.68,3,3,4,10,Big Spenders
35426,269,10,981.2,2,3,2,7,Regulars
35427,5,15,6267.29,5,5,5,15,Champions
35428,65,9,3765.71,5,2,5,12,Big Spenders
35429,63,8,1127.18,5,2,2,9,Regulars
35430,228,9,2858.97,3,2,5,10,Big Spenders
35431,491,14,1556.21,1,5,3,9,At Risk
35432,287,12,4395.33,2,4,5,11,At Risk
35433,196,14,2462.2,3,5,4,12,Big Spenders
35434,10,10,1635.12,5,3,3,11,Loyal
35435,65,12,2133.42,5,4,4,13,Champions
35436,217,12,2420.98,3,4,4,11,Big Spenders
35437,519,7,589.48,1,1,1,3,Hibernating
35438,249,11,1508.8200000000002,2,3,3,8,Regulars
35439,23,11,3259.89,5,3,5,13,Loyal
35440,530,9,671.74,1,2,1,4,Hibernating
35441,307,14,1336.63,2,5,3,10,At Risk
35442,55,14,1256.1000000000001,5,5,3,13,Loyal
35443,80,12,1771.32,4,4,4,12,Champions
35444,644,12,3156.5099999999998,1,4,5,10,At Risk
35445,148,15,1860.06,3,5,4,12,Big Spenders
35446,234,17,3023.1600000000003,3,5,5,13,Big Spenders
35447,49,10,833.34,5,3,1,9,Loyal
35448,818,7,780.1,1,1,1,3,Hibernating
35449,459,13,1612.6100000000001,2,4,3,9,At Risk
35450,213,9,1249.8600000000001,3,2,3,8,Regulars
35451,571,10,819.0,1,3,1,5,Regulars
35452,155,12,1699.6500000000003,3,4,3,10,Regulars
35453,1467,2,14.04,1,1,1,3,Hibernating
35454,91,6,458.51,4,1,1,6,Regulars
35455,199,11,1998.62,3,3,4,10,Big Spenders
35456,24,11,1278.1100000000001,5,3,3,11,Loyal
35457,677,7,1407.9,1,1,3,5,Regulars
35458,188,9,631.98,3,2,1,6,Regulars
35459,73,12,1528.46,4,4,3,11,Loyal
35460,97,17,3089.9900000000002,4,5,5,14,Champions
35461,47,11,2818.1400000000003,5,3,5,13,Loyal
35462,343,8,715.55,2,2,1,5,Hibernating
35463,67,11,1104.32,4,3,2,9,Loyal
35464,3,16,1790.2,5,5,4,14,Champions
35465,89,3,174.0,4,1,1,6,Regulars
35466,73,6,2914.03,4,1,5,10,Big Spenders
35467,358,10,2196.32,2,3,4,9,Regulars
35468,237,7,1043.94,3,1,2,6,Regulars
35469,472,10,637.81,1,3,1,5,Regulars
35470,216,7,1690.17,3,1,3,7,Regulars
35471,389,11,1494.45,2,3,3,8,Regulars
35472,185,8,774.84,3,2,1,6,Regulars
35473,6,9,1339.79,5,2,3,10,Regulars
35474,45,13,2830.76,5,4,5,14,Champions
35475,262,18,2579.59,2,5,5,12,At Risk
35476,676,11,1707.72,1,3,3,7,Regulars
35477,441,7,1211.37,2,1,2,5,Hibernating
35478,253,8,1150.68,2,2,2,6,Hibernating
35479,437,13,2362.76,2,4,4,10,At Risk
35480,85,11,865.74,4,3,2,9,Loyal
35481,241,12,2440.77,3,4,4,11,Big Spenders
35482,645,8,1131.99,1,2,2,5,Hibernating
35483,75,11,839.79,4,3,1,8,Loyal
35484,164,12,1650.68,3,4,3,10,Regulars
35485,212,14,2898.13,3,5,5,13,Big Spenders
35486,303,12,2559.81,2,4,4,10,At Risk
35487,198,12,3280.7,3,4,5,12,Big Spenders
35488,76,13,5741.859999999999,4,4,5,13,Champions
35489,212,12,1456.25,3,4,3,10,Regulars
35490,1054,11,500.56,1,3,1,5,Regulars
35491,268,9,2045.94,2,2,4,8,Regulars
35492,155,15,1434.78,3,5,3,11,Regulars
35493,3,11,2483.27,5,3,4,12,Loyal
35494,12,22,5522.55,5,5,5,15,Champions
35495,145,16,5834.349999999999,4,5,5,14,Champions
35496,14,7,615.53,5,1,1,7,Regulars
35497,224,9,1902.03,3,2,4,9,Big Spenders
35498,69,16,2383.0499999999997,4,5,4,13,Champions
35499,526,8,1841.8300000000002,1,2,4,7,Regulars
35500,100,14,1528.58,4,5,3,12,Loyal
35501,150,13,838.03,3,4,1,8,Regulars
35502,57,8,1010.95,5,2,2,9,Regulars
35503,429,7,862.3100000000001,2,1,2,5,Hibernating
35504,2,10,1378.94,5,3,3,11,Loyal
35505,244,5,1057.12,3,1,2,6,Regulars
35506,642,9,577.27,1,2,1,4,Hibernating
35507,177,8,1289.52,3,2,3,8,Regulars
35508,211,8,1601.4499999999998,3,2,3,8,Regulars
35509,61,8,1175.27,5,2,2,9,Regulars
35510,951,7,1106.6599999999999,1,1,2,4,Hibernating
35511,164,11,976.6700000000001,3,3,2,8,Regulars
35512,88,6,1704.97,4,1,3,8,Regulars
35513,847,8,748.47,1,2,1,4,Hibernating
35514,119,12,3592.1899999999996,4,4,5,13,Champions
35515,248,10,1550.44,2,3,3,8,Regulars
35516,271,10,1011.19,2,3,2,7,Regulars
35517,440,11,1859.29,2,3,4,9,Regulars
35518,549,9,958.72,1,2,2,5,Hibernating
35519,369,5,1026.13,2,1,2,5,Hibernating
35520,252,7,853.06,2,1,2,5,Hibernating
35521,34,14,1484.9,5,5,3,13,Loyal
35522,23,11,5625.87,5,3,5,13,Loyal
35523,46,16,4279.93,5,5,5,15,Champions
35524,547,8,1939.76,1,2,4,7,Regulars
35525,0,16,4039.78,5,5,5,15,Champions
35526,677,6,735.11,1,1,1,3,Hibernating
35527,271,10,1202.45,2,3,2,7,Regulars
35528,123,11,2514.4900000000002,4,3,4,11,Loyal
35529,139,11,1102.22,4,3,2,9,Loyal
35530,569,11,1944.86,1,3,4,8,Regulars
35531,1046,10,1574.8100000000002,1,3,3,7,Regulars
35532,655,11,4205.95,1,3,5,9,Regulars
35533,62,11,785.46,5,3,1,9,Loyal
35534,68,7,1087.34,4,1,2,7,Regulars
35535,215,12,1410.13,3,4,3,10,Regulars
35536,146,8,808.52,4,2,1,7,Regulars
35537,234,6,424.92,3,1,1,5,Regulars
35538,153,11,2857.3199999999997,3,3,5,11,Big Spenders
35539,317,10,1775.41,2,3,4,9,Regulars
35540,534,5,476.06000000000006,1,1,1,3,Hibernating
35541,894,7,631.55,1,1,1,3,Hibernating
35542,146,13,1447.61,4,4,3,11,Loyal
35543,434,12,2684.0999999999995,2,4,5,11,At Risk
35544,9,12,569.68,5,4,1,10,Loyal
35545,26,12,3394.4500000000003,5,4,5,14,Champions
35546,748,6,1820.58,1,1,4,6,Regulars
35547,56,8,3782.83,5,2,5,12,Big Spenders
35548,560,11,1942.66,1,3,4,8,Regulars
35549,461,11,1025.6100000000001,1,3,2,6,Regulars
35550,36,10,797.24,5,3,1,9,Loyal
35551,351,5,550.88,2,1,1,4,Hibernating
35552,96,10,1823.84,4,3,4,11,Loyal
35553,758,14,1869.2500000000002,1,5,4,10,At Risk
35554,614,8,1819.71,1,2,4,7,Regulars
35555,536,8,2654.69,1,2,5,8,Regulars
35556,500,7,1431.74,1,1,3,5,Regulars
35557,801,12,2500.1,1,4,4,9,At Risk
35558,214,6,463.87,3,1,1,5,Regulars
35559,65,13,990.5899999999999,5,4,2,11,Loyal
35560,114,13,1835.81,4,4,4,12,Champions
35561,258,13,1104.23,2,4,2,8,At Risk
35562,366,11,934.71,2,3,2,7,Regulars
35563,91,14,1790.87,4,5,4,13,Champions
35564,333,11,1505.18,2,3,3,8,Regulars
35565,378,8,875.49,2,2,2,6,Hibernating
35566,12,12,1228.29,5,4,2,11,Loyal
35567,172,7,760.38,3,1,1,5,Regulars
35568,232,12,2504.2999999999997,3,4,4,11,Big Spenders
35569,1297,2,736.88,1,1,1,3,Hibernating
35570,89,12,1375.94,4,4,3,11,Loyal
35571,486,7,1681.3700000000001,1,1,3,5,Regulars
35572,169,11,4772.5,3,3,5,11,Big Spenders
35573,378,12,1670.8500000000001,2,4,3,9,At Risk
35574,164,5,720.63,3,1,1,5,Regulars
35575,206,15,1295.6100000000001,3,5,3,11,Regulars
35576,360,13,1312.33,2,4,3,9,At Risk
35577,397,6,494.66999999999996,2,1,1,4,Hibernating
35578,805,9,655.96,1,2,1,4,Hibernating
35579,115,13,4870.95,4,4,5,13,Champions
35580,113,9,1483.61,4,2,3,9,Regulars
35581,284,5,213.18999999999997,2,1,1,4,Hibernating
35582,546,5,4399.34,1,1,5,7,Regulars
35583,32,15,2486.5499999999997,5,5,4,14,Champions
35584,26,8,960.9699999999999,5,2,2,9,Regulars
35585,116,13,2981.6,4,4,5,13,Champions
35586,132,13,1661.49,4,4,3,11,Loyal
35587,119,12,4097.48,4,4,5,13,Champions
35588,450,7,2330.91,2,1,4,7,Regulars
35589,819,8,800.12,1,2,1,4,Hibernating
35590,133,9,2914.7,4,2,5,11,Big Spenders
35591,164,13,3757.7799999999997,3,4,5,12,Big Spenders
35592,344,15,1599.65,2,5,3,10,At Risk
35593,623,13,3562.73,1,4,5,10,At Risk
35594,306,11,3437.37,2,3,5,10,Regulars
35595,202,16,2111.24,3,5,4,12,Big Spenders
35596,437,6,530.65,2,1,1,4,Hibernating
35597,11,11,4380.7,5,3,5,13,Loyal
35598,56,17,3983.57,5,5,5,15,Champions
35599,117,14,5445.05,4,5,5,14,Champions
35600,595,10,1137.65,1,3,2,6,Regulars
35601,412,13,1594.83,2,4,3,9,At Risk
35602,171,8,1068.33,3,2,2,7,Regulars
35603,7,8,1725.45,5,2,4,11,Big Spenders
35604,342,9,2519.1400000000003,2,2,4,8,Regulars
35605,252,9,679.96,2,2,1,5,Hibernating
35606,231,7,1500.14,3,1,3,7,Regulars
35607,229,14,1591.94,3,5,3,11,Regulars
35608,92,21,3516.8,4,5,5,14,Champions
35609,38,11,2304.89,5,3,4,12,Loyal
35610,309,13,2675.7,2,4,5,11,At Risk
35611,210,9,694.95,3,2,1,6,Regulars
35612,303,12,2542.52,2,4,4,10,At Risk
35613,542,9,1002.9399999999999,1,2,2,5,Hibernating
35614,4,10,917.54,5,3,2,10,Loyal
35615,1279,6,810.5899999999999,1,1,1,3,Hibernating
35616,1002,8,808.7299999999999,1,2,1,4,Hibernating
35617,440,6,857.53,2,1,2,5,Hibernating
35618,295,13,1374.58,2,4,3,9,At Risk
35619,52,13,1526.78,5,4,3,12,Loyal
35620,589,12,2236.12,1,4,4,9,At Risk
35621,487,4,177.11999999999998,1,1,1,3,Hibernating
35622,268,7,667.3,2,1,1,4,Hibernating
35623,120,12,3092.6,4,4,5,13,Champions
35624,193,12,1197.53,3,4,2,9,Regulars
35625,23,8,1143.76,5,2,2,9,Regulars
35626,571,7,3044.35,1,1,5,7,Regulars
35627,323,12,3931.77,2,4,5,11,At Risk
35628,24,10,2413.5,5,3,4,12,Loyal
35629,100,13,1319.23,4,4,3,11,Loyal
35630,8,12,1306.73,5,4,3,12,Loyal
35631,104,5,821.68,4,1,1,6,Regulars
35632,879,5,1615.9599999999998,1,1,3,5,Regulars
35633,230,15,1830.74,3,5,4,12,Big Spenders
35634,506,14,1617.6000000000001,1,5,3,9,At Risk
35635,138,13,2759.92,4,4,5,13,Champions
35636,200,8,706.18,3,2,1,6,Regulars
35637,198,9,810.31,3,2,1,6,Regulars
35638,560,11,2868.6,1,3,5,9,Regulars
35639,378,7,397.49,2,1,1,4,Hibernating
35640,253,10,1050.01,2,3,2,7,Regulars
35641,488,7,574.5,1,1,1,3,Hibernating
35642,287,8,587.5999999999999,2,2,1,5,Hibernating
35643,279,7,2064.06,2,1,4,7,Regulars
35644,127,13,2386.01,4,4,4,12,Champions
35645,139,8,3353.19,4,2,5,11,Big Spenders
35646,241,11,1105.59,3,3,2,8,Regulars
35647,391,13,1250.67,2,4,3,9,At Risk
35648,118,13,2958.46,4,4,5,13,Champions
35649,233,12,4100.03,3,4,5,12,Big Spenders
35650,208,10,3122.7,3,3,5,11,Big Spenders
35651,218,6,1608.9100000000003,3,1,3,7,Regulars
35652,407,5,488.03999999999996,2,1,1,4,Hibernating
35653,183,9,2289.36,3,2,4,9,Big Spenders
35654,331,14,4490.860000000001,2,5,5,12,At Risk
35655,302,14,1703.4,2,5,3,10,At Risk
35656,315,13,3307.3599999999997,2,4,5,11,At Risk
35657,143,8,729.95,4,2,1,7,Regulars
35658,247,10,733.9,3,3,1,7,Regulars
35659,446,11,1140.89,2,3,2,7,Regulars
35660,118,12,894.97,4,4,2,10,Loyal
35661,201,8,2133.09,3,2,4,9,Big Spenders
35662,555,8,4094.68,1,2,5,8,Regulars
35663,207,12,2240.4,3,4,4,11,Big Spenders
35664,247,10,1819.26,3,3,4,10,Big Spenders
35665,143,20,6975.37,4,5,5,14,Champions
35666,267,11,1381.86,2,3,3,8,Regulars
35667,406,12,925.89,2,4,2,8,At Risk
35668,10,12,2351.85,5,4,4,13,Champions
35669,29,16,1404.18,5,5,3,13,Loyal
35670,95,9,2529.84,4,2,4,10,Big Spenders
35671,804,7,785.73,1,1,1,3,Hibernating
35672,96,12,2034.14,4,4,4,12,Champions
35673,56,13,2250.6000000000004,5,4,4,13,Champions
35674,170,8,764.73,3,2,1,6,Regulars
35675,411,11,1594.53,2,3,3,8,Regulars
35676,241,11,1231.67,3,3,2,8,Regulars
35677,117,13,1328.35,4,4,3,11,Loyal
35678,216,13,1151.6599999999999,3,4,2,9,Regulars
35679,41,14,3002.52,5,5,5,15,Champions
35680,42,12,878.8100000000001,5,4,2,11,Loyal
35681,503,4,377.69,1,1,1,3,Hibernating
35682,71,6,988.69,4,1,2,7,Regulars
35683,196,12,1609.96,3,4,3,10,Regulars
35684,300,11,696.66,2,3,1,6,Regulars
35685,43,13,2147.33,5,4,4,13,Champions
35686,23,8,484.2,5,2,1,8,Regulars
35687,722,8,1173.18,1,2,2,5,Hibernating
35688,0,12,2215.77,5,4,4,13,Champions
35689,59,12,950.4799999999999,5,4,2,11,Loyal
35690,60,6,226.47,5,1,1,7,Regulars
35691,38,8,832.3100000000001,5,2,1,8,Regulars
35692,38,6,558.63,5,1,1,7,Regulars
35693,171,10,1068.62,3,3,2,8,Regulars
35694,591,9,2607.84,1,2,5,8,Regulars
35695,100,7,593.29,4,1,1,6,Regulars
35696,450,9,742.05,2,2,1,5,Hibernating
35697,239,10,1730.6799999999998,3,3,4,10,Big Spenders
35698,54,12,922.83,5,4,2,11,Loyal
35699,124,4,309.94000000000005,4,1,1,6,Regulars
35700,255,11,1522.1999999999998,2,3,3,8,Regulars
35701,319,14,1160.23,2,5,2,9,At Risk
35702,45,10,817.01,5,3,1,9,Loyal
35703,407,13,1393.59,2,4,3,9,At Risk
35704,29,8,806.45,5,2,1,8,Regulars
35705,146,15,4641.98,4,5,5,14,Champions
35706,200,7,911.06,3,1,2,6,Regulars
35707,148,7,1706.76,3,1,3,7,Regulars
35708,39,7,547.86,5,1,1,7,Regulars
35709,346,12,3711.69,2,4,5,11,At Risk
35710,616,7,1212.53,1,1,2,4,Hibernating
35711,83,14,1767.01,4,5,4,13,Champions
35712,151,11,1372.04,3,3,3,9,Regulars
35713,14,12,2023.12,5,4,4,13,Champions
35714,80,10,3275.41,4,3,5,12,Loyal
35715,69,10,716.6700000000001,4,3,1,8,Loyal
35716,183,10,1004.24,3,3,2,8,Regulars
35717,272,7,1103.38,2,1,2,5,Hibernating
35718,279,8,3917.52,2,2,5,9,Regulars
35719,149,10,3364.1000000000004,3,3,5,11,Big Spenders
35720,222,7,702.37,3,1,1,5,Regulars
35721,107,13,1788.3,4,4,4,12,Champions
35722,233,10,2023.59,3,3,4,10,Big Spenders
35723,170,11,2697.02,3,3,5,11,Big Spenders
35724,189,9,711.56,3,2,1,6,Regulars
35725,109,12,3851.81,4,4,5,13,Champions
35726,58,7,340.97999999999996,5,1,1,7,Regulars
35727,311,7,607.45,2,1,1,4,Hibernating
35728,121,14,1358.89,4,5,3,12,Loyal
35729,118,9,1648.72,4,2,3,9,Regulars
35730,72,11,1267.6,4,3,3,10,Loyal
35731,226,15,2171.88,3,5,4,12,Big Spenders
35732,73,15,1546.96,4,5,3,12,Loyal
35733,64,10,2165.08,5,3,4,12,Loyal
35734,63,5,870.5699999999999,5,1,2,8,Regulars
35735,93,7,1861.65,4,1,4,9,Big Spenders
35736,42,11,841.0699999999999,5,3,1,9,Loyal
35737,111,10,1362.1200000000001,4,3,3,10,Loyal
35738,25,12,2240.02,5,4,4,13,Champions
35739,224,12,2567.47,3,4,4,11,Big Spenders
35740,237,9,2530.13,3,2,4,9,Big Spenders
35741,252,16,1260.38,2,5,3,10,At Risk
35742,418,12,3104.8100000000004,2,4,5,11,At Risk
35743,258,9,2531.44,2,2,4,8,Regulars
35744,423,11,1351.6599999999999,2,3,3,8,Regulars
35745,417,13,3610.66,2,4,5,11,At Risk
35746,374,9,926.63,2,2,2,6,Hibernating
35747,483,9,1269.45,1,2,3,6,Regulars
35748,129,12,2300.48,4,4,4,12,Champions
35749,464,4,346.02,1,1,1,3,Hibernating
35750,210,11,2245.13,3,3,4,10,Big Spenders
35751,67,10,1393.1200000000001,4,3,3,10,Loyal
35752,182,10,2451.07,3,3,4,10,Big Spenders
35753,82,10,1519.94,4,3,3,10,Loyal
35754,664,9,1101.0,1,2,2,5,Hibernating
35755,292,14,5015.650000000001,2,5,5,12,At Risk
35756,659,12,1368.71,1,4,3,8,At Risk
35757,87,10,3833.3799999999997,4,3,5,12,Loyal
35758,161,9,1449.56,3,2,3,8,Regulars
35759,627,5,1046.99,1,1,2,4,Hibernating
35760,5,10,2651.9399999999996,5,3,5,13,Loyal
35761,321,8,548.54,2,2,1,5,Hibernating
35762,172,9,1506.5,3,2,3,8,Regulars
35763,152,14,1650.5900000000001,3,5,3,11,Regulars
35764,23,9,3660.2099999999996,5,2,5,12,Big Spenders
35765,93,13,3143.61,4,4,5,13,Champions
35766,713,7,883.0,1,1,2,4,Hibernating
35767,405,11,3444.36,2,3,5,10,Regulars
35768,42,13,2484.6000000000004,5,4,4,13,Champions
35769,107,13,2168.97,4,4,4,12,Champions
35770,741,7,813.87,1,1,1,3,Hibernating
35771,456,10,1211.71,2,3,2,7,Regulars
35772,106,11,3839.55,4,3,5,12,Loyal
35773,3,14,1404.67,5,5,3,13,Loyal
35774,203,11,1306.33,3,3,3,9,Regulars
35775,956,8,2587.77,1,2,5,8,Regulars
35776,247,5,857.42,3,1,2,6,Regulars
35777,98,13,3383.5899999999997,4,4,5,13,Champions
35778,630,10,1317.34,1,3,3,7,Regulars
35779,30,10,2508.27,5,3,4,12,Loyal
35780,175,10,1114.78,3,3,2,8,Regulars
35781,22,7,1011.62,5,1,2,8,Regulars
35782,166,12,1084.83,3,4,2,9,Regulars
35783,620,9,1025.01,1,2,2,5,Hibernating
35784,861,8,545.78,1,2,1,4,Hibernating
35785,505,9,1868.67,1,2,4,7,Regulars
35786,212,11,885.67,3,3,2,8,Regulars
35787,108,9,2391.91,4,2,4,10,Big Spenders
35788,465,8,1347.1299999999999,1,2,3,6,Regulars
35789,199,12,3212.27,3,4,5,12,Big Spenders
35790,273,6,479.52,2,1,1,4,Hibernating
35791,115,12,3294.4100000000003,4,4,5,13,Champions
35792,535,11,1209.1799999999998,1,3,2,6,Regulars
35793,85,12,2934.9700000000003,4,4,5,13,Champions
35794,646,10,1470.76,1,3,3,7,Regulars
35795,299,12,1449.27,2,4,3,9,At Risk
35796,56,18,1270.68,5,5,3,13,Loyal
35797,124,12,1736.41,4,4,4,12,Champions
35798,70,13,3167.07,4,4,5,13,Champions
35799,94,5,1046.08,4,1,2,7,Regulars
35800,865,8,3903.09,1,2,5,8,Regulars
35801,221,12,1753.99,3,4,4,11,Big Spenders
35802,634,5,282.56,1,1,1,3,Hibernating
35803,31,11,2766.1,5,3,5,13,Loyal
35804,224,13,1010.36,3,4,2,9,Regulars
35805,204,14,2017.26,3,5,4,12,Big Spenders
35806,166,12,2710.35,3,4,5,12,Big Spenders
35807,0,6,421.96,5,1,1,7,Regulars
35808,258,10,1270.51,2,3,3,8,Regulars
35809,158,16,5217.14,3,5,5,13,Big Spenders
35810,227,10,1080.21,3,3,2,8,Regulars
35811,527,8,1111.76,1,2,2,5,Hibernating
35812,175,6,584.47,3,1,1,5,Regulars
35813,45,5,890.17,5,1,2,8,Regulars
35814,157,9,1204.26,3,2,2,7,Regulars
35815,294,12,1516.0900000000001,2,4,3,9,At Risk
35816,472,12,1525.71,1,4,3,8,At Risk
35817,847,10,892.55,1,3,2,6,Regulars
35818,49,13,1082.6399999999999,5,4,2,11,Loyal
35819,158,8,984.03,3,2,2,7,Regulars
35820,2,12,3231.91,5,4,5,14,Champions
35821,333,10,1545.45,2,3,3,8,Regulars
35822,180,10,1583.5,3,3,3,9,Regulars
35823,890,6,1039.24,1,1,2,4,Hibernating
35824,177,9,1126.42,3,2,2,7,Regulars
35825,15,7,745.98,5,1,1,7,Regulars
35826,209,15,3525.2200000000003,3,5,5,13,Big Spenders
35827,44,11,1370.3700000000001,5,3,3,11,Loyal
35828,286,15,1253.25,2,5,3,10,At Risk
35829,21,14,1975.5700000000002,5,5,4,14,Champions
35830,132,12,1346.26,4,4,3,11,Loyal
35831,42,8,438.95,5,2,1,8,Regulars
35832,50,13,3538.9700000000003,5,4,5,14,Champions
35833,20,19,5277.83,5,5,5,15,Champions
35834,63,7,2224.2599999999998,5,1,4,10,Big Spenders
35835,1234,5,636.66,1,1,1,3,Hibernating
35836,131,12,1472.42,4,4,3,11,Loyal
35837,17,11,619.46,5,3,1,9,Loyal
35838,134,5,1484.8300000000002,4,1,3,8,Regulars
35839,33,11,1092.2,5,3,2,10,Loyal
35840,163,9,1676.59,3,2,3,8,Regulars
35841,176,10,818.59,3,3,1,7,Regulars
35842,2,8,1783.46,5,2,4,11,Big Spenders
35843,8,12,1228.99,5,4,2,11,Loyal
35844,568,7,1161.6399999999999,1,1,2,4,Hibernating
35845,41,12,944.01,5,4,2,11,Loyal
35846,112,10,1882.7,4,3,4,11,Loyal
35847,217,15,3989.6600000000003,3,5,5,13,Big Spenders
35848,83,8,761.13,4,2,1,7,Regulars
35849,83,5,590.9200000000001,4,1,1,6,Regulars
35850,83,6,919.4100000000001,4,1,2,7,Regulars
35851,302,6,874.0699999999999,2,1,2,5,Hibernating
35852,286,9,2401.5499999999997,2,2,4,8,Regulars
35853,228,7,976.27,3,1,2,6,Regulars
35854,493,13,1809.8100000000002,1,4,4,9,At Risk
35855,595,8,548.6800000000001,1,2,1,4,Hibernating
35856,52,12,980.77,5,4,2,11,Loyal
35857,177,11,4343.48,3,3,5,11,Big Spenders
35858,949,6,790.94,1,1,1,3,Hibernating
35859,84,7,1423.88,4,1,3,8,Regulars
35860,374,7,1677.7299999999998,2,1,3,6,Regulars
35861,22,17,2489.03,5,5,4,14,Champions
35862,403,11,753.5500000000001,2,3,1,6,Regulars
35863,395,9,2756.32,2,2,5,9,Regulars
35864,451,9,550.07,2,2,1,5,Hibernating
35865,219,12,2694.57,3,4,5,12,Big Spenders
35866,4,16,1609.81,5,5,3,13,Loyal
35867,447,8,753.7800000000001,2,2,1,5,Hibernating
35868,218,10,1892.43,3,3,4,10,Big Spenders
35869,42,11,1066.9299999999998,5,3,2,10,Loyal
35870,126,11,1832.51,4,3,4,11,Loyal
35871,172,9,707.46,3,2,1,6,Regulars
35872,73,12,1886.29,4,4,4,12,Champions
35873,551,10,5107.94,1,3,5,9,Regulars
35874,576,7,302.8,1,1,1,3,Hibernating
35875,501,14,2417.39,1,5,4,10,At Risk
35876,292,12,1476.8600000000001,2,4,3,9,At Risk
35877,248,11,1203.36,2,3,2,7,Regulars
35878,381,10,3869.69,2,3,5,10,Regulars
35879,222,15,2107.26,3,5,4,12,Big Spenders
35880,651,7,1774.41,1,1,4,6,Regulars
35881,245,5,1643.32,3,1,3,7,Regulars
35882,124,13,1386.94,4,4,3,11,Loyal
35883,166,6,1942.77,3,1,4,8,Big Spenders
35884,37,16,1699.61,5,5,3,13,Loyal
35885,758,8,1167.59,1,2,2,5,Hibernating
35886,63,8,571.67,5,2,1,8,Regulars
35887,199,10,1222.02,3,3,2,8,Regulars
35888,154,9,1209.3999999999999,3,2,2,7,Regulars
35889,313,10,3451.62,2,3,5,10,Regulars
35890,17,7,881.3299999999999,5,1,2,8,Regulars
35891,87,17,2664.1800000000003,4,5,5,14,Champions
35892,201,8,423.99,3,2,1,6,Regulars
35893,84,8,2010.9300000000003,4,2,4,10,Big Spenders
35894,186,14,2030.95,3,5,4,12,Big Spenders
35895,347,10,2623.75,2,3,5,10,Regulars
35896,124,16,1771.86,4,5,4,13,Champions
35897,258,16,1577.1,2,5,3,10,At Risk
35898,126,14,2478.82,4,5,4,13,Champions
35899,440,9,1306.52,2,2,3,7,Regulars
35900,143,7,840.35,4,1,1,6,Regulars
35901,216,11,2039.56,3,3,4,10,Big Spenders
35902,162,5,248.8,3,1,1,5,Regulars
35903,131,10,2369.06,4,3,4,11,Loyal
35904,93,12,3188.5599999999995,4,4,5,13,Champions
35905,37,13,1022.18,5,4,2,11,Loyal
35906,153,12,1442.42,3,4,3,10,Regulars
35907,314,7,972.11,2,1,2,5,Hibernating
35908,464,9,890.9100000000001,1,2,2,5,Hibernating
35909,251,8,796.51,2,2,1,5,Hibernating
35910,668,10,1193.71,1,3,2,6,Regulars
35911,355,8,860.42,2,2,2,6,Hibernating
35912,95,10,900.59,4,3,2,9,Loyal
35913,343,7,617.24,2,1,1,4,Hibernating
35914,445,8,1421.44,2,2,3,7,Regulars
35915,225,10,1445.24,3,3,3,9,Regulars
35916,509,10,548.8,1,3,1,5,Regulars
35917,964,7,1310.1,1,1,3,5,Regulars
35918,317,6,831.6999999999999,2,1,1,4,Hibernating
35919,351,10,720.4200000000001,2,3,1,6,Regulars
35920,138,12,3474.6500000000005,4,4,5,13,Champions
35921,283,9,851.6899999999999,2,2,2,6,Hibernating
35922,21,5,367.63,5,1,1,7,Regulars
35923,64,10,1042.44,5,3,2,10,Loyal
35924,44,10,1139.41,5,3,2,10,Loyal
35925,277,9,3323.54,2,2,5,9,Regulars
35926,304,7,645.6999999999999,2,1,1,4,Hibernating
35927,252,9,850.4,2,2,2,6,Hibernating
35928,18,12,1187.6200000000001,5,4,2,11,Loyal
35929,145,5,2212.93,4,1,4,9,Big Spenders
35930,242,18,2636.85,3,5,5,13,Big Spenders
35931,133,8,1555.61,4,2,3,9,Regulars
35932,41,15,3050.12,5,5,5,15,Champions
35933,80,15,1599.04,4,5,3,12,Loyal
35934,424,12,1645.51,2,4,3,9,At Risk
35935,158,13,1589.67,3,4,3,10,Regulars
35936,729,5,409.71000000000004,1,1,1,3,Hibernating
35937,240,11,1416.3400000000001,3,3,3,9,Regulars
35938,947,7,2714.21,1,1,5,7,Regulars
35939,580,8,2850.67,1,2,5,8,Regulars
35940,23,12,6320.139999999999,5,4,5,14,Champions
35941,14,5,534.29,5,1,1,7,Regulars
35942,121,7,1688.9699999999998,4,1,3,8,Regulars
35943,588,10,1223.22,1,3,2,6,Regulars
35944,206,13,1339.49,3,4,3,10,Regulars
35945,138,9,3673.95,4,2,5,11,Big Spenders
35946,922,4,1027.0900000000001,1,1,2,4,Hibernating
35947,552,10,790.97,1,3,1,5,Regulars
35948,748,14,4696.34,1,5,5,11,At Risk
35949,86,11,1036.35,4,3,2,9,Loyal
35950,20,13,2451.4300000000003,5,4,4,13,Champions
35951,491,11,1284.3200000000002,1,3,3,7,Regulars
35952,399,9,507.61,2,2,1,5,Hibernating
35953,331,8,674.35,2,2,1,5,Hibernating
35954,2,10,3403.32,5,3,5,13,Loyal
35955,13,11,1201.08,5,3,2,10,Loyal
35956,70,10,856.5400000000001,4,3,2,9,Loyal
35957,537,6,502.02,1,1,1,3,Hibernating
35958,290,6,1830.7199999999998,2,1,4,7,Regulars
35959,169,6,983.45,3,1,2,6,Regulars
35960,397,7,3415.5,2,1,5,8,Regulars
35961,1,10,4827.23,5,3,5,13,Loyal
35962,294,6,1647.31,2,1,3,6,Regulars
35963,338,13,2116.86,2,4,4,10,At Risk
35964,16,9,1104.31,5,2,2,9,Regulars
35965,135,10,908.74,4,3,2,9,Loyal
35966,238,9,1123.48,3,2,2,7,Regulars
35967,232,13,3350.88,3,4,5,12,Big Spenders
35968,378,10,1210.1,2,3,2,7,Regulars
35969,111,9,711.65,4,2,1,7,Regulars
35970,66,8,1270.98,4,2,3,9,Regulars
35971,176,8,1261.0300000000002,3,2,3,8,Regulars
35972,206,10,824.44,3,3,1,7,Regulars
35973,359,6,888.12,2,1,2,5,Hibernating
35974,4,14,1161.98,5,5,2,12,Loyal
35975,736,7,719.55,1,1,1,3,Hibernating
35976,420,12,3675.96,2,4,5,11,At Risk
35977,1017,8,787.89,1,2,1,4,Hibernating
35978,50,14,3527.44,5,5,5,15,Champions
35979,74,15,4243.48,4,5,5,14,Champions
35980,161,6,894.85,3,1,2,6,Regulars
35981,40,18,3872.1,5,5,5,15,Champions
35982,99,8,363.5,4,2,1,7,Regulars
35983,160,9,4746.4800000000005,3,2,5,10,Big Spenders
35984,185,11,1271.97,3,3,3,9,Regulars
35985,30,17,1508.74,5,5,3,13,Loyal
35986,889,3,205.5,1,1,1,3,Hibernating
35987,23,12,1779.04,5,4,4,13,Champions
35988,262,10,1739.09,2,3,4,9,Regulars
35989,357,13,1377.09,2,4,3,9,At Risk
35990,40,11,2155.49,5,3,4,12,Loyal
35991,357,8,1127.51,2,2,2,6,Hibernating
35992,167,8,1112.62,3,2,2,7,Regulars
35993,13,6,457.56,5,1,1,7,Regulars
35994,116,15,3149.37,4,5,5,14,Champions
35995,261,10,1273.6599999999999,2,3,3,8,Regulars
35996,440,13,1640.48,2,4,3,9,At Risk
35997,401,11,2710.22,2,3,5,10,Regulars
35998,48,12,1036.12,5,4,2,11,Loyal
35999,1593,2,77.11,1,1,1,3,Hibernating
36000,1768,1,71.91,1,1,1,3,Hibernating
36001,25,11,1278.12,5,3,3,11,Loyal
36002,5,11,1391.09,5,3,3,11,Loyal
36003,205,7,926.12,3,1,2,6,Regulars
36004,184,13,1877.16,3,4,4,11,Big Spenders
36005,821,9,1134.9,1,2,2,5,Hibernating
36006,148,9,1090.25,3,2,2,7,Regulars
36007,514,7,578.46,1,1,1,3,Hibernating
36008,393,10,1283.81,2,3,3,8,Regulars
36009,645,5,469.23,1,1,1,3,Hibernating
36010,94,14,2451.29,4,5,4,13,Champions
36011,287,4,181.85,2,1,1,4,Hibernating
36012,950,9,433.96,1,2,1,4,Hibernating
36013,489,5,763.31,1,1,1,3,Hibernating
36014,146,9,1380.6399999999999,4,2,3,9,Regulars
36015,100,9,1597.89,4,2,3,9,Regulars
36016,151,14,3095.16,3,5,5,13,Big Spenders
36017,6,8,546.35,5,2,1,8,Regulars
36018,399,6,6105.75,2,1,5,8,Regulars
36019,216,8,3072.5299999999997,3,2,5,10,Big Spenders
36020,479,12,2212.02,1,4,4,9,At Risk
36021,65,16,4200.74,5,5,5,15,Champions
36022,197,9,878.59,3,2,2,7,Regulars
36023,122,11,1743.46,4,3,4,11,Loyal
36024,342,11,2227.54,2,3,4,9,Regulars
36025,12,7,2563.15,5,1,4,10,Big Spenders
36026,1663,9,2120.63,1,2,4,7,Regulars
36027,403,7,1242.95,2,1,3,6,Regulars
36028,1945,5,967.53,1,1,2,4,Hibernating
36029,148,6,1283.96,3,1,3,7,Regulars
36030,936,8,975.31,1,2,2,5,Hibernating
36031,313,9,1369.88,2,2,3,7,Regulars
36032,279,13,1680.22,2,4,3,9,At Risk
36033,209,9,3481.48,3,2,5,10,Big Spenders
36034,398,6,979.12,2,1,2,5,Hibernating
36035,102,6,1699.22,4,1,3,8,Regulars
36036,2,10,1280.24,5,3,3,11,Loyal
36037,373,11,4679.67,2,3,5,10,Regulars
36038,408,9,4106.18,2,2,5,9,Regulars
36039,68,8,548.02,4,2,1,7,Regulars
36040,120,10,2753.22,4,3,5,12,Loyal
36041,229,12,1619.5,3,4,3,10,Regulars
36042,750,13,1344.04,1,4,3,8,At Risk
36043,161,11,1681.48,3,3,3,9,Regulars
36044,350,19,3351.0,2,5,5,12,At Risk
36045,85,12,1322.74,4,4,3,11,Loyal
36046,49,6,992.8500000000001,5,1,2,8,Regulars
36047,892,11,1530.46,1,3,3,7,Regulars
36048,1197,6,339.78,1,1,1,3,Hibernating
36049,210,11,1730.74,3,3,4,10,Big Spenders
36050,82,8,1348.93,4,2,3,9,Regulars
36051,530,11,2035.21,1,3,4,8,Regulars
36052,189,14,1939.8,3,5,4,12,Big Spenders
36053,268,4,468.64,2,1,1,4,Hibernating
36054,33,10,3358.76,5,3,5,13,Loyal
36055,362,13,1829.18,2,4,4,10,At Risk
36056,777,10,2480.73,1,3,4,8,Regulars
36057,158,9,2520.18,3,2,4,9,Big Spenders
36058,213,13,2525.29,3,4,4,11,Big Spenders
36059,357,15,2047.35,2,5,4,11,At Risk
36060,64,12,841.37,5,4,1,10,Loyal
36061,29,13,2264.32,5,4,4,13,Champions
36062,198,12,988.1200000000001,3,4,2,9,Regulars
36063,46,20,3448.41,5,5,5,15,Champions
36064,90,7,1104.86,4,1,2,7,Regulars
36065,385,10,2595.76,2,3,5,10,Regulars
36066,210,8,317.87,3,2,1,6,Regulars
36067,256,7,890.34,2,1,2,5,Hibernating
36068,16,11,976.27,5,3,2,10,Loyal
36069,2,16,2955.01,5,5,5,15,Champions
36070,290,13,979.18,2,4,2,8,At Risk
36071,315,5,470.31,2,1,1,4,Hibernating
36072,177,8,964.87,3,2,2,7,Regulars
36073,63,11,1219.57,5,3,2,10,Loyal
36074,96,5,1768.9099999999999,4,1,4,9,Big Spenders
36075,686,8,3810.99,1,2,5,8,Regulars
36076,523,10,1723.77,1,3,3,7,Regulars
36077,239,7,460.24,3,1,1,5,Regulars
36078,158,5,598.56,3,1,1,5,Regulars
36079,105,9,2377.6099999999997,4,2,4,10,Big Spenders
36080,190,10,1192.45,3,3,2,8,Regulars
36081,104,10,3219.1899999999996,4,3,5,12,Loyal
36082,1026,10,1174.47,1,3,2,6,Regulars
36083,6,11,1889.5100000000002,5,3,4,12,Loyal
36084,95,9,946.8199999999999,4,2,2,8,Regulars
36085,136,5,341.83,4,1,1,6,Regulars
36086,281,12,811.76,2,4,1,7,At Risk
36087,455,7,528.77,2,1,1,4,Hibernating
36088,257,14,2698.19,2,5,5,12,At Risk
36089,64,13,2398.44,5,4,4,13,Champions
36090,191,18,2525.21,3,5,4,12,Big Spenders
36091,649,9,990.38,1,2,2,5,Hibernating
36092,237,9,1189.81,3,2,2,7,Regulars
36093,8,10,1261.4799999999998,5,3,3,11,Loyal
36094,665,6,629.6,1,1,1,3,Hibernating
36095,6,9,814.73,5,2,1,8,Regulars
36096,142,11,1485.6599999999999,4,3,3,10,Loyal
36097,152,8,992.58,3,2,2,7,Regulars
36098,167,8,772.6999999999999,3,2,1,6,Regulars
36099,128,11,1287.0700000000002,4,3,3,10,Loyal
36100,0,13,1399.53,5,4,3,12,Loyal
36101,195,8,2893.0,3,2,5,10,Big Spenders
36102,242,9,1211.87,3,2,2,7,Regulars
36103,72,11,1856.26,4,3,4,11,Loyal
36104,31,10,2203.14,5,3,4,12,Loyal
36105,285,14,3700.2399999999993,2,5,5,12,At Risk
36106,90,9,1019.7199999999999,4,2,2,8,Regulars
36107,82,7,891.48,4,1,2,7,Regulars
36108,64,8,797.64,5,2,1,8,Regulars
36109,146,12,1951.5000000000002,4,4,4,12,Champions
36110,175,11,1210.37,3,3,2,8,Regulars
36111,2,15,4280.860000000001,5,5,5,15,Champions
36112,585,12,2799.9199999999996,1,4,5,10,At Risk
36113,148,9,2759.87,3,2,5,10,Big Spenders
36114,239,8,820.29,3,2,1,6,Regulars
36115,767,11,1807.89,1,3,4,8,Regulars
36116,31,14,1946.79,5,5,4,14,Champions
36117,421,6,362.43,2,1,1,4,Hibernating
36118,1279,8,769.67,1,2,1,4,Hibernating
36119,779,10,4161.45,1,3,5,9,Regulars
36120,156,12,1679.17,3,4,3,10,Regulars
36121,10,14,1841.1999999999998,5,5,4,14,Champions
36122,329,9,1998.54,2,2,4,8,Regulars
36123,940,8,685.71,1,2,1,4,Hibernating
36124,19,8,1731.85,5,2,4,11,Big Spenders
36125,18,14,2880.26,5,5,5,15,Champions
36126,843,9,669.63,1,2,1,4,Hibernating
36127,993,9,636.58,1,2,1,4,Hibernating
36128,997,6,587.86,1,1,1,3,Hibernating
36129,441,11,2990.35,2,3,5,10,Regulars
36130,34,5,552.4100000000001,5,1,1,7,Regulars
36131,139,5,767.3100000000001,4,1,1,6,Regulars
36132,108,11,2087.52,4,3,4,11,Loyal
36133,112,13,2258.62,4,4,4,12,Champions
36134,722,11,1792.91,1,3,4,8,Regulars
36135,231,10,891.72,3,3,2,8,Regulars
36136,268,10,667.55,2,3,1,6,Regulars
36137,200,9,2998.76,3,2,5,10,Big Spenders
36138,843,5,901.13,1,1,2,4,Hibernating
36139,293,9,433.02,2,2,1,5,Hibernating
36140,179,7,1776.6399999999999,3,1,4,8,Big Spenders
36141,31,16,2542.98,5,5,4,14,Champions
36142,847,6,752.35,1,1,1,3,Hibernating
36143,193,7,692.64,3,1,1,5,Regulars
36144,246,17,2739.44,3,5,5,13,Big Spenders
36145,93,11,1589.38,4,3,3,10,Loyal
36146,148,19,2203.04,3,5,4,12,Big Spenders
36147,55,5,1324.96,5,1,3,9,Regulars
36148,124,21,6053.93,4,5,5,14,Champions
36149,886,8,959.06,1,2,2,5,Hibernating
36150,174,12,2470.7,3,4,4,11,Big Spenders
36151,362,7,539.61,2,1,1,4,Hibernating
36152,246,9,1321.87,3,2,3,8,Regulars
36153,274,13,1198.2,2,4,2,8,At Risk
36154,184,13,1957.6100000000001,3,4,4,11,Big Spenders
36155,345,11,2492.96,2,3,4,9,Regulars
36156,193,7,1036.99,3,1,2,6,Regulars
36157,50,19,4518.56,5,5,5,15,Champions
36158,317,5,576.39,2,1,1,4,Hibernating
36159,176,8,620.5899999999999,3,2,1,6,Regulars
36160,247,14,1629.22,3,5,3,11,Regulars
36161,87,8,772.51,4,2,1,7,Regulars
36162,44,12,2652.86,5,4,5,14,Champions
36163,647,6,371.13,1,1,1,3,Hibernating
36164,183,5,296.1,3,1,1,5,Regulars
36165,224,13,1327.47,3,4,3,10,Regulars
36166,250,9,728.48,2,2,1,5,Hibernating
36167,95,13,2089.88,4,4,4,12,Champions
36168,420,7,701.96,2,1,1,4,Hibernating
36169,86,11,2360.65,4,3,4,11,Loyal
36170,52,13,2176.1200000000003,5,4,4,13,Champions
36171,87,16,3535.7799999999997,4,5,5,14,Champions
36172,384,6,391.87,2,1,1,4,Hibernating
36173,178,14,1893.32,3,5,4,12,Big Spenders
36174,101,12,3138.5,4,4,5,13,Champions
36175,241,12,763.43,3,4,1,8,Regulars
36176,14,11,3440.0700000000006,5,3,5,13,Loyal
36177,21,13,2120.77,5,4,4,13,Champions
36178,76,11,1388.85,4,3,3,10,Loyal
36179,258,13,1026.11,2,4,2,8,At Risk
36180,230,15,4017.51,3,5,5,13,Big Spenders
36181,322,11,1990.17,2,3,4,9,Regulars
36182,193,16,3320.4300000000003,3,5,5,13,Big Spenders
36183,68,15,2487.65,4,5,4,13,Champions
36184,134,4,284.74,4,1,1,6,Regulars
36185,6,11,2980.93,5,3,5,13,Loyal
36186,843,11,2187.46,1,3,4,8,Regulars
36187,164,10,1444.89,3,3,3,9,Regulars
36188,525,10,1600.79,1,3,3,7,Regulars
36189,2,14,2468.38,5,5,4,14,Champions
36190,92,8,1373.75,4,2,3,9,Regulars
36191,121,5,2020.71,4,1,4,9,Big Spenders
36192,68,15,4417.679999999999,4,5,5,14,Champions
36193,303,8,1259.2099999999998,2,2,3,7,Regulars
36194,114,10,996.03,4,3,2,9,Loyal
36195,95,14,1455.28,4,5,3,12,Loyal
36196,323,12,3727.9,2,4,5,11,At Risk
36197,15,10,1368.11,5,3,3,11,Loyal
36198,45,15,2511.51,5,5,4,14,Champions
36199,55,12,1221.96,5,4,2,11,Loyal
36200,127,10,3391.25,4,3,5,12,Loyal
36201,18,11,2418.51,5,3,4,12,Loyal
36202,122,8,982.77,4,2,2,8,Regulars
36203,216,7,429.75,3,1,1,5,Regulars
36204,392,6,327.28,2,1,1,4,Hibernating
36205,37,12,932.11,5,4,2,11,Loyal
36206,128,12,1885.0,4,4,4,12,Champions
36207,73,14,4310.0,4,5,5,14,Champions
36208,5,10,1043.04,5,3,2,10,Loyal
36209,49,10,1257.99,5,3,3,11,Loyal
36210,235,8,1402.78,3,2,3,8,Regulars
36211,158,16,3523.54,3,5,5,13,Big Spenders
36212,27,13,1754.57,5,4,4,13,Champions
36213,245,14,1274.88,3,5,3,11,Regulars
36214,116,6,936.29,4,1,2,7,Regulars
36215,119,7,1971.86,4,1,4,9,Big Spenders
36216,43,10,1314.88,5,3,3,11,Loyal
36217,530,9,969.37,1,2,2,5,Hibernating
36218,139,8,3112.96,4,2,5,11,Big Spenders
36219,183,8,933.47,3,2,2,7,Regulars
36220,36,12,1250.6100000000001,5,4,3,12,Loyal
36221,111,13,1706.3400000000001,4,4,3,11,Loyal
36222,336,6,432.7,2,1,1,4,Hibernating
36223,184,9,3281.06,3,2,5,10,Big Spenders
36224,44,8,3364.0200000000004,5,2,5,12,Big Spenders
36225,192,5,964.04,3,1,2,6,Regulars
36226,291,10,1270.42,2,3,3,8,Regulars
36227,78,10,1849.1,4,3,4,11,Loyal
36228,380,12,728.53,2,4,1,7,At Risk
36229,437,7,369.57,2,1,1,4,Hibernating
36230,328,9,548.1600000000001,2,2,1,5,Hibernating
36231,421,7,986.17,2,1,2,5,Hibernating
36232,190,6,308.01,3,1,1,5,Regulars
36233,47,12,3640.78,5,4,5,14,Champions
36234,434,12,2004.48,2,4,4,10,At Risk
36235,42,13,3100.76,5,4,5,14,Champions
36236,211,11,2633.55,3,3,5,11,Big Spenders
36237,15,9,679.79,5,2,1,8,Regulars
36238,349,7,496.65,2,1,1,4,Hibernating
36239,21,6,700.56,5,1,1,7,Regulars
36240,9,9,1192.22,5,2,2,9,Regulars
36241,38,12,1919.95,5,4,4,13,Champions
36242,120,7,1756.89,4,1,4,9,Big Spenders
36243,521,12,2202.18,1,4,4,9,At Risk
36244,261,12,1428.73,2,4,3,9,At Risk
36245,85,8,950.2099999999999,4,2,2,8,Regulars
36246,101,10,1249.8,4,3,3,10,Loyal
36247,360,12,2255.2599999999998,2,4,4,10,At Risk
36248,176,9,1342.15,3,2,3,8,Regulars
36249,672,4,414.51,1,1,1,3,Hibernating
36250,54,12,2640.84,5,4,5,14,Champions
36251,82,15,2010.8999999999999,4,5,4,13,Champions
36252,45,14,1351.55,5,5,3,13,Loyal
36253,191,17,3423.17,3,5,5,13,Big Spenders
36254,162,7,616.36,3,1,1,5,Regulars
36255,259,16,2174.51,2,5,4,11,At Risk
36256,852,7,1543.41,1,1,3,5,Regulars
36257,338,10,2810.58,2,3,5,10,Regulars
36258,138,8,1231.65,4,2,2,8,Regulars
36259,119,10,1658.97,4,3,3,10,Loyal
36260,514,7,704.47,1,1,1,3,Hibernating
36261,623,7,311.31,1,1,1,3,Hibernating
36262,195,12,1467.18,3,4,3,10,Regulars
36263,69,13,1753.24,4,4,4,12,Champions
36264,192,9,665.25,3,2,1,6,Regulars
36265,55,6,1223.09,5,1,2,8,Regulars
36266,65,8,3549.0800000000004,5,2,5,12,Big Spenders
36267,798,8,915.47,1,2,2,5,Hibernating
36268,127,12,1633.1899999999998,4,4,3,11,Loyal
36269,68,12,967.6,4,4,2,10,Loyal
36270,131,10,726.6,4,3,1,8,Loyal
36271,63,12,1662.97,5,4,3,12,Loyal
36272,180,12,1090.58,3,4,2,9,Regulars
36273,159,6,367.68,3,1,1,5,Regulars
36274,124,8,1421.01,4,2,3,9,Regulars
36275,12,11,788.1700000000001,5,3,1,9,Loyal
36276,223,13,1811.4299999999998,3,4,4,11,Big Spenders
36277,402,12,1513.7,2,4,3,9,At Risk
36278,346,11,1514.0800000000002,2,3,3,8,Regulars
36279,23,8,651.7,5,2,1,8,Regulars
36280,152,10,3634.52,3,3,5,11,Big Spenders
36281,93,12,1909.26,4,4,4,12,Champions
36282,318,14,1278.65,2,5,3,10,At Risk
36283,641,7,593.58,1,1,1,3,Hibernating
36284,243,10,3309.89,3,3,5,11,Big Spenders
36285,860,10,636.3199999999999,1,3,1,5,Regulars
36286,1037,7,1543.18,1,1,3,5,Regulars
36287,278,14,1094.42,2,5,2,9,At Risk
36288,396,9,3013.81,2,2,5,9,Regulars
36289,540,10,1022.5,1,3,2,6,Regulars
36290,707,6,891.76,1,1,2,4,Hibernating
36291,89,7,684.92,4,1,1,6,Regulars
36292,453,5,4174.400000000001,2,1,5,8,Regulars
36293,327,10,892.17,2,3,2,7,Regulars
36294,138,11,1675.66,4,3,3,10,Loyal
36295,132,13,2834.56,4,4,5,13,Champions
36296,315,9,734.1,2,2,1,5,Hibernating
36297,169,7,350.81000000000006,3,1,1,5,Regulars
36298,44,9,1170.29,5,2,2,9,Regulars
36299,286,8,1874.47,2,2,4,8,Regulars
36300,266,6,974.24,2,1,2,5,Hibernating
36301,316,8,818.44,2,2,1,5,Hibernating
36302,314,12,2150.2,2,4,4,10,At Risk
36303,166,11,872.12,3,3,2,8,Regulars
36304,605,7,362.37,1,1,1,3,Hibernating
36305,89,11,1308.25,4,3,3,10,Loyal
36306,203,13,1733.34,3,4,4,11,Big Spenders
36307,9,10,1885.41,5,3,4,12,Loyal
36308,179,10,832.98,3,3,1,7,Regulars
36309,730,10,2355.87,1,3,4,8,Regulars
36310,352,12,3500.7000000000003,2,4,5,11,At Risk
36311,506,15,2656.32,1,5,5,11,At Risk
36312,204,12,1244.52,3,4,3,10,Regulars
36313,110,14,4568.63,4,5,5,14,Champions
36314,170,14,2528.58,3,5,4,12,Big Spenders
36315,718,6,898.0600000000001,1,1,2,4,Hibernating
36316,255,7,397.82,2,1,1,4,Hibernating
36317,105,12,2490.8199999999997,4,4,4,12,Champions
36318,37,8,4262.51,5,2,5,12,Big Spenders
36319,262,17,5428.09,2,5,5,12,At Risk
36320,102,13,716.23,4,4,1,9,Loyal
36321,470,9,1921.98,1,2,4,7,Regulars
36322,337,11,927.66,2,3,2,7,Regulars
36323,728,4,420.81,1,1,1,3,Hibernating
36324,166,9,2781.38,3,2,5,10,Big Spenders
36325,5,9,902.7,5,2,2,9,Regulars
36326,761,15,1979.18,1,5,4,10,At Risk
36327,140,14,1711.47,4,5,3,12,Loyal
36328,1,8,2413.38,5,2,4,11,Big Spenders
36329,931,5,411.28999999999996,1,1,1,3,Hibernating
36330,303,12,2418.09,2,4,4,10,At Risk
36331,269,10,1232.71,2,3,2,7,Regulars
36332,610,13,1470.26,1,4,3,8,At Risk
36333,531,5,927.4300000000001,1,1,2,4,Hibernating
36334,189,6,3166.48,3,1,5,9,Big Spenders
36335,449,11,2498.89,2,3,4,9,Regulars
36336,28,11,2572.2,5,3,4,12,Loyal
36337,1131,9,969.86,1,2,2,5,Hibernating
36338,109,12,2050.45,4,4,4,12,Champions
36339,343,11,2768.18,2,3,5,10,Regulars
36340,62,14,1107.1200000000001,5,5,2,12,Loyal
36341,318,8,459.87,2,2,1,5,Hibernating
36342,85,15,3874.0800000000004,4,5,5,14,Champions
36343,370,7,943.97,2,1,2,5,Hibernating
36344,404,8,1087.84,2,2,2,6,Hibernating
36345,326,11,2315.69,2,3,4,9,Regulars
36346,125,4,473.79999999999995,4,1,1,6,Regulars
36347,382,10,878.71,2,3,2,7,Regulars
36348,249,14,1568.47,2,5,3,10,At Risk
36349,385,14,958.44,2,5,2,9,At Risk
36350,20,9,2452.6,5,2,4,11,Big Spenders
36351,122,10,666.49,4,3,1,8,Loyal
36352,151,8,705.68,3,2,1,6,Regulars
36353,28,11,2465.29,5,3,4,12,Loyal
36354,639,4,2042.26,1,1,4,6,Regulars
36355,245,16,1788.94,3,5,4,12,Big Spenders
36356,110,15,2787.38,4,5,5,14,Champions
36357,134,12,3182.23,4,4,5,13,Champions
36358,4,18,2232.94,5,5,4,14,Champions
36359,341,15,1652.6799999999998,2,5,3,10,At Risk
36360,82,10,1246.94,4,3,3,10,Loyal
36361,151,7,3461.68,3,1,5,9,Big Spenders
36362,85,9,1429.75,4,2,3,9,Regulars
36363,121,9,1475.9,4,2,3,9,Regulars
36364,293,11,2547.6,2,3,4,9,Regulars
36365,324,10,1370.92,2,3,3,8,Regulars
36366,357,10,2393.04,2,3,4,9,Regulars
36367,119,11,2646.84,4,3,5,12,Loyal
36368,210,13,1488.09,3,4,3,10,Regulars
36369,18,15,2604.67,5,5,5,15,Champions
36370,102,9,1067.5,4,2,2,8,Regulars
36371,170,8,747.65,3,2,1,6,Regulars
36372,119,14,863.74,4,5,2,11,Loyal
36373,551,9,986.6600000000001,1,2,2,5,Hibernating
36374,526,9,1031.33,1,2,2,5,Hibernating
36375,65,2,94.57000000000001,5,1,1,7,Regulars
36376,288,9,960.88,2,2,2,6,Hibernating
36377,208,15,1816.09,3,5,4,12,Big Spenders
36378,424,7,387.3,2,1,1,4,Hibernating
36379,41,18,5631.3,5,5,5,15,Champions
36380,143,7,896.97,4,1,2,7,Regulars
36381,89,11,1573.1799999999998,4,3,3,10,Loyal
36382,70,8,889.16,4,2,2,8,Regulars
36383,148,15,1148.07,3,5,2,10,Regulars
36384,653,5,1076.0,1,1,2,4,Hibernating
36385,438,13,1070.57,2,4,2,8,At Risk
36386,230,12,1560.95,3,4,3,10,Regulars
36387,320,7,311.64,2,1,1,4,Hibernating
36388,213,9,1713.96,3,2,3,8,Regulars
36389,216,11,1063.62,3,3,2,8,Regulars
36390,480,14,2862.46,1,5,5,11,At Risk
36391,427,9,1493.25,2,2,3,7,Regulars
36392,1148,7,1323.8200000000002,1,1,3,5,Regulars
36393,809,9,843.3299999999999,1,2,1,4,Hibernating
36394,543,8,451.77000000000004,1,2,1,4,Hibernating
36395,558,13,1219.04,1,4,2,7,At Risk
36396,527,10,995.14,1,3,2,6,Regulars
36397,695,7,670.48,1,1,1,3,Hibernating
36398,188,13,1204.91,3,4,2,9,Regulars
36399,583,5,613.8700000000001,1,1,1,3,Hibernating
36400,50,11,445.06,5,3,1,9,Loyal
36401,322,8,808.43,2,2,1,5,Hibernating
36402,701,10,2491.2799999999997,1,3,4,8,Regulars
36403,34,15,1670.83,5,5,3,13,Loyal
36404,459,7,822.33,2,1,1,4,Hibernating
36405,238,9,1125.27,3,2,2,7,Regulars
36406,318,8,1261.61,2,2,3,7,Regulars
36407,1557,3,3457.0300000000007,1,1,5,7,Regulars
36408,69,15,4254.96,4,5,5,14,Champions
36409,66,12,1078.6299999999999,4,4,2,10,Loyal
36410,901,5,448.7,1,1,1,3,Hibernating
36411,11,8,2929.6799999999994,5,2,5,12,Big Spenders
36412,130,11,1549.42,4,3,3,10,Loyal
36413,442,12,2052.66,2,4,4,10,At Risk
36414,255,11,3147.66,2,3,5,10,Regulars
36415,52,15,2340.7599999999998,5,5,4,14,Champions
36416,218,10,619.25,3,3,1,7,Regulars
36417,118,9,966.75,4,2,2,8,Regulars
36418,286,10,982.8199999999999,2,3,2,7,Regulars
36419,618,12,2964.72,1,4,5,10,At Risk
36420,807,11,2085.54,1,3,4,8,Regulars
36421,82,6,538.0699999999999,4,1,1,6,Regulars
36422,523,10,4684.59,1,3,5,9,Regulars
36423,124,12,1447.96,4,4,3,11,Loyal
36424,31,8,1129.8600000000001,5,2,2,9,Regulars
36425,322,12,1317.57,2,4,3,9,At Risk
36426,163,6,946.5799999999999,3,1,2,6,Regulars
36427,343,8,849.2099999999999,2,2,2,6,Hibernating
36428,121,6,274.09000000000003,4,1,1,6,Regulars
36429,259,6,615.3700000000001,2,1,1,4,Hibernating
36430,28,11,1355.79,5,3,3,11,Loyal
36431,92,12,3249.7200000000003,4,4,5,13,Champions
36432,224,11,2615.6099999999997,3,3,5,11,Big Spenders
36433,308,16,1126.71,2,5,2,9,At Risk
36434,295,11,1413.3,2,3,3,8,Regulars
36435,338,4,248.65000000000003,2,1,1,4,Hibernating
36436,90,12,1379.8,4,4,3,11,Loyal
36437,161,17,3818.42,3,5,5,13,Big Spenders
36438,190,9,1005.1800000000001,3,2,2,7,Regulars
36439,922,10,2553.53,1,3,4,8,Regulars
36440,84,8,1805.09,4,2,4,10,Big Spenders
36441,773,7,917.97,1,1,2,4,Hibernating
36442,72,11,1011.76,4,3,2,9,Loyal
36443,228,10,2391.96,3,3,4,10,Big Spenders
36444,165,11,1427.0300000000002,3,3,3,9,Regulars
36445,107,11,1407.73,4,3,3,10,Loyal
36446,179,15,2318.41,3,5,4,12,Big Spenders
36447,138,9,964.1700000000001,4,2,2,8,Regulars
36448,13,7,834.63,5,1,1,7,Regulars
36449,1248,8,796.95,1,2,1,4,Hibernating
36450,156,4,694.76,3,1,1,5,Regulars
36451,104,7,1343.19,4,1,3,8,Regulars
36452,525,15,4403.61,1,5,5,11,At Risk
36453,19,9,1175.8700000000001,5,2,2,9,Regulars
36454,255,8,1267.72,2,2,3,7,Regulars
36455,387,11,1059.43,2,3,2,7,Regulars
36456,128,10,2154.13,4,3,4,11,Loyal
36457,1031,7,2045.9999999999998,1,1,4,6,Regulars
36458,28,5,554.4300000000001,5,1,1,7,Regulars
36459,284,13,1860.4,2,4,4,10,At Risk
36460,197,10,1968.8,3,3,4,10,Big Spenders
36461,1162,5,1458.1000000000001,1,1,3,5,Regulars
36462,271,11,1455.76,2,3,3,8,Regulars
36463,173,7,2536.42,3,1,4,8,Big Spenders
36464,319,10,1545.19,2,3,3,8,Regulars
36465,31,21,3217.63,5,5,5,15,Champions
36466,310,9,1290.61,2,2,3,7,Regulars
36467,129,11,1270.16,4,3,3,10,Loyal
36468,1349,4,777.99,1,1,1,3,Hibernating
36469,71,8,1145.6000000000001,4,2,2,8,Regulars
36470,1161,5,553.94,1,1,1,3,Hibernating
36471,16,11,1319.76,5,3,3,11,Loyal
36472,5,14,2473.16,5,5,4,14,Champions
36473,274,8,878.65,2,2,2,6,Hibernating
36474,456,12,1262.41,2,4,3,9,At Risk
36475,218,12,2361.06,3,4,4,11,Big Spenders
36476,292,12,1841.28,2,4,4,10,At Risk
36477,519,9,871.91,1,2,2,5,Hibernating
36478,931,7,2433.42,1,1,4,6,Regulars
36479,64,8,2468.0699999999997,5,2,4,11,Big Spenders
36480,75,17,5425.85,4,5,5,14,Champions
36481,446,5,1962.84,2,1,4,7,Regulars
36482,10,10,783.39,5,3,1,9,Loyal
36483,19,7,1052.51,5,1,2,8,Regulars
36484,186,12,1546.3,3,4,3,10,Regulars
36485,375,6,514.5,2,1,1,4,Hibernating
36486,23,9,834.8299999999999,5,2,1,8,Regulars
36487,47,12,2827.2000000000003,5,4,5,14,Champions
36488,95,8,1677.34,4,2,3,9,Regulars
36489,249,8,765.88,2,2,1,5,Hibernating
36490,119,13,2124.86,4,4,4,12,Champions
36491,119,10,955.1600000000001,4,3,2,9,Loyal
36492,199,14,2963.34,3,5,5,13,Big Spenders
36493,231,14,2954.28,3,5,5,13,Big Spenders
36494,307,8,1249.66,2,2,3,7,Regulars
36495,522,8,904.1199999999999,1,2,2,5,Hibernating
36496,180,11,1506.53,3,3,3,9,Regulars
36497,127,10,2804.79,4,3,5,12,Loyal
36498,741,12,1381.59,1,4,3,8,At Risk
36499,30,11,1280.05,5,3,3,11,Loyal
36500,88,13,1623.53,4,4,3,11,Loyal
36501,296,9,2303.67,2,2,4,8,Regulars
36502,562,12,1191.96,1,4,2,7,At Risk
36503,511,9,2039.01,1,2,4,7,Regulars
36504,125,10,2224.16,4,3,4,11,Loyal
36505,193,2,134.04000000000002,3,1,1,5,Regulars
36506,101,8,805.2600000000001,4,2,1,7,Regulars
36507,345,14,2317.55,2,5,4,11,At Risk
36508,248,15,2371.8599999999997,2,5,4,11,At Risk
36509,101,6,720.1,4,1,1,6,Regulars
36510,167,13,3707.97,3,4,5,12,Big Spenders
36511,23,12,4274.2,5,4,5,14,Champions
36512,286,16,5047.12,2,5,5,12,At Risk
36513,196,12,1685.4099999999999,3,4,3,10,Regulars
36514,96,7,900.07,4,1,2,7,Regulars
36515,448,5,311.56,2,1,1,4,Hibernating
36516,73,12,1390.12,4,4,3,11,Loyal
36517,66,9,1089.17,4,2,2,8,Regulars
36518,266,12,807.05,2,4,1,7,At Risk
36519,15,7,649.6899999999999,5,1,1,7,Regulars
36520,91,9,1258.47,4,2,3,9,Regulars
36521,139,17,2350.33,4,5,4,13,Champions
36522,178,7,927.84,3,1,2,6,Regulars
36523,1157,3,458.75,1,1,1,3,Hibernating
36524,493,5,281.24,1,1,1,3,Hibernating
36525,169,11,1453.28,3,3,3,9,Regulars
36526,208,7,542.8100000000001,3,1,1,5,Regulars
36527,541,11,1492.5,1,3,3,7,Regulars
36528,442,10,827.97,2,3,1,6,Regulars
36529,44,9,808.82,5,2,1,8,Regulars
36530,70,8,2175.15,4,2,4,10,Big Spenders
36531,83,6,401.37,4,1,1,6,Regulars
36532,748,6,1399.6599999999999,1,1,3,5,Regulars
36533,152,8,701.59,3,2,1,6,Regulars
36534,118,15,823.64,4,5,1,10,Loyal
36535,166,8,1163.08,3,2,2,7,Regulars
36536,117,14,3317.63,4,5,5,14,Champions
36537,342,9,799.87,2,2,1,5,Hibernating
36538,74,8,469.12,4,2,1,7,Regulars
36539,668,10,1172.35,1,3,2,6,Regulars
36540,204,11,2489.3399999999997,3,3,4,10,Big Spenders
36541,59,14,2124.85,5,5,4,14,Champions
36542,19,12,860.84,5,4,2,11,Loyal
36543,215,13,1322.65,3,4,3,10,Regulars
36544,243,6,1169.78,3,1,2,6,Regulars
36545,333,7,458.1,2,1,1,4,Hibernating
36546,750,8,1012.9,1,2,2,5,Hibernating
36547,107,10,1829.7799999999997,4,3,4,11,Loyal
36548,148,4,861.3299999999999,3,1,2,6,Regulars
36549,822,8,1062.42,1,2,2,5,Hibernating
36550,460,5,1690.28,1,1,3,5,Regulars
36551,248,10,1435.05,2,3,3,8,Regulars
36552,28,11,851.58,5,3,2,10,Loyal
36553,146,9,1173.29,4,2,2,8,Regulars
36554,140,11,1393.01,4,3,3,10,Loyal
36555,431,9,671.3000000000001,2,2,1,5,Hibernating
36556,101,12,3000.67,4,4,5,13,Champions
36557,445,15,1819.04,2,5,4,11,At Risk
36558,727,8,694.27,1,2,1,4,Hibernating
36559,577,11,1825.17,1,3,4,8,Regulars
36560,207,11,1106.97,3,3,2,8,Regulars
36561,821,7,722.36,1,1,1,3,Hibernating
36562,63,10,1930.04,5,3,4,12,Loyal
36563,465,8,511.53,1,2,1,4,Hibernating
36564,324,13,1158.29,2,4,2,8,At Risk
36565,788,11,670.16,1,3,1,5,Regulars
36566,327,8,1387.73,2,2,3,7,Regulars
36567,307,14,2573.5299999999997,2,5,4,11,At Risk
36568,563,6,589.62,1,1,1,3,Hibernating
36569,268,7,943.34,2,1,2,5,Hibernating
36570,91,10,858.81,4,3,2,9,Loyal
36571,402,7,593.71,2,1,1,4,Hibernating
36572,619,4,2042.4500000000003,1,1,4,6,Regulars
36573,41,11,1303.92,5,3,3,11,Loyal
36574,96,10,3926.16,4,3,5,12,Loyal
36575,522,6,3486.9,1,1,5,7,Regulars
36576,553,8,2415.19,1,2,4,7,Regulars
36577,6,8,1319.71,5,2,3,10,Regulars
36578,116,13,1777.81,4,4,4,12,Champions
36579,820,11,1098.42,1,3,2,6,Regulars
36580,228,10,1802.0500000000002,3,3,4,10,Big Spenders
36581,553,6,819.63,1,1,1,3,Hibernating
36582,131,14,1473.15,4,5,3,12,Loyal
36583,108,6,611.53,4,1,1,6,Regulars
36584,5,12,1512.62,5,4,3,12,Loyal
36585,14,9,812.79,5,2,1,8,Regulars
36586,100,11,2954.15,4,3,5,12,Loyal
36587,296,6,527.35,2,1,1,4,Hibernating
36588,126,8,2097.13,4,2,4,10,Big Spenders
36589,121,15,1695.67,4,5,3,12,Loyal
36590,140,15,1240.08,4,5,2,11,Loyal
36591,56,5,204.69,5,1,1,7,Regulars
36592,368,8,737.54,2,2,1,5,Hibernating
36593,220,15,1371.93,3,5,3,11,Regulars
36594,161,11,1066.91,3,3,2,8,Regulars
36595,31,7,1763.8600000000001,5,1,4,10,Big Spenders
36596,88,10,632.84,4,3,1,8,Loyal
36597,295,13,3125.37,2,4,5,11,At Risk
36598,42,10,1619.1399999999999,5,3,3,11,Loyal
36599,972,7,1250.67,1,1,3,5,Regulars
36600,7,13,1667.3899999999999,5,4,3,12,Loyal
36601,140,6,696.97,4,1,1,6,Regulars
36602,76,7,645.5899999999999,4,1,1,6,Regulars
36603,31,10,1380.9,5,3,3,11,Loyal
36604,56,10,997.65,5,3,2,10,Loyal
36605,124,6,1623.88,4,1,3,8,Regulars
36606,1248,7,1867.31,1,1,4,6,Regulars
36607,188,6,730.98,3,1,1,5,Regulars
36608,761,12,2305.07,1,4,4,9,At Risk
36609,190,10,1279.1,3,3,3,9,Regulars
36610,56,11,3536.43,5,3,5,13,Loyal
36611,40,13,2600.27,5,4,5,14,Champions
36612,259,17,2126.06,2,5,4,11,At Risk
36613,144,10,1795.1,4,3,4,11,Loyal
36614,179,6,487.36,3,1,1,5,Regulars
36615,381,9,894.81,2,2,2,6,Hibernating
36616,822,2,29.39,1,1,1,3,Hibernating
36617,297,11,1220.41,2,3,2,7,Regulars
36618,232,18,2110.45,3,5,4,12,Big Spenders
36619,119,7,1585.9399999999998,4,1,3,8,Regulars
36620,295,9,2515.28,2,2,4,8,Regulars
36621,67,14,2149.53,4,5,4,13,Champions
36622,33,9,1261.82,5,2,3,10,Regulars
36623,210,15,3853.26,3,5,5,13,Big Spenders
36624,724,9,1005.86,1,2,2,5,Hibernating
36625,337,10,2476.9199999999996,2,3,4,9,Regulars
36626,226,16,1629.58,3,5,3,11,Regulars
36627,131,8,1817.37,4,2,4,10,Big Spenders
36628,597,9,454.84999999999997,1,2,1,4,Hibernating
36629,667,8,2008.97,1,2,4,7,Regulars
36630,75,8,629.35,4,2,1,7,Regulars
36631,203,17,2879.2299999999996,3,5,5,13,Big Spenders
36632,126,14,2309.69,4,5,4,13,Champions
36633,365,9,1150.63,2,2,2,6,Hibernating
36634,236,9,1577.46,3,2,3,8,Regulars
36635,502,8,1264.45,1,2,3,6,Regulars
36636,418,9,799.0600000000001,2,2,1,5,Hibernating
36637,262,16,1865.4,2,5,4,11,At Risk
36638,425,9,2422.73,2,2,4,8,Regulars
36639,40,11,2466.07,5,3,4,12,Loyal
36640,6,10,1019.85,5,3,2,10,Loyal
36641,197,20,2670.4,3,5,5,13,Big Spenders
36642,27,14,1493.33,5,5,3,13,Loyal
36643,33,16,3023.65,5,5,5,15,Champions
36644,45,4,633.3900000000001,5,1,1,7,Regulars
36645,18,8,1943.34,5,2,4,11,Big Spenders
36646,66,11,1510.3,4,3,3,10,Loyal
36647,373,9,549.4300000000001,2,2,1,5,Hibernating
36648,853,5,584.75,1,1,1,3,Hibernating
36649,31,10,1173.08,5,3,2,10,Loyal
36650,496,9,1890.1999999999998,1,2,4,7,Regulars
36651,46,12,2969.03,5,4,5,14,Champions
36652,182,12,1903.28,3,4,4,11,Big Spenders
36653,161,13,1360.38,3,4,3,10,Regulars
36654,222,10,1834.85,3,3,4,10,Big Spenders
36655,85,10,680.42,4,3,1,8,Loyal
36656,75,16,3380.72,4,5,5,14,Champions
36657,188,9,1056.6799999999998,3,2,2,7,Regulars
36658,607,9,951.4799999999999,1,2,2,5,Hibernating
36659,133,8,5310.65,4,2,5,11,Big Spenders
36660,16,13,3538.7400000000002,5,4,5,14,Champions
36661,171,8,661.6700000000001,3,2,1,6,Regulars
36662,166,8,2280.89,3,2,4,9,Big Spenders
36663,29,4,388.04999999999995,5,1,1,7,Regulars
36664,537,9,814.15,1,2,1,4,Hibernating
36665,507,8,561.9300000000001,1,2,1,4,Hibernating
36666,439,8,2897.77,2,2,5,9,Regulars
36667,24,7,1672.4,5,1,3,9,Regulars
36668,191,12,1544.76,3,4,3,10,Regulars
36669,38,12,1900.84,5,4,4,13,Champions
36670,314,7,1519.68,2,1,3,6,Regulars
36671,182,10,3432.39,3,3,5,11,Big Spenders
36672,9,9,1484.58,5,2,3,10,Regulars
36673,23,14,1513.55,5,5,3,13,Loyal
36674,182,12,1691.08,3,4,3,10,Regulars
36675,75,11,2117.1,4,3,4,11,Loyal
36676,4,5,343.6,5,1,1,7,Regulars
36677,71,13,2740.03,4,4,5,13,Champions
36678,279,15,2922.49,2,5,5,12,At Risk
36679,601,6,976.99,1,1,2,4,Hibernating
36680,129,7,947.78,4,1,2,7,Regulars
36681,174,14,1501.23,3,5,3,11,Regulars
36682,31,9,2263.94,5,2,4,11,Big Spenders
36683,546,9,1159.33,1,2,2,5,Hibernating
36684,476,6,498.6,1,1,1,3,Hibernating
36685,336,8,2199.12,2,2,4,8,Regulars
36686,126,11,3669.2799999999997,4,3,5,12,Loyal
36687,111,14,3480.8700000000003,4,5,5,14,Champions
36688,33,8,1023.9,5,2,2,9,Regulars
36689,167,3,170.42000000000002,3,1,1,5,Regulars
36690,774,5,1135.3,1,1,2,4,Hibernating
36691,112,12,598.7,4,4,1,9,Loyal
36692,106,5,2080.4000000000005,4,1,4,9,Big Spenders
36693,59,16,4566.31,5,5,5,15,Champions
36694,929,9,521.51,1,2,1,4,Hibernating
36695,1592,5,1108.4499999999998,1,1,2,4,Hibernating
36696,490,9,3293.75,1,2,5,8,Regulars
36697,290,14,2296.76,2,5,4,11,At Risk
36698,260,8,2262.09,2,2,4,8,Regulars
36699,197,7,2511.66,3,1,4,8,Big Spenders
36700,201,4,384.99,3,1,1,5,Regulars
36701,898,9,677.79,1,2,1,4,Hibernating
36702,641,8,1215.73,1,2,2,5,Hibernating
36703,805,10,1420.95,1,3,3,7,Regulars
36704,60,12,1404.47,5,4,3,12,Loyal
36705,200,12,775.93,3,4,1,8,Regulars
36706,55,12,3128.97,5,4,5,14,Champions
36707,171,8,1660.89,3,2,3,8,Regulars
36708,301,4,468.1,2,1,1,4,Hibernating
36709,53,13,1415.9,5,4,3,12,Loyal
36710,571,5,624.32,1,1,1,3,Hibernating
36711,191,11,3986.42,3,3,5,11,Big Spenders
36712,13,11,1225.93,5,3,2,10,Loyal
36713,425,12,3693.5,2,4,5,11,At Risk
36714,115,11,1460.9299999999998,4,3,3,10,Loyal
36715,127,8,787.2399999999999,4,2,1,7,Regulars
36716,83,9,629.73,4,2,1,7,Regulars
36717,594,5,895.6899999999999,1,1,2,4,Hibernating
36718,174,9,1913.28,3,2,4,9,Big Spenders
36719,143,9,765.33,4,2,1,7,Regulars
36720,126,8,1365.2199999999998,4,2,3,9,Regulars
36721,438,9,3445.73,2,2,5,9,Regulars
36722,373,11,4304.54,2,3,5,10,Regulars
36723,93,13,4777.349999999999,4,4,5,13,Champions
36724,586,14,1566.28,1,5,3,9,At Risk
36725,334,8,1532.03,2,2,3,7,Regulars
36726,371,14,2879.56,2,5,5,12,At Risk
36727,71,16,3435.36,4,5,5,14,Champions
36728,156,8,659.19,3,2,1,6,Regulars
36729,1562,10,2820.42,1,3,5,9,Regulars
36730,171,9,1243.55,3,2,3,8,Regulars
36731,50,6,765.03,5,1,1,7,Regulars
36732,167,12,1948.22,3,4,4,11,Big Spenders
36733,50,11,2198.58,5,3,4,12,Loyal
36734,15,14,1199.67,5,5,2,12,Loyal
36735,495,9,2502.29,1,2,4,7,Regulars
36736,755,8,1662.17,1,2,3,6,Regulars
36737,9,14,2244.75,5,5,4,14,Champions
36738,182,10,1304.62,3,3,3,9,Regulars
36739,101,4,1586.23,4,1,3,8,Regulars
36740,274,10,1083.03,2,3,2,7,Regulars
36741,435,8,455.21,2,2,1,5,Hibernating
36742,23,14,2137.59,5,5,4,14,Champions
36743,92,6,727.2,4,1,1,6,Regulars
36744,113,4,484.23,4,1,1,6,Regulars
36745,203,8,572.5799999999999,3,2,1,6,Regulars
36746,755,10,879.97,1,3,2,6,Regulars
36747,427,7,671.33,2,1,1,4,Hibernating
36748,70,8,3050.3,4,2,5,11,Big Spenders
36749,236,9,719.6800000000001,3,2,1,6,Regulars
36750,346,9,1261.6100000000001,2,2,3,7,Regulars
36751,553,12,1654.42,1,4,3,8,At Risk
36752,830,9,3670.0200000000004,1,2,5,8,Regulars
36753,50,14,1502.94,5,5,3,13,Loyal
36754,504,6,518.1400000000001,1,1,1,3,Hibernating
36755,245,10,1082.77,3,3,2,8,Regulars
36756,1253,4,392.34,1,1,1,3,Hibernating
36757,356,11,870.55,2,3,2,7,Regulars
36758,10,10,1111.07,5,3,2,10,Loyal
36759,533,9,2146.53,1,2,4,7,Regulars
36760,298,7,1792.62,2,1,4,7,Regulars
36761,17,15,1795.77,5,5,4,14,Champions
36762,530,5,255.82,1,1,1,3,Hibernating
36763,583,16,2147.58,1,5,4,10,At Risk
36764,205,10,1582.05,3,3,3,9,Regulars
36765,143,13,2596.81,4,4,5,13,Champions
36766,324,10,2521.11,2,3,4,9,Regulars
36767,391,13,1485.82,2,4,3,9,At Risk
36768,807,10,1091.5,1,3,2,6,Regulars
36769,262,10,2334.41,2,3,4,9,Regulars
36770,8,16,1507.06,5,5,3,13,Loyal
36771,221,14,1557.58,3,5,3,11,Regulars
36772,598,14,1496.6,1,5,3,9,At Risk
36773,34,13,1019.87,5,4,2,11,Loyal
36774,1211,7,678.76,1,1,1,3,Hibernating
36775,181,8,1682.5800000000002,3,2,3,8,Regulars
36776,70,12,1477.73,4,4,3,11,Loyal
36777,23,8,724.12,5,2,1,8,Regulars
36778,166,20,4188.2,3,5,5,13,Big Spenders
36779,399,6,748.68,2,1,1,4,Hibernating
36780,305,4,420.84000000000003,2,1,1,4,Hibernating
36781,407,9,778.86,2,2,1,5,Hibernating
36782,311,10,1558.2,2,3,3,8,Regulars
36783,197,11,1469.08,3,3,3,9,Regulars
36784,249,12,2460.4,2,4,4,10,At Risk
36785,501,13,1783.48,1,4,4,9,At Risk
36786,702,8,1198.87,1,2,2,5,Hibernating
36787,30,14,1565.72,5,5,3,13,Loyal
36788,180,13,3463.05,3,4,5,12,Big Spenders
36789,99,17,3220.2999999999997,4,5,5,14,Champions
36790,238,8,1205.74,3,2,2,7,Regulars
36791,522,13,6123.210000000001,1,4,5,10,At Risk
36792,171,14,5223.29,3,5,5,13,Big Spenders
36793,627,9,1149.27,1,2,2,5,Hibernating
36794,237,8,585.0,3,2,1,6,Regulars
36795,118,19,4207.09,4,5,5,14,Champions
36796,262,15,1535.29,2,5,3,10,At Risk
36797,477,12,1897.3600000000001,1,4,4,9,At Risk
36798,40,10,1640.71,5,3,3,11,Loyal
36799,167,15,5339.110000000001,3,5,5,13,Big Spenders
36800,183,13,2601.05,3,4,5,12,Big Spenders
36801,281,12,1850.72,2,4,4,10,At Risk
36802,292,9,2749.27,2,2,5,9,Regulars
36803,164,10,2256.97,3,3,4,10,Big Spenders
36804,1460,6,913.51,1,1,2,4,Hibernating
36805,252,13,1012.5600000000001,2,4,2,8,At Risk
36806,521,5,851.24,1,1,2,4,Hibernating
36807,1003,7,460.79,1,1,1,3,Hibernating
36808,1503,4,286.67,1,1,1,3,Hibernating
36809,48,8,826.42,5,2,1,8,Regulars
36810,54,6,733.37,5,1,1,7,Regulars
36811,117,13,1336.92,4,4,3,11,Loyal
36812,7,10,1901.1599999999999,5,3,4,12,Loyal
36813,163,11,708.63,3,3,1,7,Regulars
36814,116,8,608.99,4,2,1,7,Regulars
36815,99,7,1341.4299999999998,4,1,3,8,Regulars
36816,357,10,1656.0800000000002,2,3,3,8,Regulars
36817,362,8,1564.21,2,2,3,7,Regulars
36818,82,7,417.70000000000005,4,1,1,6,Regulars
36819,77,10,1996.8600000000001,4,3,4,11,Loyal
36820,134,9,638.84,4,2,1,7,Regulars
36821,167,13,1236.15,3,4,2,9,Regulars
36822,6,14,1175.32,5,5,2,12,Loyal
36823,385,8,818.49,2,2,1,5,Hibernating
36824,69,10,668.6800000000001,4,3,1,8,Loyal
36825,862,7,812.03,1,1,1,3,Hibernating
36826,53,12,1287.06,5,4,3,12,Loyal
36827,149,10,512.85,3,3,1,7,Regulars
36828,481,14,1754.46,1,5,4,10,At Risk
36829,225,8,1617.9099999999999,3,2,3,8,Regulars
36830,528,9,2109.21,1,2,4,7,Regulars
36831,950,11,930.11,1,3,2,6,Regulars
36832,589,12,933.12,1,4,2,7,At Risk
36833,205,10,3912.6499999999996,3,3,5,11,Big Spenders
36834,224,9,1946.36,3,2,4,9,Big Spenders
36835,144,16,3025.71,4,5,5,14,Champions
36836,193,6,267.96,3,1,1,5,Regulars
36837,286,8,3821.29,2,2,5,9,Regulars
36838,229,15,3564.33,3,5,5,13,Big Spenders
36839,570,9,1687.79,1,2,3,6,Regulars
36840,88,12,2414.62,4,4,4,12,Champions
36841,478,7,493.58000000000004,1,1,1,3,Hibernating
36842,248,12,2101.77,2,4,4,10,At Risk
36843,50,7,1092.79,5,1,2,8,Regulars
36844,312,10,843.09,2,3,1,6,Regulars
36845,116,6,457.89,4,1,1,6,Regulars
36846,99,7,309.47,4,1,1,6,Regulars
36847,139,8,645.18,4,2,1,7,Regulars
36848,175,9,1004.9,3,2,2,7,Regulars
36849,500,12,888.03,1,4,2,7,At Risk
36850,128,10,3933.39,4,3,5,12,Loyal
36851,549,12,3580.5499999999997,1,4,5,10,At Risk
36852,135,9,3231.78,4,2,5,11,Big Spenders
36853,120,13,2694.06,4,4,5,13,Champions
36854,108,6,2283.1800000000003,4,1,4,9,Big Spenders
36855,492,14,2227.7799999999997,1,5,4,10,At Risk
36856,101,13,1878.09,4,4,4,12,Champions
36857,427,8,714.53,2,2,1,5,Hibernating
36858,74,13,4403.999999999999,4,4,5,13,Champions
36859,180,6,2192.86,3,1,4,8,Big Spenders
36860,49,11,926.89,5,3,2,10,Loyal
36861,471,10,3455.35,1,3,5,9,Regulars
36862,97,13,1512.46,4,4,3,11,Loyal
36863,497,9,967.1700000000001,1,2,2,5,Hibernating
36864,110,6,869.43,4,1,2,7,Regulars
36865,5,9,1594.57,5,2,3,10,Regulars
36866,7,10,2433.02,5,3,4,12,Loyal
36867,284,12,2251.55,2,4,4,10,At Risk
36868,680,7,492.45,1,1,1,3,Hibernating
36869,276,14,3953.33,2,5,5,12,At Risk
36870,174,13,3516.4100000000003,3,4,5,12,Big Spenders
36871,83,13,3427.72,4,4,5,13,Champions
36872,18,9,1689.75,5,2,3,10,Regulars
36873,9,9,1427.89,5,2,3,10,Regulars
36874,162,13,2213.33,3,4,4,11,Big Spenders
36875,1169,9,3105.7599999999998,1,2,5,8,Regulars
36876,491,11,575.2900000000001,1,3,1,5,Regulars
36877,143,12,1001.53,4,4,2,10,Loyal
36878,118,6,418.45,4,1,1,6,Regulars
36879,99,10,870.8000000000001,4,3,2,9,Loyal
36880,111,11,2062.99,4,3,4,11,Loyal
36881,182,11,1540.37,3,3,3,9,Regulars
36882,218,10,866.4200000000001,3,3,2,8,Regulars
36883,190,15,1472.67,3,5,3,11,Regulars
36884,183,9,734.71,3,2,1,6,Regulars
36885,308,7,1123.28,2,1,2,5,Hibernating
36886,75,13,1665.68,4,4,3,11,Loyal
36887,511,7,1922.8700000000001,1,1,4,6,Regulars
36888,229,14,1501.6499999999999,3,5,3,11,Regulars
36889,131,16,4620.2699999999995,4,5,5,14,Champions
36890,41,5,496.54999999999995,5,1,1,7,Regulars
36891,448,12,1704.42,2,4,3,9,At Risk
36892,624,10,1115.39,1,3,2,6,Regulars
36893,63,18,2522.08,5,5,4,14,Champions
36894,420,12,2821.11,2,4,5,11,At Risk
36895,93,11,1352.06,4,3,3,10,Loyal
36896,515,7,486.72999999999996,1,1,1,3,Hibernating
36897,724,7,763.03,1,1,1,3,Hibernating
36898,208,11,1171.07,3,3,2,8,Regulars
36899,163,12,1466.34,3,4,3,10,Regulars
36900,543,7,630.16,1,1,1,3,Hibernating
36901,318,10,896.92,2,3,2,7,Regulars
36902,184,9,1030.73,3,2,2,7,Regulars
36903,139,9,1243.75,4,2,3,9,Regulars
36904,295,13,1898.21,2,4,4,10,At Risk
36905,168,12,4033.7200000000003,3,4,5,12,Big Spenders
36906,193,7,938.73,3,1,2,6,Regulars
36907,149,9,2056.11,3,2,4,9,Big Spenders
36908,115,10,1403.12,4,3,3,10,Loyal
36909,1006,9,2014.7800000000002,1,2,4,7,Regulars
36910,382,13,4273.07,2,4,5,11,At Risk
36911,45,10,3728.58,5,3,5,13,Loyal
36912,850,5,826.07,1,1,1,3,Hibernating
36913,243,12,1930.18,3,4,4,11,Big Spenders
36914,133,17,3011.66,4,5,5,14,Champions
36915,139,10,1364.72,4,3,3,10,Loyal
36916,892,11,1141.22,1,3,2,6,Regulars
36917,172,12,3418.11,3,4,5,12,Big Spenders
36918,90,9,1310.24,4,2,3,9,Regulars
36919,342,8,827.89,2,2,1,5,Hibernating
36920,85,13,1664.1100000000001,4,4,3,11,Loyal
36921,119,10,1239.8700000000001,4,3,2,9,Loyal
36922,20,11,1194.62,5,3,2,10,Loyal
36923,376,14,3184.7000000000003,2,5,5,12,At Risk
36924,110,10,1954.29,4,3,4,11,Loyal
36925,303,11,1677.11,2,3,3,8,Regulars
36926,131,9,968.2199999999999,4,2,2,8,Regulars
36927,184,7,590.23,3,1,1,5,Regulars
36928,16,19,5041.2,5,5,5,15,Champions
36929,17,9,2360.2599999999998,5,2,4,11,Big Spenders
36930,201,6,1813.44,3,1,4,8,Big Spenders
36931,209,15,1910.1200000000001,3,5,4,12,Big Spenders
36932,115,6,651.48,4,1,1,6,Regulars
36933,571,11,1343.87,1,3,3,7,Regulars
36934,197,13,1557.83,3,4,3,10,Regulars
36935,226,11,2855.87,3,3,5,11,Big Spenders
36936,212,14,1722.88,3,5,3,11,Regulars
36937,348,7,1589.37,2,1,3,6,Regulars
36938,182,13,2831.82,3,4,5,12,Big Spenders
36939,74,11,2081.6,4,3,4,11,Loyal
36940,222,13,1757.04,3,4,4,11,Big Spenders
36941,155,13,4180.53,3,4,5,12,Big Spenders
36942,1933,2,361.32,1,1,1,3,Hibernating
36943,426,9,1657.8899999999999,2,2,3,7,Regulars
36944,188,10,2315.52,3,3,4,10,Big Spenders
36945,482,7,2119.7599999999998,1,1,4,6,Regulars
36946,414,7,2868.3,2,1,5,8,Regulars
36947,90,11,1245.09,4,3,3,10,Loyal
36948,521,10,718.4,1,3,1,5,Regulars
36949,166,6,303.22,3,1,1,5,Regulars
36950,166,9,2138.93,3,2,4,9,Big Spenders
36951,95,13,1873.1200000000001,4,4,4,12,Champions
36952,497,10,1247.48,1,3,3,7,Regulars
36953,152,17,2216.89,3,5,4,12,Big Spenders
36954,5,10,1015.0,5,3,2,10,Loyal
36955,123,7,975.9200000000001,4,1,2,7,Regulars
36956,29,10,2136.09,5,3,4,12,Loyal
36957,604,9,842.39,1,2,1,4,Hibernating
36958,45,10,944.61,5,3,2,10,Loyal
36959,58,14,3702.61,5,5,5,15,Champions
36960,792,10,1822.3600000000001,1,3,4,8,Regulars
36961,344,9,1136.18,2,2,2,6,Hibernating
36962,262,5,254.83,2,1,1,4,Hibernating
36963,42,8,1627.42,5,2,3,10,Regulars
36964,205,9,641.8199999999999,3,2,1,6,Regulars
36965,218,7,715.27,3,1,1,5,Regulars
36966,262,12,1367.02,2,4,3,9,At Risk
36967,475,10,1291.32,1,3,3,7,Regulars
36968,1054,5,917.8499999999999,1,1,2,4,Hibernating
36969,65,12,1485.76,5,4,3,12,Loyal
36970,194,9,1809.3600000000001,3,2,4,9,Big Spenders
36971,46,12,1082.45,5,4,2,11,Loyal
36972,22,16,3233.66,5,5,5,15,Champions
36973,52,15,3617.77,5,5,5,15,Champions
36974,611,11,1701.74,1,3,3,7,Regulars
36975,14,8,615.08,5,2,1,8,Regulars
36976,770,9,507.08000000000004,1,2,1,4,Hibernating
36977,169,9,971.32,3,2,2,7,Regulars
36978,45,10,1993.7900000000002,5,3,4,12,Loyal
36979,87,12,1808.04,4,4,4,12,Champions
36980,92,9,1588.6399999999999,4,2,3,9,Regulars
36981,155,12,4518.57,3,4,5,12,Big Spenders
36982,336,12,960.6700000000001,2,4,2,8,At Risk
36983,223,14,4070.4900000000002,3,5,5,13,Big Spenders
36984,1235,9,2655.45,1,2,5,8,Regulars
36985,184,10,3518.13,3,3,5,11,Big Spenders
36986,264,11,7322.360000000001,2,3,5,10,Regulars
36987,90,13,2143.03,4,4,4,12,Champions
36988,62,9,1451.72,5,2,3,10,Regulars
36989,274,9,1452.37,2,2,3,7,Regulars
36990,17,8,1176.18,5,2,2,9,Regulars
36991,824,9,3141.58,1,2,5,8,Regulars
36992,103,13,712.99,4,4,1,9,Loyal
36993,156,8,1046.1399999999999,3,2,2,7,Regulars
36994,195,9,4156.32,3,2,5,10,Big Spenders
36995,358,8,1026.29,2,2,2,6,Hibernating
36996,92,13,1423.29,4,4,3,11,Loyal
36997,786,10,2534.9999999999995,1,3,4,8,Regulars
36998,470,5,1222.68,1,1,2,4,Hibernating
36999,44,9,1653.04,5,2,3,10,Regulars
37000,451,8,601.2,2,2,1,5,Hibernating
37001,1118,3,217.62,1,1,1,3,Hibernating
37002,374,10,1738.3600000000001,2,3,4,9,Regulars
37003,354,10,977.1899999999999,2,3,2,7,Regulars
37004,225,12,1314.17,3,4,3,10,Regulars
37005,41,14,3740.59,5,5,5,15,Champions
37006,567,8,1644.96,1,2,3,6,Regulars
37007,524,4,323.90999999999997,1,1,1,3,Hibernating
37008,1174,7,1045.1399999999999,1,1,2,4,Hibernating
37009,21,12,3588.8500000000004,5,4,5,14,Champions
37010,30,10,3654.5099999999998,5,3,5,13,Loyal
37011,431,7,1212.67,2,1,2,5,Hibernating
37012,85,7,423.6,4,1,1,6,Regulars
37013,491,6,520.02,1,1,1,3,Hibernating
37014,289,10,1400.9799999999998,2,3,3,8,Regulars
37015,1104,4,223.66000000000003,1,1,1,3,Hibernating
37016,183,12,1702.6200000000001,3,4,3,10,Regulars
37017,148,12,1572.5,3,4,3,10,Regulars
37018,204,8,1217.21,3,2,2,7,Regulars
37019,470,10,1157.33,1,3,2,6,Regulars
37020,196,12,1413.1,3,4,3,10,Regulars
37021,369,11,1389.05,2,3,3,8,Regulars
37022,148,11,1077.13,3,3,2,8,Regulars
37023,448,7,550.63,2,1,1,4,Hibernating
37024,318,10,3522.75,2,3,5,10,Regulars
37025,561,9,542.31,1,2,1,4,Hibernating
37026,52,12,1019.59,5,4,2,11,Loyal
37027,235,10,2208.3799999999997,3,3,4,10,Big Spenders
37028,870,13,1048.15,1,4,2,7,At Risk
37029,22,12,4735.42,5,4,5,14,Champions
37030,30,14,3058.06,5,5,5,15,Champions
37031,139,9,848.4,4,2,2,8,Regulars
37032,156,12,1154.12,3,4,2,9,Regulars
37033,470,11,1067.29,1,3,2,6,Regulars
37034,133,11,3581.83,4,3,5,12,Loyal
37035,48,12,1329.5700000000002,5,4,3,12,Loyal
37036,224,10,909.09,3,3,2,8,Regulars
37037,116,8,2120.9500000000003,4,2,4,10,Big Spenders
37038,75,12,1348.51,4,4,3,11,Loyal
37039,397,8,2661.88,2,2,5,9,Regulars
37040,4,9,1304.77,5,2,3,10,Regulars
37041,478,11,1652.49,1,3,3,7,Regulars
37042,102,10,1182.56,4,3,2,9,Loyal
37043,164,11,1591.82,3,3,3,9,Regulars
37044,801,6,982.66,1,1,2,4,Hibernating
37045,60,10,5085.78,5,3,5,13,Loyal
37046,997,11,2969.39,1,3,5,9,Regulars
37047,106,11,1570.5900000000001,4,3,3,10,Loyal
37048,141,13,2037.65,4,4,4,12,Champions
37049,609,11,609.38,1,3,1,5,Regulars
37050,165,13,982.52,3,4,2,9,Regulars
37051,8,7,636.14,5,1,1,7,Regulars
37052,69,11,1140.3700000000001,4,3,2,9,Loyal
37053,0,15,1354.49,5,5,3,13,Loyal
37054,560,11,1854.5100000000002,1,3,4,8,Regulars
37055,60,6,621.42,5,1,1,7,Regulars
37056,30,9,3308.19,5,2,5,12,Big Spenders
37057,263,11,1080.59,2,3,2,7,Regulars
37058,56,12,2692.5899999999997,5,4,5,14,Champions
37059,564,7,735.0699999999999,1,1,1,3,Hibernating
37060,149,13,1449.2,3,4,3,10,Regulars
37061,62,8,931.02,5,2,2,9,Regulars
37062,564,8,2147.56,1,2,4,7,Regulars
37063,472,14,1008.64,1,5,2,8,At Risk
37064,16,13,2520.92,5,4,4,13,Champions
37065,188,12,1111.77,3,4,2,9,Regulars
37066,545,15,3763.64,1,5,5,11,At Risk
37067,87,10,770.34,4,3,1,8,Loyal
37068,340,10,2044.1399999999999,2,3,4,9,Regulars
37069,52,9,3129.52,5,2,5,12,Big Spenders
37070,25,17,1645.75,5,5,3,13,Loyal
37071,75,11,1118.45,4,3,2,9,Loyal
37072,19,10,907.93,5,3,2,10,Loyal
37073,22,8,649.99,5,2,1,8,Regulars
37074,650,7,598.75,1,1,1,3,Hibernating
37075,119,9,2503.31,4,2,4,10,Big Spenders
37076,118,16,1770.36,4,5,4,13,Champions
37077,103,14,6270.0599999999995,4,5,5,14,Champions
37078,348,10,1244.1399999999999,2,3,3,8,Regulars
37079,179,11,3648.11,3,3,5,11,Big Spenders
37080,348,10,950.6800000000001,2,3,2,7,Regulars
37081,108,9,1643.85,4,2,3,9,Regulars
37082,456,7,2163.8999999999996,2,1,4,7,Regulars
37083,172,5,587.8199999999999,3,1,1,5,Regulars
37084,40,15,4738.47,5,5,5,15,Champions
37085,1155,6,1248.54,1,1,3,5,Regulars
37086,524,7,1282.5500000000002,1,1,3,5,Regulars
37087,70,18,2969.27,4,5,5,14,Champions
37088,106,6,1286.77,4,1,3,8,Regulars
37089,312,15,1890.18,2,5,4,11,At Risk
37090,728,8,1248.1399999999999,1,2,3,6,Regulars
37091,468,5,728.3199999999999,1,1,1,3,Hibernating
37092,594,8,1921.14,1,2,4,7,Regulars
37093,59,18,1606.74,5,5,3,13,Loyal
37094,413,10,2068.1600000000003,2,3,4,9,Regulars
37095,459,17,1645.71,2,5,3,10,At Risk
37096,167,11,2213.36,3,3,4,10,Big Spenders
37097,147,9,1272.0,4,2,3,9,Regulars
37098,209,14,2692.2999999999997,3,5,5,13,Big Spenders
37099,427,7,532.64,2,1,1,4,Hibernating
37100,97,5,1521.02,4,1,3,8,Regulars
37101,473,14,1635.1699999999998,1,5,3,9,At Risk
37102,61,11,4285.7,5,3,5,13,Loyal
37103,481,10,1273.25,1,3,3,7,Regulars
37104,771,10,1115.94,1,3,2,6,Regulars
37105,229,4,213.86,3,1,1,5,Regulars
37106,9,9,972.75,5,2,2,9,Regulars
37107,683,10,1035.07,1,3,2,6,Regulars
37108,205,13,1699.49,3,4,3,10,Regulars
37109,18,12,1333.5500000000002,5,4,3,12,Loyal
37110,216,9,6134.74,3,2,5,10,Big Spenders
37111,561,13,1696.3200000000002,1,4,3,8,At Risk
37112,98,11,1998.28,4,3,4,11,Loyal
37113,38,7,1025.6000000000001,5,1,2,8,Regulars
37114,23,9,1294.89,5,2,3,10,Regulars
37115,385,7,530.73,2,1,1,4,Hibernating
37116,335,6,529.61,2,1,1,4,Hibernating
37117,584,7,520.96,1,1,1,3,Hibernating
37118,100,13,2947.21,4,4,5,13,Champions
37119,90,12,4052.7200000000003,4,4,5,13,Champions
37120,81,13,1534.29,4,4,3,11,Loyal
37121,308,13,3565.8399999999997,2,4,5,11,At Risk
37122,66,16,1568.47,4,5,3,12,Loyal
37123,11,12,737.37,5,4,1,10,Loyal
37124,139,13,2805.45,4,4,5,13,Champions
37125,266,12,2199.75,2,4,4,10,At Risk
37126,215,8,2676.0299999999997,3,2,5,10,Big Spenders
37127,195,7,761.54,3,1,1,5,Regulars
37128,505,10,1372.95,1,3,3,7,Regulars
37129,234,11,1342.69,3,3,3,9,Regulars
37130,515,10,2197.7299999999996,1,3,4,8,Regulars
37131,33,10,1091.81,5,3,2,10,Loyal
37132,27,10,895.38,5,3,2,10,Loyal
37133,156,10,3189.38,3,3,5,11,Big Spenders
37134,332,7,2089.02,2,1,4,7,Regulars
37135,175,15,3341.92,3,5,5,13,Big Spenders
37136,52,9,3198.66,5,2,5,12,Big Spenders
37137,130,6,2009.0,4,1,4,9,Big Spenders
37138,117,10,804.1700000000001,4,3,1,8,Loyal
37139,46,15,5309.24,5,5,5,15,Champions
37140,751,10,691.27,1,3,1,5,Regulars
37141,517,7,611.85,1,1,1,3,Hibernating
37142,52,8,1350.48,5,2,3,10,Regulars
37143,407,13,2617.5099999999998,2,4,5,11,At Risk
37144,14,7,406.38,5,1,1,7,Regulars
37145,1,8,2504.4,5,2,4,11,Big Spenders
37146,45,15,3538.5499999999997,5,5,5,15,Champions
37147,40,15,1478.01,5,5,3,13,Loyal
37148,234,16,2909.21,3,5,5,13,Big Spenders
37149,0,11,1433.29,5,3,3,11,Loyal
37150,199,11,2345.77,3,3,4,10,Big Spenders
37151,196,12,1911.18,3,4,4,11,Big Spenders
37152,121,11,952.1,4,3,2,9,Loyal
37153,0,12,1301.8799999999999,5,4,3,12,Loyal
37154,164,8,739.04,3,2,1,6,Regulars
37155,101,9,1568.65,4,2,3,9,Regulars
37156,1103,10,1449.75,1,3,3,7,Regulars
37157,513,12,2927.1,1,4,5,10,At Risk
37158,203,17,4075.26,3,5,5,13,Big Spenders
37159,394,11,1877.1200000000001,2,3,4,9,Regulars
37160,221,7,1584.3899999999999,3,1,3,7,Regulars
37161,46,11,1060.99,5,3,2,10,Loyal
37162,5,12,1406.7,5,4,3,12,Loyal
37163,472,14,1584.8600000000001,1,5,3,9,At Risk
37164,363,10,732.6,2,3,1,6,Regulars
37165,419,11,865.91,2,3,2,7,Regulars
37166,1,9,1923.53,5,2,4,11,Big Spenders
37167,127,7,3253.5600000000004,4,1,5,10,Big Spenders
37168,485,11,4320.91,1,3,5,9,Regulars
37169,254,12,2083.99,2,4,4,10,At Risk
37170,305,8,2008.8899999999999,2,2,4,8,Regulars
37171,200,10,1805.08,3,3,4,10,Big Spenders
37172,726,6,811.85,1,1,1,3,Hibernating
37173,194,12,1949.51,3,4,4,11,Big Spenders
37174,307,12,747.93,2,4,1,7,At Risk
37175,404,10,1911.3200000000002,2,3,4,9,Regulars
37176,85,6,373.57,4,1,1,6,Regulars
37177,115,8,1248.8100000000002,4,2,3,9,Regulars
37178,418,5,260.90999999999997,2,1,1,4,Hibernating
37179,53,9,678.1800000000001,5,2,1,8,Regulars
37180,193,7,2020.1299999999999,3,1,4,8,Big Spenders
37181,137,8,1265.31,4,2,3,9,Regulars
37182,173,10,701.67,3,3,1,7,Regulars
37183,69,8,1985.9500000000003,4,2,4,10,Big Spenders
37184,65,13,1536.41,5,4,3,12,Loyal
37185,65,8,1130.61,5,2,2,9,Regulars
37186,439,9,1774.4,2,2,4,8,Regulars
37187,350,8,1343.0700000000002,2,2,3,7,Regulars
37188,202,15,2934.8199999999997,3,5,5,13,Big Spenders
37189,43,7,611.0500000000001,5,1,1,7,Regulars
37190,233,10,686.3000000000001,3,3,1,7,Regulars
37191,25,16,2300.1,5,5,4,14,Champions
37192,362,13,1530.1,2,4,3,9,At Risk
37193,123,15,3299.0,4,5,5,14,Champions
37194,60,6,625.66,5,1,1,7,Regulars
37195,21,6,496.89,5,1,1,7,Regulars
37196,62,7,2218.92,5,1,4,10,Big Spenders
37197,53,10,2202.24,5,3,4,12,Loyal
37198,627,16,3776.13,1,5,5,11,At Risk
37199,29,14,1952.44,5,5,4,14,Champions
37200,378,10,2751.67,2,3,5,10,Regulars
37201,1159,4,215.38,1,1,1,3,Hibernating
37202,92,11,1215.13,4,3,2,9,Loyal
37203,35,10,711.47,5,3,1,9,Loyal
37204,76,11,5694.74,4,3,5,12,Loyal
37205,176,10,2017.77,3,3,4,10,Big Spenders
37206,849,8,901.1800000000001,1,2,2,5,Hibernating
37207,142,11,1826.06,4,3,4,11,Loyal
37208,128,16,3916.1,4,5,5,14,Champions
37209,268,9,835.79,2,2,1,5,Hibernating
37210,199,17,4805.97,3,5,5,13,Big Spenders
37211,153,11,1629.22,3,3,3,9,Regulars
37212,488,8,399.32,1,2,1,4,Hibernating
37213,33,7,1750.2199999999998,5,1,4,10,Big Spenders
37214,164,8,1806.54,3,2,4,9,Big Spenders
37215,42,11,1075.27,5,3,2,10,Loyal
37216,159,11,2247.14,3,3,4,10,Big Spenders
37217,60,8,1328.77,5,2,3,10,Regulars
37218,502,8,312.81,1,2,1,4,Hibernating
37219,307,12,2800.38,2,4,5,11,At Risk
37220,430,11,1490.55,2,3,3,8,Regulars
37221,239,12,1736.05,3,4,4,11,Big Spenders
37222,617,12,2213.55,1,4,4,9,At Risk
37223,148,11,1190.3999999999999,3,3,2,8,Regulars
37224,883,12,2993.2799999999997,1,4,5,10,At Risk
37225,582,7,891.9,1,1,2,4,Hibernating
37226,239,7,1015.55,3,1,2,6,Regulars
37227,154,14,1262.65,3,5,3,11,Regulars
37228,145,13,2153.31,4,4,4,12,Champions
37229,391,11,4019.9500000000003,2,3,5,10,Regulars
37230,148,14,1263.91,3,5,3,11,Regulars
37231,514,12,3582.0299999999997,1,4,5,10,At Risk
37232,9,11,3042.3799999999997,5,3,5,13,Loyal
37233,159,11,2245.0299999999997,3,3,4,10,Big Spenders
37234,534,5,1179.78,1,1,2,4,Hibernating
37235,172,12,1710.7600000000002,3,4,3,10,Regulars
37236,447,4,398.94000000000005,2,1,1,4,Hibernating
37237,211,13,3031.8000000000006,3,4,5,12,Big Spenders
37238,126,12,2097.93,4,4,4,12,Champions
37239,70,9,2453.02,4,2,4,10,Big Spenders
37240,13,11,1390.67,5,3,3,11,Loyal
37241,139,12,1677.07,4,4,3,11,Loyal
37242,2,4,635.88,5,1,1,7,Regulars
37243,492,14,3101.42,1,5,5,11,At Risk
37244,292,7,647.14,2,1,1,4,Hibernating
37245,183,15,3077.83,3,5,5,13,Big Spenders
37246,274,16,3045.98,2,5,5,12,At Risk
37247,54,9,1436.19,5,2,3,10,Regulars
37248,400,14,3299.57,2,5,5,12,At Risk
37249,222,13,1358.05,3,4,3,10,Regulars
37250,49,13,2580.69,5,4,5,14,Champions
37251,16,12,1105.69,5,4,2,11,Loyal
37252,329,10,4164.58,2,3,5,10,Regulars
37253,426,8,406.72999999999996,2,2,1,5,Hibernating
37254,494,4,2043.6899999999996,1,1,4,6,Regulars
37255,5,15,1977.4,5,5,4,14,Champions
37256,145,10,1397.23,4,3,3,10,Loyal
37257,360,12,1520.55,2,4,3,9,At Risk
37258,172,9,2170.96,3,2,4,9,Big Spenders
37259,98,10,1168.49,4,3,2,9,Loyal
37260,331,8,592.15,2,2,1,5,Hibernating
37261,129,11,2635.5,4,3,5,12,Loyal
37262,380,7,1205.43,2,1,2,5,Hibernating
37263,43,11,1286.28,5,3,3,11,Loyal
37264,179,8,955.6500000000001,3,2,2,7,Regulars
37265,189,13,1260.97,3,4,3,10,Regulars
37266,231,13,1281.08,3,4,3,10,Regulars
37267,3,17,3435.7,5,5,5,15,Champions
37268,196,10,1109.8899999999999,3,3,2,8,Regulars
37269,194,10,783.38,3,3,1,7,Regulars
37270,0,10,1193.43,5,3,2,10,Loyal
37271,19,13,1576.5,5,4,3,12,Loyal
37272,2,8,603.97,5,2,1,8,Regulars
37273,682,11,1575.3200000000002,1,3,3,7,Regulars
37274,507,6,467.15,1,1,1,3,Hibernating
37275,22,12,1006.75,5,4,2,11,Loyal
37276,262,18,1564.51,2,5,3,10,At Risk
37277,70,12,1842.76,4,4,4,12,Champions
37278,243,16,2857.79,3,5,5,13,Big Spenders
37279,29,10,4374.55,5,3,5,13,Loyal
37280,287,10,853.97,2,3,2,7,Regulars
37281,643,13,1988.8500000000001,1,4,4,9,At Risk
37282,537,5,256.5,1,1,1,3,Hibernating
37283,349,11,1557.8,2,3,3,8,Regulars
37284,931,7,932.1200000000001,1,1,2,4,Hibernating
37285,682,12,1509.4099999999999,1,4,3,8,At Risk
37286,529,10,616.93,1,3,1,5,Regulars
37287,7,14,4343.17,5,5,5,15,Champions
37288,330,6,1069.98,2,1,2,5,Hibernating
37289,253,12,705.05,2,4,1,7,At Risk
37290,531,10,1201.03,1,3,2,6,Regulars
37291,162,11,1286.8,3,3,3,9,Regulars
37292,190,11,844.78,3,3,2,8,Regulars
37293,1000,7,1404.76,1,1,3,5,Regulars
37294,90,13,1635.29,4,4,3,11,Loyal
37295,92,6,593.55,4,1,1,6,Regulars
37296,541,13,1775.9,1,4,4,9,At Risk
37297,737,6,898.52,1,1,2,4,Hibernating
37298,302,12,3063.28,2,4,5,11,At Risk
37299,1178,6,965.72,1,1,2,4,Hibernating
37300,23,5,473.54,5,1,1,7,Regulars
37301,115,8,1178.73,4,2,2,8,Regulars
37302,383,11,2999.1099999999997,2,3,5,10,Regulars
37303,247,10,1696.42,3,3,3,9,Regulars
37304,420,11,2666.92,2,3,5,10,Regulars
37305,316,8,820.72,2,2,1,5,Hibernating
37306,174,8,973.34,3,2,2,7,Regulars
37307,408,11,1636.31,2,3,3,8,Regulars
37308,145,8,737.98,4,2,1,7,Regulars
37309,269,7,439.68000000000006,2,1,1,4,Hibernating
37310,571,7,774.98,1,1,1,3,Hibernating
37311,516,2,139.74,1,1,1,3,Hibernating
37312,318,6,699.41,2,1,1,4,Hibernating
37313,844,12,1314.35,1,4,3,8,At Risk
37314,164,7,1203.44,3,1,2,6,Regulars
37315,167,17,1525.85,3,5,3,11,Regulars
37316,341,11,1206.5,2,3,2,7,Regulars
37317,199,6,344.05,3,1,1,5,Regulars
37318,17,13,2288.89,5,4,4,13,Champions
37319,30,14,3068.09,5,5,5,15,Champions
37320,71,12,2318.73,4,4,4,12,Champions
37321,38,10,513.01,5,3,1,9,Loyal
37322,204,10,612.14,3,3,1,7,Regulars
37323,90,10,779.13,4,3,1,8,Loyal
37324,1094,4,491.97,1,1,1,3,Hibernating
37325,415,13,1510.95,2,4,3,9,At Risk
37326,90,13,1619.29,4,4,3,11,Loyal
37327,221,13,2453.58,3,4,4,11,Big Spenders
37328,412,7,487.1,2,1,1,4,Hibernating
37329,161,11,1838.21,3,3,4,10,Big Spenders
37330,338,7,1084.3,2,1,2,5,Hibernating
37331,144,9,625.8399999999999,4,2,1,7,Regulars
37332,14,12,847.34,5,4,2,11,Loyal
37333,174,16,2306.58,3,5,4,12,Big Spenders
37334,245,6,779.79,3,1,1,5,Regulars
37335,172,11,1793.8799999999999,3,3,4,10,Big Spenders
37336,571,11,2331.04,1,3,4,8,Regulars
37337,813,7,1918.6100000000001,1,1,4,6,Regulars
37338,100,11,1920.5999999999997,4,3,4,11,Loyal
37339,187,7,739.88,3,1,1,5,Regulars
37340,247,7,1659.1599999999999,3,1,3,7,Regulars
37341,102,4,957.6000000000001,4,1,2,7,Regulars
37342,156,7,688.81,3,1,1,5,Regulars
37343,132,8,1300.46,4,2,3,9,Regulars
37344,60,15,1724.2,5,5,3,13,Loyal
37345,916,7,2983.4799999999996,1,1,5,7,Regulars
37346,1091,8,861.48,1,2,2,5,Hibernating
37347,895,7,1144.6599999999999,1,1,2,4,Hibernating
37348,16,9,469.99,5,2,1,8,Regulars
37349,217,9,641.09,3,2,1,6,Regulars
37350,126,10,1124.69,4,3,2,9,Loyal
37351,578,12,2063.71,1,4,4,9,At Risk
37352,42,8,1382.0900000000001,5,2,3,10,Regulars
37353,89,12,807.15,4,4,1,9,Loyal
37354,908,5,690.49,1,1,1,3,Hibernating
37355,42,13,2996.57,5,4,5,14,Champions
37356,89,14,2685.38,4,5,5,14,Champions
37357,775,6,2191.22,1,1,4,6,Regulars
37358,181,9,1331.94,3,2,3,8,Regulars
37359,241,11,1181.16,3,3,2,8,Regulars
37360,185,15,3299.24,3,5,5,13,Big Spenders
37361,1316,10,1565.07,1,3,3,7,Regulars
37362,543,5,1030.8500000000001,1,1,2,4,Hibernating
37363,148,10,1778.95,3,3,4,10,Big Spenders
37364,161,13,1525.8899999999999,3,4,3,10,Regulars
37365,567,9,742.88,1,2,1,4,Hibernating
37366,226,13,4149.139999999999,3,4,5,12,Big Spenders
37367,17,15,1257.21,5,5,3,13,Loyal
37368,106,9,1307.6699999999998,4,2,3,9,Regulars
37369,175,12,2778.11,3,4,5,12,Big Spenders
37370,67,9,2010.22,4,2,4,10,Big Spenders
37371,297,5,2662.69,2,1,5,8,Regulars
37372,90,6,738.54,4,1,1,6,Regulars
37373,505,13,1210.2,1,4,2,7,At Risk
37374,191,14,1678.37,3,5,3,11,Regulars
37375,141,14,1454.52,4,5,3,12,Loyal
37376,895,10,744.31,1,3,1,5,Regulars
37377,0,7,408.76,5,1,1,7,Regulars
37378,501,10,2151.5499999999997,1,3,4,8,Regulars
37379,475,12,3835.6800000000003,1,4,5,10,At Risk
37380,611,8,508.15999999999997,1,2,1,4,Hibernating
37381,681,15,3895.1200000000003,1,5,5,11,At Risk
37382,454,7,876.6,2,1,2,5,Hibernating
37383,6,6,2200.88,5,1,4,10,Big Spenders
37384,96,7,868.88,4,1,2,7,Regulars
37385,605,12,1252.9699999999998,1,4,3,8,At Risk
37386,72,15,4163.44,4,5,5,14,Champions
37387,333,6,616.2,2,1,1,4,Hibernating
37388,0,6,644.8199999999999,5,1,1,7,Regulars
37389,16,18,4551.64,5,5,5,15,Champions
37390,421,15,2709.39,2,5,5,12,At Risk
37391,580,9,1461.68,1,2,3,6,Regulars
37392,619,8,517.97,1,2,1,4,Hibernating
37393,228,9,2955.79,3,2,5,10,Big Spenders
37394,54,7,675.61,5,1,1,7,Regulars
37395,121,9,1175.6699999999998,4,2,2,8,Regulars
37396,383,14,1915.91,2,5,4,11,At Risk
37397,31,10,2486.4900000000002,5,3,4,12,Loyal
37398,125,12,2412.41,4,4,4,12,Champions
37399,124,17,3112.75,4,5,5,14,Champions
37400,569,4,913.6200000000001,1,1,2,4,Hibernating
37401,395,8,688.7099999999999,2,2,1,5,Hibernating
37402,303,11,2071.65,2,3,4,9,Regulars
37403,749,6,1323.34,1,1,3,5,Regulars
37404,707,13,1528.51,1,4,3,8,At Risk
37405,100,10,1130.3500000000001,4,3,2,9,Loyal
37406,973,8,1357.0800000000002,1,2,3,6,Regulars
37407,2,11,2645.95,5,3,5,13,Loyal
37408,100,8,2024.3199999999997,4,2,4,10,Big Spenders
37409,34,14,2202.49,5,5,4,14,Champions
37410,55,13,1125.6399999999999,5,4,2,11,Loyal
37411,26,9,1063.92,5,2,2,9,Regulars
37412,56,19,4273.84,5,5,5,15,Champions
37413,461,14,2518.95,1,5,4,10,At Risk
37414,583,11,1333.46,1,3,3,7,Regulars
37415,29,4,370.54,5,1,1,7,Regulars
37416,402,8,425.25,2,2,1,5,Hibernating
37417,385,8,1355.0500000000002,2,2,3,7,Regulars
37418,156,13,2842.0200000000004,3,4,5,12,Big Spenders
37419,203,6,413.33,3,1,1,5,Regulars
37420,274,13,2348.96,2,4,4,10,At Risk
37421,55,8,1421.6200000000001,5,2,3,10,Regulars
37422,342,7,2301.47,2,1,4,7,Regulars
37423,57,10,2981.19,5,3,5,13,Loyal
37424,13,7,524.33,5,1,1,7,Regulars
37425,746,10,1537.54,1,3,3,7,Regulars
37426,52,9,2329.82,5,2,4,11,Big Spenders
37427,110,18,3395.85,4,5,5,14,Champions
37428,3,9,1368.53,5,2,3,10,Regulars
37429,243,11,932.1,3,3,2,8,Regulars
37430,188,9,3067.91,3,2,5,10,Big Spenders
37431,135,10,3817.6,4,3,5,12,Loyal
37432,824,8,765.03,1,2,1,4,Hibernating
37433,56,14,2451.61,5,5,4,14,Champions
37434,385,9,777.3499999999999,2,2,1,5,Hibernating
37435,556,11,1729.35,1,3,4,8,Regulars
37436,486,11,1527.54,1,3,3,7,Regulars
37437,20,8,785.1,5,2,1,8,Regulars
37438,1314,5,1875.79,1,1,4,6,Regulars
37439,467,11,2903.3799999999997,1,3,5,9,Regulars
37440,607,9,3388.0999999999995,1,2,5,8,Regulars
37441,170,14,2226.06,3,5,4,12,Big Spenders
37442,35,13,1697.7800000000002,5,4,3,12,Loyal
37443,79,8,844.27,4,2,1,7,Regulars
37444,464,6,799.1099999999999,1,1,1,3,Hibernating
37445,250,5,2049.12,2,1,4,7,Regulars
37446,99,14,2025.96,4,5,4,13,Champions
37447,34,9,1229.47,5,2,2,9,Regulars
37448,310,10,990.18,2,3,2,7,Regulars
37449,52,14,2798.63,5,5,5,15,Champions
37450,40,14,3783.35,5,5,5,15,Champions
37451,68,8,1032.21,4,2,2,8,Regulars
37452,440,9,3926.0799999999995,2,2,5,9,Regulars
37453,244,8,1237.5,3,2,2,7,Regulars
37454,770,7,795.2199999999999,1,1,1,3,Hibernating
37455,1355,7,472.02,1,1,1,3,Hibernating
37456,567,14,8000.08,1,5,5,11,At Risk
37457,706,8,806.61,1,2,1,4,Hibernating
37458,342,10,1356.7,2,3,3,8,Regulars
37459,176,8,3597.3900000000003,3,2,5,10,Big Spenders
37460,90,12,2113.32,4,4,4,12,Champions
37461,260,17,1891.2,2,5,4,11,At Risk
37462,15,11,1863.15,5,3,4,12,Loyal
37463,181,17,2256.86,3,5,4,12,Big Spenders
37464,1347,6,905.64,1,1,2,4,Hibernating
37465,74,11,2467.7,4,3,4,11,Loyal
37466,680,12,3315.67,1,4,5,10,At Risk
37467,15,14,945.0699999999999,5,5,2,12,Loyal
37468,204,10,1581.21,3,3,3,9,Regulars
37469,378,9,2419.52,2,2,4,8,Regulars
37470,13,8,905.46,5,2,2,9,Regulars
37471,542,9,583.45,1,2,1,4,Hibernating
37472,60,11,1601.68,5,3,3,11,Loyal
37473,573,7,1067.4299999999998,1,1,2,4,Hibernating
37474,132,14,1522.6000000000001,4,5,3,12,Loyal
37475,37,12,2850.18,5,4,5,14,Champions
37476,355,10,3803.9100000000003,2,3,5,10,Regulars
37477,102,10,1871.28,4,3,4,11,Loyal
37478,1031,8,718.5200000000001,1,2,1,4,Hibernating
37479,243,7,1019.7299999999999,3,1,2,6,Regulars
37480,168,8,740.53,3,2,1,6,Regulars
37481,1560,5,302.90999999999997,1,1,1,3,Hibernating
37482,216,12,1373.75,3,4,3,10,Regulars
37483,462,5,1824.3799999999999,1,1,4,6,Regulars
37484,247,13,1014.07,3,4,2,9,Regulars
37485,174,12,655.35,3,4,1,8,Regulars
37486,639,6,772.85,1,1,1,3,Hibernating
37487,135,11,3553.2400000000002,4,3,5,12,Loyal
37488,521,7,1235.1100000000001,1,1,2,4,Hibernating
37489,90,12,3483.39,4,4,5,13,Champions
37490,69,16,3602.73,4,5,5,14,Champions
37491,126,6,1772.63,4,1,4,9,Big Spenders
37492,213,10,1775.56,3,3,4,10,Big Spenders
37493,150,11,3050.12,3,3,5,11,Big Spenders
37494,220,9,1686.21,3,2,3,8,Regulars
37495,37,11,1211.94,5,3,2,10,Loyal
37496,13,8,2114.6099999999997,5,2,4,11,Big Spenders
37497,141,8,2486.62,4,2,4,10,Big Spenders
37498,30,9,528.86,5,2,1,8,Regulars
37499,260,13,1836.11,2,4,4,10,At Risk
37500,34,11,1470.03,5,3,3,11,Loyal
37501,122,11,786.94,4,3,1,8,Loyal
37502,8,13,2055.86,5,4,4,13,Champions
37503,95,13,1942.6599999999999,4,4,4,12,Champions
37504,48,16,1920.29,5,5,4,14,Champions
37505,828,10,1184.29,1,3,2,6,Regulars
37506,122,8,1529.87,4,2,3,9,Regulars
37507,379,7,1010.37,2,1,2,5,Hibernating
37508,712,5,518.55,1,1,1,3,Hibernating
37509,229,6,4227.5,3,1,5,9,Big Spenders
37510,765,7,862.43,1,1,2,4,Hibernating
37511,318,12,1737.7,2,4,4,10,At Risk
37512,854,9,599.41,1,2,1,4,Hibernating
37513,554,5,1529.47,1,1,3,5,Regulars
37514,76,9,1038.5,4,2,2,8,Regulars
37515,60,7,1738.46,5,1,4,10,Big Spenders
37516,272,10,1040.3799999999999,2,3,2,7,Regulars
37517,5,15,1566.3300000000002,5,5,3,13,Loyal
37518,6,9,1420.76,5,2,3,10,Regulars
37519,495,12,2901.91,1,4,5,10,At Risk
37520,168,10,1422.2,3,3,3,9,Regulars
37521,389,13,5592.66,2,4,5,11,At Risk
37522,224,12,1832.76,3,4,4,11,Big Spenders
37523,693,12,2833.69,1,4,5,10,At Risk
37524,226,14,1393.39,3,5,3,11,Regulars
37525,682,7,2090.33,1,1,4,6,Regulars
37526,916,5,445.84000000000003,1,1,1,3,Hibernating
37527,174,12,1390.03,3,4,3,10,Regulars
37528,243,11,1724.76,3,3,3,9,Regulars
37529,608,9,4037.4399999999996,1,2,5,8,Regulars
37530,578,8,595.12,1,2,1,4,Hibernating
37531,690,6,346.42,1,1,1,3,Hibernating
37532,71,13,1843.66,4,4,4,12,Champions
37533,166,10,2199.34,3,3,4,10,Big Spenders
37534,78,10,1491.73,4,3,3,10,Loyal
37535,108,8,2434.05,4,2,4,10,Big Spenders
37536,1598,4,1712.79,1,1,3,5,Regulars
37537,289,16,1434.15,2,5,3,10,At Risk
37538,377,9,587.45,2,2,1,5,Hibernating
37539,154,16,3774.45,3,5,5,13,Big Spenders
37540,657,9,661.77,1,2,1,4,Hibernating
37541,108,9,635.15,4,2,1,7,Regulars
37542,450,13,1500.91,2,4,3,9,At Risk
37543,168,9,689.4300000000001,3,2,1,6,Regulars
37544,552,7,2738.8900000000003,1,1,5,7,Regulars
37545,162,9,988.9300000000001,3,2,2,7,Regulars
37546,272,9,2762.89,2,2,5,9,Regulars
37547,211,5,615.17,3,1,1,5,Regulars
37548,244,11,932.47,3,3,2,8,Regulars
37549,100,8,613.48,4,2,1,7,Regulars
37550,314,10,844.8199999999999,2,3,2,7,Regulars
37551,290,14,2132.6099999999997,2,5,4,11,At Risk
37552,18,8,712.3,5,2,1,8,Regulars
37553,10,12,3012.34,5,4,5,14,Champions
37554,705,5,308.43,1,1,1,3,Hibernating
37555,124,14,4721.95,4,5,5,14,Champions
37556,358,7,1343.6599999999999,2,1,3,6,Regulars
37557,186,8,1583.97,3,2,3,8,Regulars
37558,368,12,1317.85,2,4,3,9,At Risk
37559,715,6,554.39,1,1,1,3,Hibernating
37560,1150,5,289.7,1,1,1,3,Hibernating
37561,695,8,1316.01,1,2,3,6,Regulars
37562,216,8,945.39,3,2,2,7,Regulars
37563,24,9,750.58,5,2,1,8,Regulars
37564,35,12,4004.04,5,4,5,14,Champions
37565,190,9,1218.82,3,2,2,7,Regulars
37566,141,13,1764.95,4,4,4,12,Champions
37567,134,8,1348.65,4,2,3,9,Regulars
37568,260,13,1241.44,2,4,3,9,At Risk
37569,615,10,326.40999999999997,1,3,1,5,Regulars
37570,3,8,3979.98,5,2,5,12,Big Spenders
37571,336,10,3189.35,2,3,5,10,Regulars
37572,30,8,3905.0199999999995,5,2,5,12,Big Spenders
37573,776,6,618.21,1,1,1,3,Hibernating
37574,184,13,801.03,3,4,1,8,Regulars
37575,121,9,2220.9,4,2,4,10,Big Spenders
37576,33,16,2403.37,5,5,4,14,Champions
37577,252,10,684.62,2,3,1,6,Regulars
37578,112,11,1306.5,4,3,3,10,Loyal
37579,109,12,2090.13,4,4,4,12,Champions
37580,496,7,2776.76,1,1,5,7,Regulars
37581,38,7,2165.61,5,1,4,10,Big Spenders
37582,75,15,3005.23,4,5,5,14,Champions
37583,152,13,1762.1000000000001,3,4,4,11,Big Spenders
37584,279,5,500.92,2,1,1,4,Hibernating
37585,427,7,3731.1899999999996,2,1,5,8,Regulars
37586,18,10,1333.22,5,3,3,11,Loyal
37587,143,12,1827.88,4,4,4,12,Champions
37588,0,11,3652.88,5,3,5,13,Loyal
37589,2,8,823.83,5,2,1,8,Regulars
37590,1508,8,479.12,1,2,1,4,Hibernating
37591,141,17,2788.91,4,5,5,14,Champions
37592,146,10,2264.85,4,3,4,11,Loyal
37593,266,11,1322.24,2,3,3,8,Regulars
37594,534,10,2598.35,1,3,5,9,Regulars
37595,127,13,1385.45,4,4,3,11,Loyal
37596,830,5,803.29,1,1,1,3,Hibernating
37597,51,15,1777.06,5,5,4,14,Champions
37598,244,11,5166.38,3,3,5,11,Big Spenders
37599,124,16,1304.62,4,5,3,12,Loyal
37600,236,5,242.39,3,1,1,5,Regulars
37601,140,12,1231.05,4,4,2,10,Loyal
37602,28,11,1420.37,5,3,3,11,Loyal
37603,187,10,1197.25,3,3,2,8,Regulars
37604,229,6,1342.99,3,1,3,7,Regulars
37605,12,9,875.1199999999999,5,2,2,9,Regulars
37606,78,11,1444.81,4,3,3,10,Loyal
37607,15,12,1707.43,5,4,3,12,Loyal
37608,239,12,2343.08,3,4,4,11,Big Spenders
37609,203,8,3109.66,3,2,5,10,Big Spenders
37610,50,9,6164.53,5,2,5,12,Big Spenders
37611,18,8,808.9,5,2,1,8,Regulars
37612,175,10,1460.52,3,3,3,9,Regulars
37613,141,13,3064.3,4,4,5,13,Champions
37614,366,13,1870.44,2,4,4,10,At Risk
37615,506,8,2860.53,1,2,5,8,Regulars
37616,30,15,4149.46,5,5,5,15,Champions
37617,0,14,1970.77,5,5,4,14,Champions
37618,261,6,724.68,2,1,1,4,Hibernating
37619,252,8,855.9499999999999,2,2,2,6,Hibernating
37620,156,13,1889.03,3,4,4,11,Big Spenders
37621,339,6,1461.22,2,1,3,6,Regulars
37622,271,6,2799.42,2,1,5,8,Regulars
37623,124,6,2458.99,4,1,4,9,Big Spenders
37624,221,5,535.76,3,1,1,5,Regulars
37625,59,12,1303.92,5,4,3,12,Loyal
37626,742,8,2455.9,1,2,4,7,Regulars
37627,24,9,2025.8400000000001,5,2,4,11,Big Spenders
37628,179,9,1977.27,3,2,4,9,Big Spenders
37629,433,11,5655.01,2,3,5,10,Regulars
37630,440,10,3506.91,2,3,5,10,Regulars
37631,177,7,1020.49,3,1,2,6,Regulars
37632,623,7,898.18,1,1,2,4,Hibernating
37633,495,16,3859.9399999999996,1,5,5,11,At Risk
37634,114,11,1864.5,4,3,4,11,Loyal
37635,165,11,1839.8,3,3,4,10,Big Spenders
37636,16,14,2201.93,5,5,4,14,Champions
37637,84,8,892.7,4,2,2,8,Regulars
37638,68,11,1250.3600000000001,4,3,3,10,Loyal
37639,218,7,1320.22,3,1,3,7,Regulars
37640,384,9,425.65,2,2,1,5,Hibernating
37641,60,10,1313.06,5,3,3,11,Loyal
37642,655,6,611.3299999999999,1,1,1,3,Hibernating
37643,23,13,1149.51,5,4,2,11,Loyal
37644,65,12,1043.54,5,4,2,11,Loyal
37645,11,6,584.0,5,1,1,7,Regulars
37646,274,11,1247.37,2,3,3,8,Regulars
37647,53,11,2212.7000000000003,5,3,4,12,Loyal
37648,380,8,749.54,2,2,1,5,Hibernating
37649,179,9,997.98,3,2,2,7,Regulars
37650,652,12,931.8100000000001,1,4,2,7,At Risk
37651,311,4,326.92999999999995,2,1,1,4,Hibernating
37652,747,6,511.76,1,1,1,3,Hibernating
37653,17,9,1446.96,5,2,3,10,Regulars
37654,243,9,1811.8400000000001,3,2,4,9,Big Spenders
37655,53,12,4231.110000000001,5,4,5,14,Champions
37656,25,10,887.53,5,3,2,10,Loyal
37657,439,7,560.36,2,1,1,4,Hibernating
37658,295,15,1555.0800000000002,2,5,3,10,At Risk
37659,15,11,604.9200000000001,5,3,1,9,Loyal
37660,31,11,1741.81,5,3,4,12,Loyal
37661,57,20,3205.52,5,5,5,15,Champions
37662,292,12,1057.57,2,4,2,8,At Risk
37663,291,20,3001.4700000000003,2,5,5,12,At Risk
37664,110,12,1728.0,4,4,4,12,Champions
37665,27,13,1177.48,5,4,2,11,Loyal
37666,36,11,4292.29,5,3,5,13,Loyal
37667,141,10,1150.78,4,3,2,9,Loyal
37668,563,9,436.15,1,2,1,4,Hibernating
37669,14,13,3121.8799999999997,5,4,5,14,Champions
37670,0,11,2276.77,5,3,4,12,Loyal
37671,420,14,2886.65,2,5,5,12,At Risk
37672,86,8,1334.48,4,2,3,9,Regulars
37673,50,8,813.45,5,2,1,8,Regulars
37674,535,11,4443.38,1,3,5,9,Regulars
37675,249,7,1224.51,2,1,2,5,Hibernating
37676,535,13,2111.72,1,4,4,9,At Risk
37677,268,13,2438.83,2,4,4,10,At Risk
37678,227,14,4248.4800000000005,3,5,5,13,Big Spenders
37679,854,9,1620.1999999999998,1,2,3,6,Regulars
37680,116,10,1499.7800000000002,4,3,3,10,Loyal
37681,213,14,2096.27,3,5,4,12,Big Spenders
37682,259,11,914.5400000000001,2,3,2,7,Regulars
37683,1088,9,797.63,1,2,1,4,Hibernating
37684,102,16,2023.46,4,5,4,13,Champions
37685,470,9,2042.0,1,2,4,7,Regulars
37686,18,11,2681.89,5,3,5,13,Loyal
37687,310,13,1699.98,2,4,3,9,At Risk
37688,910,10,2012.6200000000001,1,3,4,8,Regulars
37689,342,7,1877.8900000000003,2,1,4,7,Regulars
37690,571,9,931.04,1,2,2,5,Hibernating
37691,118,9,3639.2299999999996,4,2,5,11,Big Spenders
37692,62,9,1622.7900000000002,5,2,3,10,Regulars
37693,406,18,1996.38,2,5,4,11,At Risk
37694,805,5,471.68,1,1,1,3,Hibernating
37695,211,11,1741.0800000000002,3,3,4,10,Big Spenders
37696,223,7,1124.28,3,1,2,6,Regulars
37697,541,10,1621.97,1,3,3,7,Regulars
37698,109,13,2013.0500000000002,4,4,4,12,Champions
37699,585,4,809.2199999999999,1,1,1,3,Hibernating
37700,897,4,262.97,1,1,1,3,Hibernating
37701,167,10,1328.6999999999998,3,3,3,9,Regulars
37702,675,10,745.37,1,3,1,5,Regulars
37703,7,13,3192.84,5,4,5,14,Champions
37704,63,12,1187.9099999999999,5,4,2,11,Loyal
37705,337,9,3316.9100000000003,2,2,5,9,Regulars
37706,128,11,3589.1000000000004,4,3,5,12,Loyal
37707,371,15,1587.92,2,5,3,10,At Risk
37708,237,10,6825.73,3,3,5,11,Big Spenders
37709,238,13,2073.56,3,4,4,11,Big Spenders
37710,544,15,1473.1399999999999,1,5,3,9,At Risk
37711,525,6,2241.2,1,1,4,6,Regulars
37712,452,9,524.74,2,2,1,5,Hibernating
37713,0,9,999.29,5,2,2,9,Regulars
37714,89,14,1798.0,4,5,4,13,Champions
37715,1231,10,839.67,1,3,1,5,Regulars
37716,1192,9,698.1,1,2,1,4,Hibernating
37717,17,8,2146.73,5,2,4,11,Big Spenders
37718,331,8,775.04,2,2,1,5,Hibernating
37719,321,9,873.0999999999999,2,2,2,6,Hibernating
37720,600,9,554.1800000000001,1,2,1,4,Hibernating
37721,18,8,4035.6800000000003,5,2,5,12,Big Spenders
37722,43,9,729.57,5,2,1,8,Regulars
37723,33,12,4490.5,5,4,5,14,Champions
37724,17,21,5083.09,5,5,5,15,Champions
37725,212,12,4191.3,3,4,5,12,Big Spenders
37726,129,8,874.18,4,2,2,8,Regulars
37727,1150,5,929.9399999999999,1,1,2,4,Hibernating
37728,471,9,2242.06,1,2,4,7,Regulars
37729,193,9,1790.11,3,2,4,9,Big Spenders
37730,249,9,3333.86,2,2,5,9,Regulars
37731,21,9,2003.6,5,2,4,11,Big Spenders
37732,455,8,1137.12,2,2,2,6,Hibernating
37733,484,9,1177.77,1,2,2,5,Hibernating
37734,244,12,2305.8100000000004,3,4,4,11,Big Spenders
37735,525,5,357.55,1,1,1,3,Hibernating
37736,29,4,2938.69,5,1,5,11,Big Spenders
37737,653,8,580.1700000000001,1,2,1,4,Hibernating
37738,120,10,2004.41,4,3,4,11,Loyal
37739,250,9,1286.35,2,2,3,7,Regulars
37740,289,9,2097.65,2,2,4,8,Regulars
37741,43,13,1895.56,5,4,4,13,Champions
37742,11,12,1347.5,5,4,3,12,Loyal
37743,217,13,2207.83,3,4,4,11,Big Spenders
37744,945,5,502.30999999999995,1,1,1,3,Hibernating
37745,448,9,1667.6100000000001,2,2,3,7,Regulars
37746,734,9,1984.65,1,2,4,7,Regulars
37747,261,9,2021.51,2,2,4,8,Regulars
37748,141,9,917.3499999999999,4,2,2,8,Regulars
37749,345,9,575.51,2,2,1,5,Hibernating
37750,152,11,4390.74,3,3,5,11,Big Spenders
37751,78,7,632.02,4,1,1,6,Regulars
37752,516,8,577.59,1,2,1,4,Hibernating
37753,855,9,2503.22,1,2,4,7,Regulars
37754,138,8,848.5500000000001,4,2,2,8,Regulars
37755,9,13,1476.98,5,4,3,12,Loyal
37756,226,12,1574.63,3,4,3,10,Regulars
37757,551,10,995.42,1,3,2,6,Regulars
37758,189,7,1334.1100000000001,3,1,3,7,Regulars
37759,232,10,688.9300000000001,3,3,1,7,Regulars
37760,252,13,2787.31,2,4,5,11,At Risk
37761,184,9,1046.09,3,2,2,7,Regulars
37762,110,11,1677.1200000000001,4,3,3,10,Loyal
37763,53,10,1861.8,5,3,4,12,Loyal
37764,161,10,1315.6100000000001,3,3,3,9,Regulars
37765,21,15,1456.85,5,5,3,13,Loyal
37766,253,8,3010.58,2,2,5,9,Regulars
37767,37,10,2801.6,5,3,5,13,Loyal
37768,130,12,1404.78,4,4,3,11,Loyal
37769,341,13,1151.54,2,4,2,8,At Risk
37770,76,15,1115.68,4,5,2,11,Loyal
37771,138,8,1098.39,4,2,2,8,Regulars
37772,195,8,626.48,3,2,1,6,Regulars
37773,45,15,2390.9300000000003,5,5,4,14,Champions
37774,274,10,908.9,2,3,2,7,Regulars
37775,362,10,627.9200000000001,2,3,1,6,Regulars
37776,539,9,1451.04,1,2,3,6,Regulars
37777,838,4,1450.38,1,1,3,5,Regulars
37778,39,9,1563.29,5,2,3,10,Regulars
37779,171,15,2223.65,3,5,4,12,Big Spenders
37780,153,5,160.37,3,1,1,5,Regulars
37781,169,6,1121.81,3,1,2,6,Regulars
37782,70,8,1447.74,4,2,3,9,Regulars
37783,83,11,1262.86,4,3,3,10,Loyal
37784,60,12,738.09,5,4,1,10,Loyal
37785,1002,11,1033.1299999999999,1,3,2,6,Regulars
37786,54,4,155.39,5,1,1,7,Regulars
37787,288,14,1569.84,2,5,3,10,At Risk
37788,259,5,2306.2000000000003,2,1,4,7,Regulars
37789,632,6,1079.95,1,1,2,4,Hibernating
37790,609,5,570.86,1,1,1,3,Hibernating
37791,85,12,960.55,4,4,2,10,Loyal
37792,372,11,1906.0100000000002,2,3,4,9,Regulars
37793,385,13,962.36,2,4,2,8,At Risk
37794,154,8,1673.43,3,2,3,8,Regulars
37795,29,11,1660.12,5,3,3,11,Loyal
37796,117,13,1813.46,4,4,4,12,Champions
37797,89,10,2218.69,4,3,4,11,Loyal
37798,270,8,754.74,2,2,1,5,Hibernating
37799,232,14,6735.6900000000005,3,5,5,13,Big Spenders
37800,230,14,3032.57,3,5,5,13,Big Spenders
37801,152,10,908.75,3,3,2,8,Regulars
37802,270,12,2615.86,2,4,5,11,At Risk
37803,210,11,1430.12,3,3,3,9,Regulars
37804,749,6,1426.26,1,1,3,5,Regulars
37805,229,13,2229.21,3,4,4,11,Big Spenders
37806,56,11,1083.85,5,3,2,10,Loyal
37807,429,12,791.26,2,4,1,7,At Risk
37808,348,9,1368.97,2,2,3,7,Regulars
37809,245,8,1122.76,3,2,2,7,Regulars
37810,24,9,744.0600000000001,5,2,1,8,Regulars
37811,365,7,430.49,2,1,1,4,Hibernating
37812,165,12,3678.77,3,4,5,12,Big Spenders
37813,231,13,1580.66,3,4,3,10,Regulars
37814,398,2,203.49,2,1,1,4,Hibernating
37815,429,10,1131.6499999999999,2,3,2,7,Regulars
37816,365,6,448.24,2,1,1,4,Hibernating
37817,416,9,640.47,2,2,1,5,Hibernating
37818,55,13,2175.88,5,4,4,13,Champions
37819,3,8,1124.87,5,2,2,9,Regulars
37820,626,13,1481.66,1,4,3,8,At Risk
37821,176,8,1872.9699999999998,3,2,4,9,Big Spenders
37822,39,7,364.4,5,1,1,7,Regulars
37823,65,6,636.7,5,1,1,7,Regulars
37824,1617,7,1261.4,1,1,3,5,Regulars
37825,64,13,1227.1399999999999,5,4,2,11,Loyal
37826,261,13,1493.58,2,4,3,9,At Risk
37827,124,8,405.82,4,2,1,7,Regulars
37828,620,3,345.59,1,1,1,3,Hibernating
37829,531,7,448.63,1,1,1,3,Hibernating
37830,33,12,3036.6899999999996,5,4,5,14,Champions
37831,167,11,3025.32,3,3,5,11,Big Spenders
37832,35,8,604.35,5,2,1,8,Regulars
37833,272,11,2063.13,2,3,4,9,Regulars
37834,370,7,679.26,2,1,1,4,Hibernating
37835,85,8,1837.8899999999999,4,2,4,10,Big Spenders
37836,958,10,1245.54,1,3,3,7,Regulars
37837,429,8,638.49,2,2,1,5,Hibernating
37838,5,10,604.28,5,3,1,9,Loyal
37839,503,6,872.73,1,1,2,4,Hibernating
37840,205,10,3071.0299999999997,3,3,5,11,Big Spenders
37841,73,9,738.25,4,2,1,7,Regulars
37842,252,9,1502.74,2,2,3,7,Regulars
37843,281,13,3213.38,2,4,5,11,At Risk
37844,5,9,1551.8899999999999,5,2,3,10,Regulars
37845,607,5,348.53000000000003,1,1,1,3,Hibernating
37846,277,5,445.34,2,1,1,4,Hibernating
37847,344,13,1453.43,2,4,3,9,At Risk
37848,571,13,1027.43,1,4,2,7,At Risk
37849,220,6,880.87,3,1,2,6,Regulars
37850,202,13,1232.29,3,4,2,9,Regulars
37851,61,10,3055.84,5,3,5,13,Loyal
37852,1,10,2270.02,5,3,4,12,Loyal
37853,236,4,1859.67,3,1,4,8,Big Spenders
37854,113,11,1203.01,4,3,2,9,Loyal
37855,1036,9,2521.67,1,2,4,7,Regulars
37856,376,14,2425.73,2,5,4,11,At Risk
37857,333,13,1775.59,2,4,4,10,At Risk
37858,612,16,5249.01,1,5,5,11,At Risk
37859,230,15,3727.56,3,5,5,13,Big Spenders
37860,21,8,1627.78,5,2,3,10,Regulars
37861,595,11,2725.08,1,3,5,9,Regulars
37862,46,8,2285.06,5,2,4,11,Big Spenders
37863,158,9,1016.5799999999999,3,2,2,7,Regulars
37864,310,12,1274.23,2,4,3,9,At Risk
37865,523,12,1810.8200000000002,1,4,4,9,At Risk
37866,1201,11,3039.67,1,3,5,9,Regulars
37867,351,7,868.41,2,1,2,5,Hibernating
37868,172,10,762.85,3,3,1,7,Regulars
37869,39,12,1293.35,5,4,3,12,Loyal
37870,68,8,602.76,4,2,1,7,Regulars
37871,184,9,1005.52,3,2,2,7,Regulars
37872,659,8,1650.37,1,2,3,6,Regulars
37873,231,12,3427.4900000000002,3,4,5,12,Big Spenders
37874,239,10,1090.69,3,3,2,8,Regulars
37875,234,6,685.21,3,1,1,5,Regulars
37876,68,16,2747.8,4,5,5,14,Champions
37877,716,14,1599.05,1,5,3,9,At Risk
37878,109,12,1239.9,4,4,2,10,Loyal
37879,377,17,2883.13,2,5,5,12,At Risk
37880,157,11,1442.23,3,3,3,9,Regulars
37881,495,8,1296.44,1,2,3,6,Regulars
37882,149,11,1524.28,3,3,3,9,Regulars
37883,145,11,1773.81,4,3,4,11,Loyal
37884,100,12,1075.06,4,4,2,10,Loyal
37885,115,10,1087.86,4,3,2,9,Loyal
37886,316,7,584.4000000000001,2,1,1,4,Hibernating
37887,85,6,1983.6,4,1,4,9,Big Spenders
37888,408,7,1030.88,2,1,2,5,Hibernating
37889,881,11,664.52,1,3,1,5,Regulars
37890,98,9,1397.36,4,2,3,9,Regulars
37891,36,15,1237.48,5,5,2,12,Loyal
37892,156,12,1603.25,3,4,3,10,Regulars
37893,60,8,944.3000000000001,5,2,2,9,Regulars
37894,50,10,1203.6599999999999,5,3,2,10,Loyal
37895,294,6,843.59,2,1,1,4,Hibernating
37896,184,11,3801.18,3,3,5,11,Big Spenders
37897,77,8,905.28,4,2,2,8,Regulars
37898,225,14,3251.13,3,5,5,13,Big Spenders
37899,144,16,7661.0,4,5,5,14,Champions
37900,127,9,2749.49,4,2,5,11,Big Spenders
37901,365,19,3224.9100000000003,2,5,5,12,At Risk
37902,282,11,999.89,2,3,2,7,Regulars
37903,211,12,1660.87,3,4,3,10,Regulars
37904,49,10,3125.53,5,3,5,13,Loyal
37905,40,7,2451.56,5,1,4,10,Big Spenders
37906,891,8,2048.6499999999996,1,2,4,7,Regulars
37907,348,7,962.3799999999999,2,1,2,5,Hibernating
37908,679,7,1078.0,1,1,2,4,Hibernating
37909,3,10,585.8199999999999,5,3,1,9,Loyal
37910,391,10,927.24,2,3,2,7,Regulars
37911,33,11,624.88,5,3,1,9,Loyal
37912,109,9,2767.1499999999996,4,2,5,11,Big Spenders
37913,564,14,1329.97,1,5,3,9,At Risk
37914,83,13,3254.9,4,4,5,13,Champions
37915,19,10,1434.26,5,3,3,11,Loyal
37916,199,14,2992.95,3,5,5,13,Big Spenders
37917,188,11,2788.7,3,3,5,11,Big Spenders
37918,151,11,1120.48,3,3,2,8,Regulars
37919,447,12,3063.31,2,4,5,11,At Risk
37920,228,14,1456.81,3,5,3,11,Regulars
37921,974,7,2155.9,1,1,4,6,Regulars
37922,149,7,2234.66,3,1,4,8,Big Spenders
37923,312,7,2790.75,2,1,5,8,Regulars
37924,230,8,5398.42,3,2,5,10,Big Spenders
37925,254,9,1804.01,2,2,4,8,Regulars
37926,85,9,1555.98,4,2,3,9,Regulars
37927,217,9,918.58,3,2,2,7,Regulars
37928,151,10,2193.9700000000003,3,3,4,10,Big Spenders
37929,523,12,1391.95,1,4,3,8,At Risk
37930,321,10,608.81,2,3,1,6,Regulars
37931,166,8,1518.5800000000002,3,2,3,8,Regulars
37932,141,11,1382.0,4,3,3,10,Loyal
37933,85,9,1452.21,4,2,3,9,Regulars
37934,207,8,3798.48,3,2,5,10,Big Spenders
37935,292,12,2160.85,2,4,4,10,At Risk
37936,329,11,1256.45,2,3,3,8,Regulars
37937,131,6,1140.96,4,1,2,7,Regulars
37938,262,9,1091.5,2,2,2,6,Hibernating
37939,122,8,789.59,4,2,1,7,Regulars
37940,503,11,827.67,1,3,1,5,Regulars
37941,103,14,2756.4900000000002,4,5,5,14,Champions
37942,152,7,1041.33,3,1,2,6,Regulars
37943,77,10,1049.5,4,3,2,9,Loyal
37944,331,2,345.70000000000005,2,1,1,4,Hibernating
37945,21,7,497.93,5,1,1,7,Regulars
37946,36,10,1543.24,5,3,3,11,Loyal
37947,245,11,2886.0099999999998,3,3,5,11,Big Spenders
37948,5,12,1667.7199999999998,5,4,3,12,Loyal
37949,197,10,2046.8700000000001,3,3,4,10,Big Spenders
37950,99,15,1928.87,4,5,4,13,Champions
37951,232,12,3101.6099999999997,3,4,5,12,Big Spenders
37952,171,8,958.41,3,2,2,7,Regulars
37953,76,9,2206.82,4,2,4,10,Big Spenders
37954,91,12,3445.61,4,4,5,13,Champions
37955,119,8,2585.29,4,2,5,11,Big Spenders
37956,202,5,802.98,3,1,1,5,Regulars
37957,406,11,1793.58,2,3,4,9,Regulars
37958,640,8,815.1,1,2,1,4,Hibernating
37959,800,4,445.93,1,1,1,3,Hibernating
37960,216,7,626.25,3,1,1,5,Regulars
37961,258,13,1174.23,2,4,2,8,At Risk
37962,289,11,1258.63,2,3,3,8,Regulars
37963,192,15,6052.0,3,5,5,13,Big Spenders
37964,65,14,1747.64,5,5,4,14,Champions
37965,93,6,474.03,4,1,1,6,Regulars
37966,332,10,1140.4299999999998,2,3,2,7,Regulars
37967,490,9,742.3299999999999,1,2,1,4,Hibernating
37968,34,14,2887.7599999999998,5,5,5,15,Champions
37969,331,7,1222.75,2,1,2,5,Hibernating
37970,553,8,817.77,1,2,1,4,Hibernating
37971,63,10,2289.79,5,3,4,12,Loyal
37972,117,12,818.3199999999999,4,4,1,9,Loyal
37973,194,13,1285.1,3,4,3,10,Regulars
37974,168,5,781.8399999999999,3,1,1,5,Regulars
37975,45,10,2721.61,5,3,5,13,Loyal
37976,114,6,2672.63,4,1,5,10,Big Spenders
37977,194,8,730.77,3,2,1,6,Regulars
37978,18,6,417.93,5,1,1,7,Regulars
37979,250,8,809.21,2,2,1,5,Hibernating
37980,111,9,789.52,4,2,1,7,Regulars
37981,238,13,1322.5700000000002,3,4,3,10,Regulars
37982,110,10,778.71,4,3,1,8,Loyal
37983,613,13,1425.3,1,4,3,8,At Risk
37984,167,13,1981.08,3,4,4,11,Big Spenders
37985,99,11,2972.06,4,3,5,12,Loyal
37986,214,12,2012.24,3,4,4,11,Big Spenders
37987,255,7,3335.5,2,1,5,8,Regulars
37988,975,8,2448.9,1,2,4,7,Regulars
37989,305,12,3023.29,2,4,5,11,At Risk
37990,251,6,973.8,2,1,2,5,Hibernating
37991,59,12,4210.45,5,4,5,14,Champions
37992,574,12,1952.8600000000001,1,4,4,9,At Risk
37993,423,10,937.8,2,3,2,7,Regulars
37994,104,10,1127.26,4,3,2,9,Loyal
37995,122,10,1417.76,4,3,3,10,Loyal
37996,19,13,1901.81,5,4,4,13,Champions
37997,277,10,4127.9,2,3,5,10,Regulars
37998,52,15,4834.75,5,5,5,15,Champions
37999,366,7,1133.28,2,1,2,5,Hibernating
38000,56,15,1583.6000000000001,5,5,3,13,Loyal
38001,310,6,408.63,2,1,1,4,Hibernating
38002,7,13,1116.81,5,4,2,11,Loyal
38003,54,13,1418.6200000000001,5,4,3,12,Loyal
38004,74,15,1746.93,4,5,4,13,Champions
38005,853,10,630.39,1,3,1,5,Regulars
38006,564,7,2239.65,1,1,4,6,Regulars
38007,279,12,706.88,2,4,1,7,At Risk
38008,225,12,2734.0,3,4,5,12,Big Spenders
38009,206,12,690.39,3,4,1,8,Regulars
38010,252,10,1046.48,2,3,2,7,Regulars
38011,295,11,921.45,2,3,2,7,Regulars
38012,474,12,1577.8600000000001,1,4,3,8,At Risk
38013,275,9,926.21,2,2,2,6,Hibernating
38014,908,12,1455.43,1,4,3,8,At Risk
38015,23,8,3448.8599999999997,5,2,5,12,Big Spenders
38016,207,5,1294.2,3,1,3,7,Regulars
38017,1601,5,391.87,1,1,1,3,Hibernating
38018,49,8,351.55,5,2,1,8,Regulars
38019,45,8,2319.38,5,2,4,11,Big Spenders
38020,47,12,866.74,5,4,2,11,Loyal
38021,219,8,831.5600000000001,3,2,1,6,Regulars
38022,26,20,2311.9,5,5,4,14,Champions
38023,13,10,799.13,5,3,1,9,Loyal
38024,9,9,1264.5,5,2,3,10,Regulars
38025,40,15,1080.98,5,5,2,12,Loyal
38026,473,8,1975.9600000000003,1,2,4,7,Regulars
38027,244,12,885.35,3,4,2,9,Regulars
38028,112,6,1437.5700000000002,4,1,3,8,Regulars
38029,542,12,1335.16,1,4,3,8,At Risk
38030,235,7,1117.22,3,1,2,6,Regulars
38031,651,6,675.85,1,1,1,3,Hibernating
38032,42,8,898.65,5,2,2,9,Regulars
38033,176,10,1051.16,3,3,2,8,Regulars
38034,446,6,525.1800000000001,2,1,1,4,Hibernating
38035,90,12,1438.58,4,4,3,11,Loyal
38036,84,13,1670.28,4,4,3,11,Loyal
38037,4,12,1309.4,5,4,3,12,Loyal
38038,539,8,626.17,1,2,1,4,Hibernating
38039,133,9,1923.11,4,2,4,10,Big Spenders
38040,128,7,420.38,4,1,1,6,Regulars
38041,58,13,3206.15,5,4,5,14,Champions
38042,72,13,1404.0300000000002,4,4,3,11,Loyal
38043,17,11,3184.1600000000003,5,3,5,13,Loyal
38044,602,8,980.79,1,2,2,5,Hibernating
38045,476,14,3930.81,1,5,5,11,At Risk
38046,980,12,1001.79,1,4,2,7,At Risk
38047,313,9,1368.86,2,2,3,7,Regulars
38048,327,16,1561.51,2,5,3,10,At Risk
38049,390,10,1774.76,2,3,4,9,Regulars
38050,98,13,4582.82,4,4,5,13,Champions
38051,169,12,1331.62,3,4,3,10,Regulars
38052,328,11,1026.71,2,3,2,7,Regulars
38053,381,10,1211.56,2,3,2,7,Regulars
38054,420,7,390.06,2,1,1,4,Hibernating
38055,49,13,3250.2400000000002,5,4,5,14,Champions
38056,77,6,740.4,4,1,1,6,Regulars
38057,6,11,2017.8,5,3,4,12,Loyal
38058,493,11,1836.38,1,3,4,8,Regulars
38059,596,10,1467.97,1,3,3,7,Regulars
38060,410,6,1251.98,2,1,3,6,Regulars
38061,503,10,1231.21,1,3,2,6,Regulars
38062,354,12,1321.27,2,4,3,9,At Risk
38063,358,10,1205.8500000000001,2,3,2,7,Regulars
38064,875,8,755.9,1,2,1,4,Hibernating
38065,32,16,2663.4300000000003,5,5,5,15,Champions
38066,108,4,213.56,4,1,1,6,Regulars
38067,75,18,2237.75,4,5,4,13,Champions
38068,15,8,2314.38,5,2,4,11,Big Spenders
38069,433,12,2140.54,2,4,4,10,At Risk
38070,94,9,1714.73,4,2,3,9,Regulars
38071,145,13,2691.08,4,4,5,13,Champions
38072,23,11,1154.6299999999999,5,3,2,10,Loyal
38073,417,4,395.47,2,1,1,4,Hibernating
38074,97,13,1413.2600000000002,4,4,3,11,Loyal
38075,65,12,2394.6,5,4,4,13,Champions
38076,311,14,1417.5700000000002,2,5,3,10,At Risk
38077,82,12,1909.22,4,4,4,12,Champions
38078,357,10,794.1800000000001,2,3,1,6,Regulars
38079,819,7,1391.78,1,1,3,5,Regulars
38080,425,11,1340.77,2,3,3,8,Regulars
38081,92,16,3420.84,4,5,5,14,Champions
38082,395,11,3510.8,2,3,5,10,Regulars
38083,267,16,1780.08,2,5,4,11,At Risk
38084,439,9,916.11,2,2,2,6,Hibernating
38085,1101,8,971.2,1,2,2,5,Hibernating
38086,787,7,722.79,1,1,1,3,Hibernating
38087,420,9,1158.8899999999999,2,2,2,6,Hibernating
38088,333,8,643.77,2,2,1,5,Hibernating
38089,609,3,765.1,1,1,1,3,Hibernating
38090,138,10,2831.82,4,3,5,12,Loyal
38091,852,8,816.3,1,2,1,4,Hibernating
38092,130,15,3742.73,4,5,5,14,Champions
38093,241,7,1562.4,3,1,3,7,Regulars
38094,131,9,1029.62,4,2,2,8,Regulars
38095,22,7,773.5,5,1,1,7,Regulars
38096,149,12,3908.73,3,4,5,12,Big Spenders
38097,508,8,528.99,1,2,1,4,Hibernating
38098,156,11,1241.06,3,3,3,9,Regulars
38099,731,5,1114.48,1,1,2,4,Hibernating
38100,26,8,666.94,5,2,1,8,Regulars
38101,140,6,653.04,4,1,1,6,Regulars
38102,17,6,805.09,5,1,1,7,Regulars
38103,122,8,1023.29,4,2,2,8,Regulars
38104,110,9,1724.02,4,2,3,9,Regulars
38105,1140,9,3927.8100000000004,1,2,5,8,Regulars
38106,42,10,1091.1,5,3,2,10,Loyal
38107,119,12,1725.1599999999999,4,4,3,11,Loyal
38108,804,10,1920.46,1,3,4,8,Regulars
38109,146,9,1403.94,4,2,3,9,Regulars
38110,29,10,3563.5900000000006,5,3,5,13,Loyal
38111,22,14,835.36,5,5,1,11,Loyal
38112,182,9,2587.67,3,2,5,10,Big Spenders
38113,289,8,492.68,2,2,1,5,Hibernating
38114,483,15,987.03,1,5,2,8,At Risk
38115,10,7,686.1999999999999,5,1,1,7,Regulars
38116,108,10,658.48,4,3,1,8,Loyal
38117,97,9,1347.51,4,2,3,9,Regulars
38118,314,6,2328.42,2,1,4,7,Regulars
38119,32,16,3110.62,5,5,5,15,Champions
38120,152,13,1894.25,3,4,4,11,Big Spenders
38121,166,13,2590.25,3,4,5,12,Big Spenders
38122,196,14,2431.3,3,5,4,12,Big Spenders
38123,283,12,1114.33,2,4,2,8,At Risk
38124,29,15,3112.6400000000003,5,5,5,15,Champions
38125,35,15,2290.78,5,5,4,14,Champions
38126,91,9,1470.44,4,2,3,9,Regulars
38127,48,17,1547.5,5,5,3,13,Loyal
38128,75,9,1015.5699999999999,4,2,2,8,Regulars
38129,884,10,3520.92,1,3,5,9,Regulars
38130,114,9,750.6500000000001,4,2,1,7,Regulars
38131,44,9,700.83,5,2,1,8,Regulars
38132,63,14,1969.09,5,5,4,14,Champions
38133,78,10,688.88,4,3,1,8,Loyal
38134,230,14,1998.42,3,5,4,12,Big Spenders
38135,438,8,1005.89,2,2,2,6,Hibernating
38136,369,9,1922.14,2,2,4,8,Regulars
38137,29,12,1197.08,5,4,2,11,Loyal
38138,33,9,899.7099999999999,5,2,2,9,Regulars
38139,31,9,1342.44,5,2,3,10,Regulars
38140,497,7,1802.98,1,1,4,6,Regulars
38141,385,7,1758.02,2,1,4,7,Regulars
38142,424,6,1209.75,2,1,2,5,Hibernating
38143,98,20,2259.94,4,5,4,13,Champions
38144,295,13,1978.48,2,4,4,10,At Risk
38145,24,7,1034.25,5,1,2,8,Regulars
38146,127,11,1001.2,4,3,2,9,Loyal
38147,129,11,1351.89,4,3,3,10,Loyal
38148,611,10,1086.32,1,3,2,6,Regulars
38149,868,8,469.69,1,2,1,4,Hibernating
38150,413,5,423.58,2,1,1,4,Hibernating
38151,362,10,1174.84,2,3,2,7,Regulars
38152,109,8,707.91,4,2,1,7,Regulars
38153,166,9,2003.02,3,2,4,9,Big Spenders
38154,565,10,1556.79,1,3,3,7,Regulars
38155,32,9,2326.34,5,2,4,11,Big Spenders
38156,301,12,2639.3900000000003,2,4,5,11,At Risk
38157,164,10,2384.17,3,3,4,10,Big Spenders
38158,6,8,3062.74,5,2,5,12,Big Spenders
38159,105,14,3414.0299999999997,4,5,5,14,Champions
38160,278,14,3071.34,2,5,5,12,At Risk
38161,17,16,2555.45,5,5,4,14,Champions
38162,253,20,2286.8199999999997,2,5,4,11,At Risk
38163,189,8,2075.4,3,2,4,9,Big Spenders
38164,152,9,1461.6299999999999,3,2,3,8,Regulars
38165,255,8,541.32,2,2,1,5,Hibernating
38166,491,11,1291.6100000000001,1,3,3,7,Regulars
38167,160,11,1227.36,3,3,2,8,Regulars
38168,385,8,1160.28,2,2,2,6,Hibernating
38169,564,9,654.48,1,2,1,4,Hibernating
38170,150,11,1912.2,3,3,4,10,Big Spenders
38171,161,10,2930.51,3,3,5,11,Big Spenders
38172,142,17,4783.099999999999,4,5,5,14,Champions
38173,303,6,2088.79,2,1,4,7,Regulars
38174,338,14,1473.46,2,5,3,10,At Risk
38175,426,8,3027.13,2,2,5,9,Regulars
38176,138,8,1086.98,4,2,2,8,Regulars
38177,303,8,564.54,2,2,1,5,Hibernating
38178,245,5,477.37,3,1,1,5,Regulars
38179,116,11,1526.18,4,3,3,10,Loyal
38180,50,15,3326.56,5,5,5,15,Champions
38181,88,15,2638.79,4,5,5,14,Champions
38182,55,16,3819.6000000000004,5,5,5,15,Champions
38183,93,9,1773.58,4,2,4,10,Big Spenders
38184,388,9,1860.91,2,2,4,8,Regulars
38185,266,6,580.05,2,1,1,4,Hibernating
38186,81,11,1583.54,4,3,3,10,Loyal
38187,43,9,1548.15,5,2,3,10,Regulars
38188,728,9,782.62,1,2,1,4,Hibernating
38189,144,8,1251.36,4,2,3,9,Regulars
38190,99,10,1667.1100000000001,4,3,3,10,Loyal
38191,428,8,807.2900000000001,2,2,1,5,Hibernating
38192,197,14,2000.73,3,5,4,12,Big Spenders
38193,505,8,1608.83,1,2,3,6,Regulars
38194,74,12,760.91,4,4,1,9,Loyal
38195,348,11,2754.42,2,3,5,10,Regulars
38196,819,5,438.54,1,1,1,3,Hibernating
38197,129,9,1639.93,4,2,3,9,Regulars
38198,373,14,4958.93,2,5,5,12,At Risk
38199,146,13,2790.6500000000005,4,4,5,13,Champions
38200,101,10,1686.5900000000001,4,3,3,10,Loyal
38201,1553,7,1171.51,1,1,2,4,Hibernating
38202,187,11,2349.3,3,3,4,10,Big Spenders
38203,174,11,2191.91,3,3,4,10,Big Spenders
38204,42,6,694.1700000000001,5,1,1,7,Regulars
38205,250,15,3578.02,2,5,5,12,At Risk
38206,274,7,283.08,2,1,1,4,Hibernating
38207,269,12,3292.34,2,4,5,11,At Risk
38208,881,10,2528.28,1,3,4,8,Regulars
38209,173,10,2180.61,3,3,4,10,Big Spenders
38210,274,10,2947.0299999999997,2,3,5,10,Regulars
38211,45,7,905.03,5,1,2,8,Regulars
38212,351,8,630.21,2,2,1,5,Hibernating
38213,370,8,1206.48,2,2,2,6,Hibernating
38214,68,11,1531.04,4,3,3,10,Loyal
38215,93,8,1175.45,4,2,2,8,Regulars
38216,237,5,716.0999999999999,3,1,1,5,Regulars
38217,512,13,1623.95,1,4,3,8,At Risk
38218,732,6,1443.32,1,1,3,5,Regulars
38219,144,21,2166.49,4,5,4,13,Champions
38220,289,8,1151.5,2,2,2,6,Hibernating
38221,74,13,1951.57,4,4,4,12,Champions
38222,328,6,587.82,2,1,1,4,Hibernating
38223,644,7,1414.66,1,1,3,5,Regulars
38224,158,9,1845.48,3,2,4,9,Big Spenders
38225,401,9,799.61,2,2,1,5,Hibernating
38226,208,10,3290.58,3,3,5,11,Big Spenders
38227,622,11,3579.56,1,3,5,9,Regulars
38228,297,8,584.37,2,2,1,5,Hibernating
38229,172,9,1259.29,3,2,3,8,Regulars
38230,33,10,722.13,5,3,1,9,Loyal
38231,216,8,1239.24,3,2,2,7,Regulars
38232,294,12,2007.73,2,4,4,10,At Risk
38233,351,9,3300.3500000000004,2,2,5,9,Regulars
38234,22,16,4851.12,5,5,5,15,Champions
38235,602,3,513.61,1,1,1,3,Hibernating
38236,316,4,344.54999999999995,2,1,1,4,Hibernating
38237,253,12,1520.67,2,4,3,9,At Risk
38238,135,10,1249.73,4,3,3,10,Loyal
38239,65,9,1189.69,5,2,2,9,Regulars
38240,188,13,966.33,3,4,2,9,Regulars
38241,171,6,549.01,3,1,1,5,Regulars
38242,19,10,1753.5500000000002,5,3,4,12,Loyal
38243,207,10,4736.32,3,3,5,11,Big Spenders
38244,728,7,410.08000000000004,1,1,1,3,Hibernating
38245,160,14,1310.02,3,5,3,11,Regulars
38246,114,12,1703.1399999999999,4,4,3,11,Loyal
38247,118,8,1662.32,4,2,3,9,Regulars
38248,84,8,523.15,4,2,1,7,Regulars
38249,503,10,1394.19,1,3,3,7,Regulars
38250,12,10,1767.33,5,3,4,12,Loyal
38251,209,7,3035.56,3,1,5,9,Big Spenders
38252,108,10,1480.67,4,3,3,10,Loyal
38253,38,8,2424.62,5,2,4,11,Big Spenders
38254,201,13,1217.74,3,4,2,9,Regulars
38255,222,12,1853.6200000000001,3,4,4,11,Big Spenders
38256,552,14,2921.71,1,5,5,11,At Risk
38257,133,16,2702.99,4,5,5,14,Champions
38258,213,9,2543.3100000000004,3,2,4,9,Big Spenders
38259,220,6,958.3000000000001,3,1,2,6,Regulars
38260,78,7,1146.95,4,1,2,7,Regulars
38261,170,7,435.35,3,1,1,5,Regulars
38262,123,17,3909.2200000000003,4,5,5,14,Champions
38263,622,9,1603.29,1,2,3,6,Regulars
38264,223,10,2837.96,3,3,5,11,Big Spenders
38265,397,9,1558.73,2,2,3,7,Regulars
38266,13,12,2111.25,5,4,4,13,Champions
38267,52,12,2186.62,5,4,4,13,Champions
38268,116,9,1715.0,4,2,3,9,Regulars
38269,237,6,338.78,3,1,1,5,Regulars
38270,89,13,2052.58,4,4,4,12,Champions
38271,593,4,376.24,1,1,1,3,Hibernating
38272,111,13,5933.530000000001,4,4,5,13,Champions
38273,19,8,2118.08,5,2,4,11,Big Spenders
38274,160,10,1384.93,3,3,3,9,Regulars
38275,144,13,2077.2,4,4,4,12,Champions
38276,143,13,3437.0799999999995,4,4,5,13,Champions
38277,391,10,1100.19,2,3,2,7,Regulars
38278,326,15,1292.42,2,5,3,10,At Risk
38279,147,9,2427.8,4,2,4,10,Big Spenders
38280,56,17,2726.17,5,5,5,15,Champions
38281,199,14,1725.43,3,5,4,12,Big Spenders
38282,272,11,2103.67,2,3,4,9,Regulars
38283,36,10,1515.86,5,3,3,11,Loyal
38284,493,7,598.28,1,1,1,3,Hibernating
38285,119,15,4081.0499999999997,4,5,5,14,Champions
38286,152,13,4524.59,3,4,5,12,Big Spenders
38287,230,12,1129.66,3,4,2,9,Regulars
38288,560,8,635.29,1,2,1,4,Hibernating
38289,72,9,1991.12,4,2,4,10,Big Spenders
38290,142,17,2277.9,4,5,4,13,Champions
38291,151,12,4451.19,3,4,5,12,Big Spenders
38292,960,8,926.22,1,2,2,5,Hibernating
38293,291,10,2383.61,2,3,4,9,Regulars
38294,96,16,880.58,4,5,2,11,Loyal
38295,23,15,1803.7,5,5,4,14,Champions
38296,202,11,3843.01,3,3,5,11,Big Spenders
38297,51,12,2160.0,5,4,4,13,Champions
38298,52,13,1811.6200000000001,5,4,4,13,Champions
38299,261,7,2618.19,2,1,5,8,Regulars
38300,315,9,865.35,2,2,2,6,Hibernating
38301,8,6,235.39999999999998,5,1,1,7,Regulars
38302,12,6,461.6,5,1,1,7,Regulars
38303,11,11,1184.47,5,3,2,10,Loyal
38304,335,10,1125.62,2,3,2,7,Regulars
38305,237,14,2955.42,3,5,5,13,Big Spenders
38306,673,10,1738.48,1,3,4,8,Regulars
38307,598,7,1090.6299999999999,1,1,2,4,Hibernating
38308,10,14,3126.48,5,5,5,15,Champions
38309,55,7,1831.75,5,1,4,10,Big Spenders
38310,339,10,1407.0800000000002,2,3,3,8,Regulars
38311,200,11,798.04,3,3,1,7,Regulars
38312,53,15,2054.9,5,5,4,14,Champions
38313,33,8,600.91,5,2,1,8,Regulars
38314,407,11,1640.09,2,3,3,8,Regulars
38315,252,7,2322.3500000000004,2,1,4,7,Regulars
38316,480,13,1556.13,1,4,3,8,At Risk
38317,195,10,5419.64,3,3,5,11,Big Spenders
38318,180,11,1637.12,3,3,3,9,Regulars
38319,190,7,1196.6100000000001,3,1,2,6,Regulars
38320,140,11,3019.17,4,3,5,12,Loyal
38321,542,11,1472.15,1,3,3,7,Regulars
38322,122,12,1341.23,4,4,3,11,Loyal
38323,582,8,636.36,1,2,1,4,Hibernating
38324,571,7,1007.24,1,1,2,4,Hibernating
38325,284,11,1478.4,2,3,3,8,Regulars
38326,171,9,2053.24,3,2,4,9,Big Spenders
38327,87,8,811.23,4,2,1,7,Regulars
38328,27,12,1173.94,5,4,2,11,Loyal
38329,453,11,2939.2299999999996,2,3,5,10,Regulars
38330,113,8,2911.75,4,2,5,11,Big Spenders
38331,271,4,212.47,2,1,1,4,Hibernating
38332,460,12,1510.44,1,4,3,8,At Risk
38333,768,11,3320.3,1,3,5,9,Regulars
38334,245,5,2266.56,3,1,4,8,Big Spenders
38335,40,14,2304.72,5,5,4,14,Champions
38336,941,10,878.36,1,3,2,6,Regulars
38337,596,7,464.06,1,1,1,3,Hibernating
38338,362,12,1795.93,2,4,4,10,At Risk
38339,125,9,1589.3,4,2,3,9,Regulars
38340,125,15,2765.41,4,5,5,14,Champions
38341,215,9,1173.76,3,2,2,7,Regulars
38342,61,7,668.16,5,1,1,7,Regulars
38343,497,12,1686.8,1,4,3,8,At Risk
38344,451,13,1544.32,2,4,3,9,At Risk
38345,423,10,1032.36,2,3,2,7,Regulars
38346,113,13,1524.68,4,4,3,11,Loyal
38347,706,8,1260.26,1,2,3,6,Regulars
38348,139,10,1246.56,4,3,3,10,Loyal
38349,106,16,1477.8700000000001,4,5,3,12,Loyal
38350,481,6,357.05,1,1,1,3,Hibernating
38351,66,11,691.98,4,3,1,8,Loyal
38352,33,3,656.8,5,1,1,7,Regulars
38353,37,12,1462.31,5,4,3,12,Loyal
38354,124,11,2382.7400000000002,4,3,4,11,Loyal
38355,384,12,1090.7,2,4,2,8,At Risk
38356,74,14,1627.49,4,5,3,12,Loyal
38357,761,7,901.3199999999999,1,1,2,4,Hibernating
38358,118,9,1749.21,4,2,4,10,Big Spenders
38359,415,11,2520.09,2,3,4,9,Regulars
38360,63,11,2087.8199999999997,5,3,4,12,Loyal
38361,127,11,1744.42,4,3,4,11,Loyal
38362,80,8,619.49,4,2,1,7,Regulars
38363,0,12,5109.15,5,4,5,14,Champions
38364,160,7,1415.08,3,1,3,7,Regulars
38365,436,8,587.05,2,2,1,5,Hibernating
38366,228,16,4861.75,3,5,5,13,Big Spenders
38367,568,7,751.51,1,1,1,3,Hibernating
38368,67,7,2803.3300000000004,4,1,5,10,Big Spenders
38369,311,17,2597.7,2,5,5,12,At Risk
38370,5,8,1086.76,5,2,2,9,Regulars
38371,720,8,638.87,1,2,1,4,Hibernating
38372,10,10,2188.87,5,3,4,12,Loyal
38373,124,14,4792.37,4,5,5,14,Champions
38374,281,6,982.12,2,1,2,5,Hibernating
38375,530,9,2932.25,1,2,5,8,Regulars
38376,832,10,2661.89,1,3,5,9,Regulars
38377,37,11,862.87,5,3,2,10,Loyal
38378,229,11,3196.93,3,3,5,11,Big Spenders
38379,350,11,3485.2400000000002,2,3,5,10,Regulars
38380,0,10,2288.25,5,3,4,12,Loyal
38381,199,11,1025.92,3,3,2,8,Regulars
38382,413,12,1241.2,2,4,3,9,At Risk
38383,109,8,455.55,4,2,1,7,Regulars
38384,281,9,1673.11,2,2,3,7,Regulars
38385,106,10,1940.52,4,3,4,11,Loyal
38386,237,13,1343.3700000000001,3,4,3,10,Regulars
38387,390,7,2664.04,2,1,5,8,Regulars
38388,100,8,514.25,4,2,1,7,Regulars
38389,331,11,2992.6000000000004,2,3,5,10,Regulars
38390,632,11,695.82,1,3,1,5,Regulars
38391,181,13,4423.049999999999,3,4,5,12,Big Spenders
38392,19,7,2325.18,5,1,4,10,Big Spenders
38393,558,12,1397.06,1,4,3,8,At Risk
38394,216,6,1444.02,3,1,3,7,Regulars
38395,30,9,4111.96,5,2,5,12,Big Spenders
38396,167,10,2854.48,3,3,5,11,Big Spenders
38397,303,17,3453.57,2,5,5,12,At Risk
38398,391,16,1912.78,2,5,4,11,At Risk
38399,252,10,1601.4499999999998,2,3,3,8,Regulars
38400,318,8,1899.3400000000001,2,2,4,8,Regulars
38401,184,14,1671.43,3,5,3,11,Regulars
38402,95,11,1800.37,4,3,4,11,Loyal
38403,255,8,1137.22,2,2,2,6,Hibernating
38404,282,9,2821.56,2,2,5,9,Regulars
38405,441,9,1224.3600000000001,2,2,2,6,Hibernating
38406,20,10,1662.97,5,3,3,11,Loyal
38407,761,6,1176.1,1,1,2,4,Hibernating
38408,439,9,1555.91,2,2,3,7,Regulars
38409,528,9,548.22,1,2,1,4,Hibernating
38410,135,12,2759.2,4,4,5,13,Champions
38411,302,7,2149.44,2,1,4,7,Regulars
38412,1029,5,470.28,1,1,1,3,Hibernating
38413,229,18,2887.32,3,5,5,13,Big Spenders
38414,258,10,1761.27,2,3,4,9,Regulars
38415,773,5,604.4300000000001,1,1,1,3,Hibernating
38416,40,14,1966.98,5,5,4,14,Champions
38417,21,10,1458.95,5,3,3,11,Loyal
38418,166,13,884.6999999999999,3,4,2,9,Regulars
38419,461,7,776.27,1,1,1,3,Hibernating
38420,332,6,435.43,2,1,1,4,Hibernating
38421,222,10,1024.38,3,3,2,8,Regulars
38422,155,8,1658.7399999999998,3,2,3,8,Regulars
38423,361,10,3180.59,2,3,5,10,Regulars
38424,19,10,1745.1100000000001,5,3,4,12,Loyal
38425,880,5,973.3399999999999,1,1,2,4,Hibernating
38426,316,10,985.26,2,3,2,7,Regulars
38427,44,15,987.4300000000001,5,5,2,12,Loyal
38428,122,17,5678.03,4,5,5,14,Champions
38429,425,7,576.4300000000001,2,1,1,4,Hibernating
38430,19,10,1167.71,5,3,2,10,Loyal
38431,200,8,2102.4900000000002,3,2,4,9,Big Spenders
38432,858,9,1205.3,1,2,2,5,Hibernating
38433,25,9,419.64,5,2,1,8,Regulars
38434,535,9,2829.67,1,2,5,8,Regulars
38435,487,7,845.03,1,1,2,4,Hibernating
38436,140,12,4087.2700000000004,4,4,5,13,Champions
38437,458,10,1340.94,2,3,3,8,Regulars
38438,192,10,3016.69,3,3,5,11,Big Spenders
38439,769,10,3934.6099999999997,1,3,5,9,Regulars
38440,179,7,409.07,3,1,1,5,Regulars
38441,20,8,527.05,5,2,1,8,Regulars
38442,81,13,2988.84,4,4,5,13,Champions
38443,314,16,1887.97,2,5,4,11,At Risk
38444,557,8,1779.68,1,2,4,7,Regulars
38445,110,8,974.71,4,2,2,8,Regulars
38446,149,7,973.1400000000001,3,1,2,6,Regulars
38447,22,10,3508.7300000000005,5,3,5,13,Loyal
38448,93,11,2877.2200000000003,4,3,5,12,Loyal
38449,81,6,1546.6799999999998,4,1,3,8,Regulars
38450,383,9,848.25,2,2,2,6,Hibernating
38451,360,8,982.7199999999999,2,2,2,6,Hibernating
38452,296,7,609.86,2,1,1,4,Hibernating
38453,470,7,1600.79,1,1,3,5,Regulars
38454,398,6,583.74,2,1,1,4,Hibernating
38455,588,10,488.25,1,3,1,5,Regulars
38456,26,11,2153.19,5,3,4,12,Loyal
38457,322,13,5207.9,2,4,5,11,At Risk
38458,156,7,337.65,3,1,1,5,Regulars
38459,209,12,2539.5200000000004,3,4,4,11,Big Spenders
38460,90,14,1400.45,4,5,3,12,Loyal
38461,512,8,1455.5,1,2,3,6,Regulars
38462,68,9,438.92,4,2,1,7,Regulars
38463,384,10,1947.4800000000002,2,3,4,9,Regulars
38464,245,14,2285.9300000000003,3,5,4,12,Big Spenders
38465,600,10,2265.32,1,3,4,8,Regulars
38466,215,12,772.26,3,4,1,8,Regulars
38467,54,11,959.24,5,3,2,10,Loyal
38468,333,12,1974.28,2,4,4,10,At Risk
38469,108,12,1984.13,4,4,4,12,Champions
38470,316,8,2492.3199999999997,2,2,4,8,Regulars
38471,625,13,3403.8199999999997,1,4,5,10,At Risk
38472,88,17,6071.05,4,5,5,14,Champions
38473,262,9,2485.1000000000004,2,2,4,8,Regulars
38474,4,13,1613.6399999999999,5,4,3,12,Loyal
38475,350,9,886.96,2,2,2,6,Hibernating
38476,59,10,1791.91,5,3,4,12,Loyal
38477,805,11,877.58,1,3,2,6,Regulars
38478,249,6,935.04,2,1,2,5,Hibernating
38479,245,9,872.48,3,2,2,7,Regulars
38480,50,13,1712.4499999999998,5,4,3,12,Loyal
38481,851,10,1197.44,1,3,2,6,Regulars
38482,62,12,1175.23,5,4,2,11,Loyal
38483,595,9,1246.15,1,2,3,6,Regulars
38484,682,5,638.82,1,1,1,3,Hibernating
38485,0,11,2100.0,5,3,4,12,Loyal
38486,235,9,1317.1,3,2,3,8,Regulars
38487,155,6,970.9599999999999,3,1,2,6,Regulars
38488,459,10,1323.67,2,3,3,8,Regulars
38489,216,9,1286.72,3,2,3,8,Regulars
38490,18,14,1287.95,5,5,3,13,Loyal
38491,208,9,3142.2400000000002,3,2,5,10,Big Spenders
38492,394,12,3078.2400000000002,2,4,5,11,At Risk
38493,129,7,2263.1000000000004,4,1,4,9,Big Spenders
38494,117,15,3092.87,4,5,5,14,Champions
38495,551,6,983.4300000000001,1,1,2,4,Hibernating
38496,568,10,1776.53,1,3,4,8,Regulars
38497,237,6,406.15999999999997,3,1,1,5,Regulars
38498,108,12,2203.95,4,4,4,12,Champions
38499,376,7,430.34999999999997,2,1,1,4,Hibernating
38500,38,8,750.23,5,2,1,8,Regulars
38501,87,12,3509.64,4,4,5,13,Champions
38502,61,9,876.14,5,2,2,9,Regulars
38503,48,14,1243.6,5,5,3,13,Loyal
38504,0,10,2001.92,5,3,4,12,Loyal
38505,161,12,984.21,3,4,2,9,Regulars
38506,3,13,1487.85,5,4,3,12,Loyal
38507,374,12,1385.21,2,4,3,9,At Risk
38508,16,9,856.22,5,2,2,9,Regulars
38509,491,11,1355.0900000000001,1,3,3,7,Regulars
38510,122,14,1411.3899999999999,4,5,3,12,Loyal
38511,59,13,3682.8900000000003,5,4,5,14,Champions
38512,675,13,1288.63,1,4,3,8,At Risk
38513,96,10,2528.46,4,3,4,11,Loyal
38514,258,16,3090.5,2,5,5,12,At Risk
38515,171,16,2940.06,3,5,5,13,Big Spenders
38516,473,10,1496.34,1,3,3,7,Regulars
38517,118,11,1410.47,4,3,3,10,Loyal
38518,187,16,2812.67,3,5,5,13,Big Spenders
38519,193,10,1569.91,3,3,3,9,Regulars
38520,124,13,1585.95,4,4,3,11,Loyal
38521,858,8,1777.9700000000003,1,2,4,7,Regulars
38522,113,12,2105.54,4,4,4,12,Champions
38523,259,10,4207.39,2,3,5,10,Regulars
38524,39,8,1209.84,5,2,2,9,Regulars
38525,273,11,1279.03,2,3,3,8,Regulars
38526,134,11,3694.56,4,3,5,12,Loyal
38527,402,11,2035.02,2,3,4,9,Regulars
38528,82,11,1078.08,4,3,2,9,Loyal
38529,722,8,1936.89,1,2,4,7,Regulars
38530,193,10,1171.82,3,3,2,8,Regulars
38531,733,7,1121.16,1,1,2,4,Hibernating
38532,0,14,1300.32,5,5,3,13,Loyal
38533,165,7,1172.96,3,1,2,6,Regulars
38534,64,9,1413.05,5,2,3,10,Regulars
38535,1164,7,3032.28,1,1,5,7,Regulars
38536,79,12,1051.43,4,4,2,10,Loyal
38537,265,12,1096.41,2,4,2,8,At Risk
38538,198,9,716.8,3,2,1,6,Regulars
38539,72,7,960.0600000000001,4,1,2,7,Regulars
38540,96,12,1917.78,4,4,4,12,Champions
38541,133,13,1888.77,4,4,4,12,Champions
38542,79,13,3024.19,4,4,5,13,Champions
38543,114,9,2144.28,4,2,4,10,Big Spenders
38544,175,5,842.1600000000001,3,1,1,5,Regulars
38545,29,12,1224.45,5,4,2,11,Loyal
38546,1575,6,296.5,1,1,1,3,Hibernating
38547,314,8,888.42,2,2,2,6,Hibernating
38548,784,8,1127.31,1,2,2,5,Hibernating
38549,188,14,2854.03,3,5,5,13,Big Spenders
38550,113,16,3471.55,4,5,5,14,Champions
38551,395,11,3776.16,2,3,5,10,Regulars
38552,291,12,2234.44,2,4,4,10,At Risk
38553,191,13,1203.46,3,4,2,9,Regulars
38554,416,15,2072.75,2,5,4,11,At Risk
38555,98,8,1177.91,4,2,2,8,Regulars
38556,25,14,1250.83,5,5,3,13,Loyal
38557,10,10,960.99,5,3,2,10,Loyal
38558,711,10,1852.6499999999999,1,3,4,8,Regulars
38559,501,7,4376.0199999999995,1,1,5,7,Regulars
38560,0,8,730.98,5,2,1,8,Regulars
38561,873,7,1165.96,1,1,2,4,Hibernating
38562,213,10,1184.25,3,3,2,8,Regulars
38563,111,16,1750.96,4,5,4,13,Champions
38564,127,15,2533.98,4,5,4,13,Champions
38565,508,6,548.5799999999999,1,1,1,3,Hibernating
38566,7,8,1199.6000000000001,5,2,2,9,Regulars
38567,160,11,1075.8,3,3,2,8,Regulars
38568,345,12,1358.02,2,4,3,9,At Risk
38569,69,11,1073.1100000000001,4,3,2,9,Loyal
38570,108,11,3026.52,4,3,5,12,Loyal
38571,695,14,2799.22,1,5,5,11,At Risk
38572,583,8,1221.21,1,2,2,5,Hibernating
38573,580,8,734.5699999999999,1,2,1,4,Hibernating
38574,147,13,1840.1399999999999,4,4,4,12,Champions
38575,7,10,872.23,5,3,2,10,Loyal
38576,127,11,2149.67,4,3,4,11,Loyal
38577,21,9,1037.23,5,2,2,9,Regulars
38578,42,14,2824.95,5,5,5,15,Champions
38579,262,10,951.84,2,3,2,7,Regulars
38580,432,9,1496.6299999999999,2,2,3,7,Regulars
38581,199,4,911.04,3,1,2,6,Regulars
38582,285,4,1014.39,2,1,2,5,Hibernating
38583,139,7,839.27,4,1,1,6,Regulars
38584,22,13,1670.8999999999999,5,4,3,12,Loyal
38585,132,11,2644.25,4,3,5,12,Loyal
38586,139,9,1199.23,4,2,2,8,Regulars
38587,751,7,922.06,1,1,2,4,Hibernating
38588,14,16,2706.84,5,5,5,15,Champions
38589,26,16,1909.3200000000002,5,5,4,14,Champions
38590,68,13,4389.5,4,4,5,13,Champions
38591,149,10,3372.87,3,3,5,11,Big Spenders
38592,130,14,2602.01,4,5,5,14,Champions
38593,537,9,1806.74,1,2,4,7,Regulars
38594,316,7,1053.6,2,1,2,5,Hibernating
38595,153,9,2564.14,3,2,4,9,Big Spenders
38596,389,11,1188.9,2,3,2,7,Regulars
38597,0,15,2099.2999999999997,5,5,4,14,Champions
38598,309,7,2690.5699999999997,2,1,5,8,Regulars
38599,303,14,2252.34,2,5,4,11,At Risk
38600,107,14,2649.66,4,5,5,14,Champions
38601,171,12,1805.39,3,4,4,11,Big Spenders
38602,144,7,626.29,4,1,1,6,Regulars
38603,411,10,681.61,2,3,1,6,Regulars
38604,17,15,1009.0699999999999,5,5,2,12,Loyal
38605,351,9,1801.3000000000002,2,2,4,8,Regulars
38606,82,19,3364.78,4,5,5,14,Champions
38607,315,4,328.92,2,1,1,4,Hibernating
38608,62,8,1189.27,5,2,2,9,Regulars
38609,69,9,3675.55,4,2,5,11,Big Spenders
38610,2,10,2408.02,5,3,4,12,Loyal
38611,288,7,1091.55,2,1,2,5,Hibernating
38612,221,12,2736.6600000000003,3,4,5,12,Big Spenders
38613,734,11,2486.26,1,3,4,8,Regulars
38614,200,13,1609.56,3,4,3,10,Regulars
38615,753,6,1552.78,1,1,3,5,Regulars
38616,226,13,1344.16,3,4,3,10,Regulars
38617,35,13,2209.66,5,4,4,13,Champions
38618,85,15,3240.24,4,5,5,14,Champions
38619,213,8,2238.02,3,2,4,9,Big Spenders
38620,121,11,1358.98,4,3,3,10,Loyal
38621,379,11,3235.48,2,3,5,10,Regulars
38622,166,13,2823.98,3,4,5,12,Big Spenders
38623,1083,5,1095.15,1,1,2,4,Hibernating
38624,175,16,1200.56,3,5,2,10,Regulars
38625,322,6,1839.21,2,1,4,7,Regulars
38626,41,10,1057.74,5,3,2,10,Loyal
38627,951,7,516.89,1,1,1,3,Hibernating
38628,21,13,883.6700000000001,5,4,2,11,Loyal
38629,205,13,2919.14,3,4,5,12,Big Spenders
38630,268,10,2153.7599999999998,2,3,4,9,Regulars
38631,5,7,323.01,5,1,1,7,Regulars
38632,267,7,505.30999999999995,2,1,1,4,Hibernating
38633,259,10,2044.0,2,3,4,9,Regulars
38634,211,11,738.4,3,3,1,7,Regulars
38635,128,11,3644.59,4,3,5,12,Loyal
38636,163,10,1481.98,3,3,3,9,Regulars
38637,108,8,1554.1,4,2,3,9,Regulars
38638,228,9,3687.21,3,2,5,10,Big Spenders
38639,561,11,2036.75,1,3,4,8,Regulars
38640,144,10,1883.03,4,3,4,11,Loyal
38641,561,8,1012.15,1,2,2,5,Hibernating
38642,289,11,855.98,2,3,2,7,Regulars
38643,700,13,1441.49,1,4,3,8,At Risk
38644,92,10,1392.96,4,3,3,10,Loyal
38645,141,15,1416.6,4,5,3,12,Loyal
38646,124,10,1113.8,4,3,2,9,Loyal
38647,533,13,1859.01,1,4,4,9,At Risk
38648,295,8,1065.74,2,2,2,6,Hibernating
38649,114,14,1754.91,4,5,4,13,Champions
38650,413,6,807.12,2,1,1,4,Hibernating
38651,337,13,1160.96,2,4,2,8,At Risk
38652,561,10,1545.6200000000001,1,3,3,7,Regulars
38653,198,6,672.35,3,1,1,5,Regulars
38654,857,11,3136.63,1,3,5,9,Regulars
38655,275,8,1943.97,2,2,4,8,Regulars
38656,599,10,723.37,1,3,1,5,Regulars
38657,438,14,1084.87,2,5,2,9,At Risk
38658,12,13,947.95,5,4,2,11,Loyal
38659,186,7,676.96,3,1,1,5,Regulars
38660,515,13,1477.06,1,4,3,8,At Risk
38661,273,12,908.52,2,4,2,8,At Risk
38662,651,8,806.62,1,2,1,4,Hibernating
38663,12,12,1628.4,5,4,3,12,Loyal
38664,61,8,1813.51,5,2,4,11,Big Spenders
38665,116,9,2070.7799999999997,4,2,4,10,Big Spenders
38666,405,13,1361.41,2,4,3,9,At Risk
38667,433,4,143.32999999999998,2,1,1,4,Hibernating
38668,1320,6,600.46,1,1,1,3,Hibernating
38669,102,9,1302.87,4,2,3,9,Regulars
38670,253,5,503.23,2,1,1,4,Hibernating
38671,187,10,893.34,3,3,2,8,Regulars
38672,20,16,4817.57,5,5,5,15,Champions
38673,198,12,2449.6,3,4,4,11,Big Spenders
38674,902,7,927.17,1,1,2,4,Hibernating
38675,409,10,508.68999999999994,2,3,1,6,Regulars
38676,155,7,1847.02,3,1,4,8,Big Spenders
38677,180,7,1233.9,3,1,2,6,Regulars
38678,271,8,508.12,2,2,1,5,Hibernating
38679,46,13,2081.44,5,4,4,13,Champions
38680,221,7,1576.4499999999998,3,1,3,7,Regulars
38681,147,8,572.4200000000001,4,2,1,7,Regulars
38682,105,11,4138.280000000001,4,3,5,12,Loyal
38683,628,15,1980.96,1,5,4,10,At Risk
38684,30,13,1792.74,5,4,4,13,Champions
38685,420,4,166.13,2,1,1,4,Hibernating
38686,357,9,626.6,2,2,1,5,Hibernating
38687,44,18,2835.45,5,5,5,15,Champions
38688,290,9,547.7,2,2,1,5,Hibernating
38689,177,14,4088.8199999999997,3,5,5,13,Big Spenders
38690,286,11,1551.3899999999999,2,3,3,8,Regulars
38691,105,7,1465.31,4,1,3,8,Regulars
38692,93,13,2572.21,4,4,4,12,Champions
38693,857,11,1573.85,1,3,3,7,Regulars
38694,282,11,989.38,2,3,2,7,Regulars
38695,182,5,472.16999999999996,3,1,1,5,Regulars
38696,307,10,806.93,2,3,1,6,Regulars
38697,339,6,1502.95,2,1,3,6,Regulars
38698,172,12,2738.89,3,4,5,12,Big Spenders
38699,816,8,1882.45,1,2,4,7,Regulars
38700,208,8,564.59,3,2,1,6,Regulars
38701,2,6,391.04,5,1,1,7,Regulars
38702,563,9,804.24,1,2,1,4,Hibernating
38703,420,8,2138.27,2,2,4,8,Regulars
38704,111,10,905.4,4,3,2,9,Loyal
38705,129,17,2804.51,4,5,5,14,Champions
38706,158,13,1715.8200000000002,3,4,3,10,Regulars
38707,8,16,3995.8799999999997,5,5,5,15,Champions
38708,126,16,4124.29,4,5,5,14,Champions
38709,405,10,742.92,2,3,1,6,Regulars
38710,294,8,572.11,2,2,1,5,Hibernating
38711,480,8,1237.02,1,2,2,5,Hibernating
38712,348,8,984.21,2,2,2,6,Hibernating
38713,20,13,1539.16,5,4,3,12,Loyal
38714,54,6,990.3,5,1,2,8,Regulars
38715,13,12,2019.1499999999999,5,4,4,13,Champions
38716,134,10,2518.4700000000003,4,3,4,11,Loyal
38717,23,7,432.03,5,1,1,7,Regulars
38718,184,3,314.86,3,1,1,5,Regulars
38719,14,7,541.32,5,1,1,7,Regulars
38720,127,12,1519.93,4,4,3,11,Loyal
38721,56,9,795.9,5,2,1,8,Regulars
38722,349,9,533.06,2,2,1,5,Hibernating
38723,10,12,954.03,5,4,2,11,Loyal
38724,820,9,1171.73,1,2,2,5,Hibernating
38725,288,8,550.1,2,2,1,5,Hibernating
38726,136,10,1027.85,4,3,2,9,Loyal
38727,185,9,807.66,3,2,1,6,Regulars
38728,150,12,3777.4199999999996,3,4,5,12,Big Spenders
38729,240,5,307.83,3,1,1,5,Regulars
38730,222,6,1038.66,3,1,2,6,Regulars
38731,422,12,3602.8,2,4,5,11,At Risk
38732,52,22,3621.1,5,5,5,15,Champions
38733,23,8,1389.31,5,2,3,10,Regulars
38734,21,16,3527.12,5,5,5,15,Champions
38735,229,9,1498.0,3,2,3,8,Regulars
38736,369,11,960.7,2,3,2,7,Regulars
38737,50,12,6128.42,5,4,5,14,Champions
38738,409,16,3175.83,2,5,5,12,At Risk
38739,894,12,992.2099999999999,1,4,2,7,At Risk
38740,266,13,1612.51,2,4,3,9,At Risk
38741,731,14,2013.86,1,5,4,10,At Risk
38742,441,12,747.8,2,4,1,7,At Risk
38743,57,8,2155.43,5,2,4,11,Big Spenders
38744,121,13,1735.37,4,4,4,12,Champions
38745,130,12,1746.8200000000002,4,4,4,12,Champions
38746,479,5,418.96000000000004,1,1,1,3,Hibernating
38747,133,13,1702.7,4,4,3,11,Loyal
38748,27,9,1245.26,5,2,3,10,Regulars
38749,1097,5,373.59000000000003,1,1,1,3,Hibernating
38750,26,13,3366.0,5,4,5,14,Champions
38751,703,8,2072.4300000000003,1,2,4,7,Regulars
38752,181,18,2033.83,3,5,4,12,Big Spenders
38753,53,10,1082.3899999999999,5,3,2,10,Loyal
38754,0,16,2549.9300000000003,5,5,4,14,Champions
38755,148,8,760.24,3,2,1,6,Regulars
38756,87,13,727.45,4,4,1,9,Loyal
38757,135,8,1635.46,4,2,3,9,Regulars
38758,148,6,745.26,3,1,1,5,Regulars
38759,559,8,1210.25,1,2,2,5,Hibernating
38760,315,14,1229.78,2,5,2,9,At Risk
38761,62,15,3487.51,5,5,5,15,Champions
38762,150,10,1671.41,3,3,3,9,Regulars
38763,1232,7,969.73,1,1,2,4,Hibernating
38764,816,6,939.8199999999999,1,1,2,4,Hibernating
38765,229,19,2830.54,3,5,5,13,Big Spenders
38766,823,9,1025.5,1,2,2,5,Hibernating
38767,59,9,1077.16,5,2,2,9,Regulars
38768,113,14,1563.08,4,5,3,12,Loyal
38769,53,17,2364.5299999999997,5,5,4,14,Champions
38770,343,8,1298.6299999999999,2,2,3,7,Regulars
38771,528,6,4033.17,1,1,5,7,Regulars
38772,68,12,1096.83,4,4,2,10,Loyal
38773,61,10,662.48,5,3,1,9,Loyal
38774,172,14,850.37,3,5,2,10,Regulars
38775,34,13,1682.16,5,4,3,12,Loyal
38776,140,9,1113.19,4,2,2,8,Regulars
38777,371,14,3388.85,2,5,5,12,At Risk
38778,312,8,1027.66,2,2,2,6,Hibernating
38779,505,7,442.05,1,1,1,3,Hibernating
38780,231,12,994.76,3,4,2,9,Regulars
38781,124,21,2407.5,4,5,4,13,Champions
38782,418,14,1383.41,2,5,3,10,At Risk
38783,48,12,1979.27,5,4,4,13,Champions
38784,558,9,945.87,1,2,2,5,Hibernating
38785,256,12,1371.3899999999999,2,4,3,9,At Risk
38786,80,10,3404.2799999999997,4,3,5,12,Loyal
38787,314,10,1134.23,2,3,2,7,Regulars
38788,216,8,1261.59,3,2,3,8,Regulars
38789,188,5,276.03,3,1,1,5,Regulars
38790,261,8,842.35,2,2,1,5,Hibernating
38791,279,12,1873.52,2,4,4,10,At Risk
38792,71,12,1870.01,4,4,4,12,Champions
38793,71,15,1832.67,4,5,4,13,Champions
38794,585,9,1883.5399999999997,1,2,4,7,Regulars
38795,733,8,1922.62,1,2,4,7,Regulars
38796,166,11,1083.4,3,3,2,8,Regulars
38797,819,7,773.42,1,1,1,3,Hibernating
38798,382,13,3846.6200000000003,2,4,5,11,At Risk
38799,7,18,2269.36,5,5,4,14,Champions
38800,742,12,2475.61,1,4,4,9,At Risk
38801,128,8,503.71999999999997,4,2,1,7,Regulars
38802,329,8,3105.5,2,2,5,9,Regulars
38803,465,8,1639.95,1,2,3,6,Regulars
38804,624,6,1388.33,1,1,3,5,Regulars
38805,596,8,2665.99,1,2,5,8,Regulars
38806,281,12,1217.78,2,4,2,8,At Risk
38807,190,9,1545.3899999999999,3,2,3,8,Regulars
38808,777,13,2175.9900000000002,1,4,4,9,At Risk
38809,42,9,1880.34,5,2,4,11,Big Spenders
38810,372,11,1387.18,2,3,3,8,Regulars
38811,264,8,1164.23,2,2,2,6,Hibernating
38812,507,3,153.5,1,1,1,3,Hibernating
38813,70,9,1217.1299999999999,4,2,2,8,Regulars
38814,653,12,1185.66,1,4,2,7,At Risk
38815,708,6,639.0699999999999,1,1,1,3,Hibernating
38816,250,9,2452.1200000000003,2,2,4,8,Regulars
38817,799,9,1058.8,1,2,2,5,Hibernating
38818,318,5,372.72999999999996,2,1,1,4,Hibernating
38819,0,12,2842.8900000000003,5,4,5,14,Champions
38820,176,9,994.0899999999999,3,2,2,7,Regulars
38821,167,9,1643.47,3,2,3,8,Regulars
38822,123,12,4332.49,4,4,5,13,Champions
38823,162,12,5972.69,3,4,5,12,Big Spenders
38824,1181,8,1217.21,1,2,2,5,Hibernating
38825,269,15,1539.91,2,5,3,10,At Risk
38826,373,7,1241.33,2,1,3,6,Regulars
38827,423,7,534.6700000000001,2,1,1,4,Hibernating
38828,144,8,685.4300000000001,4,2,1,7,Regulars
38829,348,14,3612.7600000000007,2,5,5,12,At Risk
38830,65,7,1121.81,5,1,2,8,Regulars
38831,111,11,3229.34,4,3,5,12,Loyal
38832,237,8,1002.36,3,2,2,7,Regulars
38833,21,22,3813.2,5,5,5,15,Champions
38834,243,12,989.86,3,4,2,9,Regulars
38835,357,12,3467.01,2,4,5,11,At Risk
38836,422,15,4786.889999999999,2,5,5,12,At Risk
38837,171,13,1768.4699999999998,3,4,4,11,Big Spenders
38838,399,12,1293.72,2,4,3,9,At Risk
38839,103,17,1350.24,4,5,3,12,Loyal
38840,436,6,931.47,2,1,2,5,Hibernating
38841,141,5,407.56,4,1,1,6,Regulars
38842,124,14,1391.54,4,5,3,12,Loyal
38843,493,6,444.48999999999995,1,1,1,3,Hibernating
38844,116,9,701.35,4,2,1,7,Regulars
38845,110,8,1704.4499999999998,4,2,3,9,Regulars
38846,208,12,3622.08,3,4,5,12,Big Spenders
38847,136,9,1339.31,4,2,3,9,Regulars
38848,162,9,2731.69,3,2,5,10,Big Spenders
38849,712,7,867.66,1,1,2,4,Hibernating
38850,348,5,600.55,2,1,1,4,Hibernating
38851,99,18,6544.43,4,5,5,14,Champions
38852,585,13,1183.25,1,4,2,7,At Risk
38853,1366,3,631.35,1,1,1,3,Hibernating
38854,909,11,1281.53,1,3,3,7,Regulars
38855,123,12,1268.4099999999999,4,4,3,11,Loyal
38856,102,9,768.01,4,2,1,7,Regulars
38857,159,10,1003.21,3,3,2,8,Regulars
38858,195,9,580.77,3,2,1,6,Regulars
38859,439,10,2716.22,2,3,5,10,Regulars
38860,934,5,514.12,1,1,1,3,Hibernating
38861,111,15,1525.19,4,5,3,12,Loyal
38862,256,7,1403.7399999999998,2,1,3,6,Regulars
38863,522,6,288.92999999999995,1,1,1,3,Hibernating
38864,152,7,528.2,3,1,1,5,Regulars
38865,644,5,793.2299999999999,1,1,1,3,Hibernating
38866,221,7,751.1700000000001,3,1,1,5,Regulars
38867,29,13,1531.72,5,4,3,12,Loyal
38868,63,5,709.24,5,1,1,7,Regulars
38869,497,5,1482.4399999999998,1,1,3,5,Regulars
38870,226,9,2334.33,3,2,4,9,Big Spenders
38871,1147,10,1071.09,1,3,2,6,Regulars
38872,134,9,1138.06,4,2,2,8,Regulars
38873,145,11,1363.77,4,3,3,10,Loyal
38874,74,10,1310.06,4,3,3,10,Loyal
38875,796,5,2031.39,1,1,4,6,Regulars
38876,248,6,1539.98,2,1,3,6,Regulars
38877,250,10,1423.98,2,3,3,8,Regulars
38878,109,12,1486.45,4,4,3,11,Loyal
38879,544,11,3538.0299999999997,1,3,5,9,Regulars
38880,91,13,2592.32,4,4,5,13,Champions
38881,155,9,1111.24,3,2,2,7,Regulars
38882,144,12,1002.43,4,4,2,10,Loyal
38883,560,9,823.2,1,2,1,4,Hibernating
38884,187,10,1507.32,3,3,3,9,Regulars
38885,303,3,342.07,2,1,1,4,Hibernating
38886,188,9,1599.1399999999999,3,2,3,8,Regulars
38887,63,13,3583.31,5,4,5,14,Champions
38888,221,11,3355.21,3,3,5,11,Big Spenders
38889,450,10,921.01,2,3,2,7,Regulars
38890,166,11,1239.0,3,3,2,8,Regulars
38891,194,17,5124.45,3,5,5,13,Big Spenders
38892,100,9,1403.89,4,2,3,9,Regulars
38893,29,9,993.4100000000001,5,2,2,9,Regulars
38894,388,9,3774.04,2,2,5,9,Regulars
38895,212,14,1059.53,3,5,2,10,Regulars
38896,633,6,374.65,1,1,1,3,Hibernating
38897,227,8,925.56,3,2,2,7,Regulars
38898,127,18,1627.6100000000001,4,5,3,12,Loyal
38899,75,10,937.42,4,3,2,9,Loyal
38900,165,8,1176.77,3,2,2,7,Regulars
38901,481,6,675.5,1,1,1,3,Hibernating
38902,509,10,1262.29,1,3,3,7,Regulars
38903,772,12,792.44,1,4,1,6,At Risk
38904,83,8,1045.41,4,2,2,8,Regulars
38905,323,14,2243.42,2,5,4,11,At Risk
38906,714,4,318.84,1,1,1,3,Hibernating
38907,81,9,839.1899999999999,4,2,1,7,Regulars
38908,536,10,3124.03,1,3,5,9,Regulars
38909,296,9,3420.46,2,2,5,9,Regulars
38910,143,15,2503.4900000000002,4,5,4,13,Champions
38911,1329,2,820.78,1,1,1,3,Hibernating
38912,341,7,668.23,2,1,1,4,Hibernating
38913,278,9,1825.92,2,2,4,8,Regulars
38914,454,5,311.58,2,1,1,4,Hibernating
38915,385,5,519.79,2,1,1,4,Hibernating
38916,65,13,2711.09,5,4,5,14,Champions
38917,67,8,2005.31,4,2,4,10,Big Spenders
38918,20,11,737.9200000000001,5,3,1,9,Loyal
38919,139,7,613.41,4,1,1,6,Regulars
38920,636,8,2352.15,1,2,4,7,Regulars
38921,959,10,1726.3,1,3,4,8,Regulars
38922,182,17,1768.05,3,5,4,12,Big Spenders
38923,182,10,796.36,3,3,1,7,Regulars
38924,56,13,2548.83,5,4,4,13,Champions
38925,1231,10,2151.98,1,3,4,8,Regulars
38926,451,11,1622.3899999999999,2,3,3,8,Regulars
38927,208,14,3095.21,3,5,5,13,Big Spenders
38928,129,13,3219.4800000000005,4,4,5,13,Champions
38929,147,6,1021.65,4,1,2,7,Regulars
38930,578,9,840.15,1,2,1,4,Hibernating
38931,38,12,1491.01,5,4,3,12,Loyal
38932,237,11,3049.2,3,3,5,11,Big Spenders
38933,404,11,2135.68,2,3,4,9,Regulars
38934,13,12,1581.63,5,4,3,12,Loyal
38935,48,7,499.25,5,1,1,7,Regulars
38936,146,11,569.55,4,3,1,8,Loyal
38937,1097,6,618.24,1,1,1,3,Hibernating
38938,1102,6,2765.5800000000004,1,1,5,7,Regulars
38939,425,11,1475.48,2,3,3,8,Regulars
38940,91,11,998.0699999999999,4,3,2,9,Loyal
38941,125,9,1855.02,4,2,4,10,Big Spenders
38942,106,10,2942.5,4,3,5,12,Loyal
38943,316,10,1679.05,2,3,3,8,Regulars
38944,180,8,2519.39,3,2,4,9,Big Spenders
38945,2224,2,119.53,1,1,1,3,Hibernating
38946,738,8,1217.29,1,2,2,5,Hibernating
38947,315,8,1565.22,2,2,3,7,Regulars
38948,73,9,2291.85,4,2,4,10,Big Spenders
38949,333,9,1309.1899999999998,2,2,3,7,Regulars
38950,488,8,1748.6000000000001,1,2,4,7,Regulars
38951,162,10,1316.4099999999999,3,3,3,9,Regulars
38952,178,10,4062.6,3,3,5,11,Big Spenders
38953,547,10,1710.77,1,3,3,7,Regulars
38954,189,9,621.46,3,2,1,6,Regulars
38955,551,9,798.83,1,2,1,4,Hibernating
38956,196,9,949.55,3,2,2,7,Regulars
38957,102,8,1033.85,4,2,2,8,Regulars
38958,46,12,566.22,5,4,1,10,Loyal
38959,120,5,926.96,4,1,2,7,Regulars
38960,214,9,2435.92,3,2,4,9,Big Spenders
38961,60,10,944.1700000000001,5,3,2,10,Loyal
38962,174,11,972.36,3,3,2,8,Regulars
38963,879,13,3453.2,1,4,5,10,At Risk
38964,78,8,817.12,4,2,1,7,Regulars
38965,246,14,2534.5299999999997,3,5,4,12,Big Spenders
38966,128,6,993.95,4,1,2,7,Regulars
38967,315,5,1758.26,2,1,4,7,Regulars
38968,305,14,1768.48,2,5,4,11,At Risk
38969,237,11,1394.42,3,3,3,9,Regulars
38970,212,9,1628.8700000000001,3,2,3,8,Regulars
38971,179,12,802.34,3,4,1,8,Regulars
38972,43,14,2118.6600000000003,5,5,4,14,Champions
38973,40,6,555.63,5,1,1,7,Regulars
38974,750,5,466.38,1,1,1,3,Hibernating
38975,1094,10,2864.8,1,3,5,9,Regulars
38976,205,11,2395.51,3,3,4,10,Big Spenders
38977,193,8,1113.98,3,2,2,7,Regulars
38978,269,12,1221.59,2,4,2,8,At Risk
38979,237,10,1429.4099999999999,3,3,3,9,Regulars
38980,211,8,2607.2099999999996,3,2,5,10,Big Spenders
38981,42,18,2500.62,5,5,4,14,Champions
38982,254,6,1692.3,2,1,3,6,Regulars
38983,319,9,2235.5899999999997,2,2,4,8,Regulars
38984,177,13,1370.96,3,4,3,10,Regulars
38985,460,9,2518.8399999999997,1,2,4,7,Regulars
38986,154,12,2238.79,3,4,4,11,Big Spenders
38987,98,17,1940.76,4,5,4,13,Champions
38988,455,14,1608.28,2,5,3,10,At Risk
38989,1012,5,440.3,1,1,1,3,Hibernating
38990,645,8,852.07,1,2,2,5,Hibernating
38991,502,6,363.51,1,1,1,3,Hibernating
38992,23,11,4814.39,5,3,5,13,Loyal
38993,50,10,1276.99,5,3,3,11,Loyal
38994,19,15,1167.74,5,5,2,12,Loyal
38995,60,12,1667.46,5,4,3,12,Loyal
38996,251,11,1561.1799999999998,2,3,3,8,Regulars
38997,108,12,992.9499999999999,4,4,2,10,Loyal
38998,532,13,1199.96,1,4,2,7,At Risk
38999,15,17,1060.01,5,5,2,12,Loyal
39000,226,15,2660.76,3,5,5,13,Big Spenders
39001,268,14,1453.81,2,5,3,10,At Risk
39002,60,12,3701.97,5,4,5,14,Champions
39003,486,7,456.58,1,1,1,3,Hibernating
39004,80,6,1279.3,4,1,3,8,Regulars
39005,425,4,475.73,2,1,1,4,Hibernating
39006,1112,7,2766.6099999999997,1,1,5,7,Regulars
39007,443,13,4505.110000000001,2,4,5,11,At Risk
39008,155,10,867.46,3,3,2,8,Regulars
39009,456,12,1271.37,2,4,3,9,At Risk
39010,103,14,1991.78,4,5,4,13,Champions
39011,577,12,2292.27,1,4,4,9,At Risk
39012,342,7,1035.62,2,1,2,5,Hibernating
39013,632,12,4644.990000000001,1,4,5,10,At Risk
39014,73,9,3683.0700000000006,4,2,5,11,Big Spenders
39015,286,8,1938.74,2,2,4,8,Regulars
39016,193,7,1151.1299999999999,3,1,2,6,Regulars
39017,244,14,2747.55,3,5,5,13,Big Spenders
39018,85,14,4992.62,4,5,5,14,Champions
39019,125,15,2077.92,4,5,4,13,Champions
39020,162,14,869.89,3,5,2,10,Regulars
39021,318,12,2292.36,2,4,4,10,At Risk
39022,185,6,589.0699999999999,3,1,1,5,Regulars
39023,48,10,901.94,5,3,2,10,Loyal
39024,171,16,1844.19,3,5,4,12,Big Spenders
39025,499,16,2503.12,1,5,4,10,At Risk
39026,1047,9,764.1,1,2,1,4,Hibernating
39027,114,13,2181.37,4,4,4,12,Champions
39028,54,7,1584.8300000000002,5,1,3,9,Regulars
39029,190,11,1957.3300000000002,3,3,4,10,Big Spenders
39030,511,14,1416.96,1,5,3,9,At Risk
39031,723,7,3145.67,1,1,5,7,Regulars
39032,287,14,1583.1399999999999,2,5,3,10,At Risk
39033,282,7,2449.49,2,1,4,7,Regulars
39034,521,5,547.22,1,1,1,3,Hibernating
39035,285,8,646.87,2,2,1,5,Hibernating
39036,342,12,2899.27,2,4,5,11,At Risk
39037,424,9,1376.06,2,2,3,7,Regulars
39038,142,10,1554.35,4,3,3,10,Loyal
39039,119,17,4956.42,4,5,5,14,Champions
39040,34,8,448.28,5,2,1,8,Regulars
39041,112,9,768.98,4,2,1,7,Regulars
39042,58,9,447.84000000000003,5,2,1,8,Regulars
39043,467,9,796.5,1,2,1,4,Hibernating
39044,167,8,675.28,3,2,1,6,Regulars
39045,213,12,1102.67,3,4,2,9,Regulars
39046,206,7,2095.8999999999996,3,1,4,8,Big Spenders
39047,27,13,2226.12,5,4,4,13,Champions
39048,105,11,1390.32,4,3,3,10,Loyal
39049,903,6,1343.21,1,1,3,5,Regulars
39050,999,11,1718.73,1,3,3,7,Regulars
39051,169,10,4352.8099999999995,3,3,5,11,Big Spenders
39052,181,13,1868.6799999999998,3,4,4,11,Big Spenders
39053,325,10,1246.07,2,3,3,8,Regulars
39054,41,10,1887.22,5,3,4,12,Loyal
39055,82,10,1498.42,4,3,3,10,Loyal
39056,250,10,5746.33,2,3,5,10,Regulars
39057,136,8,2208.4300000000003,4,2,4,10,Big Spenders
39058,0,11,4403.32,5,3,5,13,Loyal
39059,218,8,660.17,3,2,1,6,Regulars
39060,36,7,946.14,5,1,2,8,Regulars
39061,355,15,3078.04,2,5,5,12,At Risk
39062,131,12,2608.76,4,4,5,13,Champions
39063,41,7,545.2,5,1,1,7,Regulars
39064,352,9,3423.8599999999997,2,2,5,9,Regulars
39065,126,7,1400.79,4,1,3,8,Regulars
39066,586,9,789.15,1,2,1,4,Hibernating
39067,5,8,531.75,5,2,1,8,Regulars
39068,10,13,3085.34,5,4,5,14,Champions
39069,686,8,1737.74,1,2,4,7,Regulars
39070,114,6,772.61,4,1,1,6,Regulars
39071,373,10,1570.12,2,3,3,8,Regulars
39072,246,9,2651.71,3,2,5,10,Big Spenders
39073,13,17,1450.59,5,5,3,13,Loyal
39074,718,8,1284.82,1,2,3,6,Regulars
39075,192,7,2782.63,3,1,5,9,Big Spenders
39076,412,13,964.24,2,4,2,8,At Risk
39077,239,11,1172.33,3,3,2,8,Regulars
39078,195,7,1205.35,3,1,2,6,Regulars
39079,188,9,3803.7999999999997,3,2,5,10,Big Spenders
39080,124,16,1765.3100000000002,4,5,4,13,Champions
39081,295,10,1196.03,2,3,2,7,Regulars
39082,134,12,980.7199999999999,4,4,2,10,Loyal
39083,707,5,329.77,1,1,1,3,Hibernating
39084,371,9,1515.82,2,2,3,7,Regulars
39085,385,6,716.58,2,1,1,4,Hibernating
39086,465,11,636.54,1,3,1,5,Regulars
39087,245,7,830.74,3,1,1,5,Regulars
39088,75,14,938.37,4,5,2,11,Loyal
39089,384,20,4719.21,2,5,5,12,At Risk
39090,510,6,630.8399999999999,1,1,1,3,Hibernating
39091,135,13,1587.1,4,4,3,11,Loyal
39092,98,12,1905.73,4,4,4,12,Champions
39093,20,9,1083.74,5,2,2,9,Regulars
39094,219,16,4220.55,3,5,5,13,Big Spenders
39095,0,11,813.0600000000001,5,3,1,9,Loyal
39096,21,15,2898.69,5,5,5,15,Champions
39097,286,6,1224.75,2,1,2,5,Hibernating
39098,149,7,502.28,3,1,1,5,Regulars
39099,739,3,319.28,1,1,1,3,Hibernating
39100,25,7,451.76,5,1,1,7,Regulars
39101,29,7,1295.57,5,1,3,9,Regulars
39102,84,13,4335.64,4,4,5,13,Champions
39103,300,10,1228.94,2,3,2,7,Regulars
39104,285,11,1847.91,2,3,4,9,Regulars
39105,103,9,698.03,4,2,1,7,Regulars
39106,26,17,1969.5,5,5,4,14,Champions
39107,159,9,2579.58,3,2,5,10,Big Spenders
39108,285,7,872.06,2,1,2,5,Hibernating
39109,111,12,1902.32,4,4,4,12,Champions
39110,208,16,1293.22,3,5,3,11,Regulars
39111,133,9,956.35,4,2,2,8,Regulars
39112,186,15,2116.63,3,5,4,12,Big Spenders
39113,595,11,3172.01,1,3,5,9,Regulars
39114,64,12,961.4300000000001,5,4,2,11,Loyal
39115,589,12,928.78,1,4,2,7,At Risk
39116,219,10,2949.9100000000003,3,3,5,11,Big Spenders
39117,33,11,2190.5699999999997,5,3,4,12,Loyal
39118,211,10,2475.86,3,3,4,10,Big Spenders
39119,85,13,3351.22,4,4,5,13,Champions
39120,166,11,1389.83,3,3,3,9,Regulars
39121,231,13,884.85,3,4,2,9,Regulars
39122,278,14,3631.04,2,5,5,12,At Risk
39123,615,13,1057.96,1,4,2,7,At Risk
39124,254,12,1481.97,2,4,3,9,At Risk
39125,744,5,529.37,1,1,1,3,Hibernating
39126,201,17,3733.5699999999997,3,5,5,13,Big Spenders
39127,23,9,1737.44,5,2,4,11,Big Spenders
39128,802,10,1694.18,1,3,3,7,Regulars
39129,523,8,2084.88,1,2,4,7,Regulars
39130,174,10,4580.32,3,3,5,11,Big Spenders
39131,100,9,1064.22,4,2,2,8,Regulars
39132,65,7,2810.98,5,1,5,11,Big Spenders
39133,101,11,1241.89,4,3,3,10,Loyal
39134,1159,4,562.41,1,1,1,3,Hibernating
39135,33,11,2544.84,5,3,4,12,Loyal
39136,891,13,4235.09,1,4,5,10,At Risk
39137,120,14,2248.07,4,5,4,13,Champions
39138,138,4,342.21000000000004,4,1,1,6,Regulars
39139,140,10,3233.5400000000004,4,3,5,12,Loyal
39140,119,8,1729.46,4,2,4,10,Big Spenders
39141,25,11,1984.9899999999998,5,3,4,12,Loyal
39142,188,14,2566.54,3,5,4,12,Big Spenders
39143,498,13,3069.59,1,4,5,10,At Risk
39144,543,12,1355.06,1,4,3,8,At Risk
39145,313,7,1986.04,2,1,4,7,Regulars
39146,155,12,1507.68,3,4,3,10,Regulars
39147,298,12,1796.7,2,4,4,10,At Risk
39148,112,8,671.3399999999999,4,2,1,7,Regulars
39149,638,7,1281.6899999999998,1,1,3,5,Regulars
39150,69,12,3181.7000000000003,4,4,5,13,Champions
39151,138,10,855.51,4,3,2,9,Loyal
39152,175,5,552.99,3,1,1,5,Regulars
39153,319,15,1517.1499999999999,2,5,3,10,At Risk
39154,165,12,1309.77,3,4,3,10,Regulars
39155,9,9,1256.8500000000001,5,2,3,10,Regulars
39156,174,15,1751.69,3,5,4,12,Big Spenders
39157,69,11,1015.08,4,3,2,9,Loyal
39158,91,8,1380.25,4,2,3,9,Regulars
39159,250,8,740.32,2,2,1,5,Hibernating
39160,132,14,4256.23,4,5,5,14,Champions
39161,220,9,3087.0699999999997,3,2,5,10,Big Spenders
39162,349,8,1153.88,2,2,2,6,Hibernating
39163,89,14,1624.23,4,5,3,12,Loyal
39164,785,4,141.95,1,1,1,3,Hibernating
39165,161,9,3743.6800000000003,3,2,5,10,Big Spenders
39166,19,11,1624.58,5,3,3,11,Loyal
39167,656,11,2343.94,1,3,4,8,Regulars
39168,228,10,621.13,3,3,1,7,Regulars
39169,287,14,1445.97,2,5,3,10,At Risk
39170,17,15,3362.87,5,5,5,15,Champions
39171,153,14,2800.76,3,5,5,13,Big Spenders
39172,372,11,4320.1,2,3,5,10,Regulars
39173,600,7,543.72,1,1,1,3,Hibernating
39174,672,11,1722.86,1,3,3,7,Regulars
39175,1135,4,1886.3999999999999,1,1,4,6,Regulars
39176,82,17,4216.51,4,5,5,14,Champions
39177,193,12,2732.48,3,4,5,12,Big Spenders
39178,126,16,1558.07,4,5,3,12,Loyal
39179,129,12,2877.94,4,4,5,13,Champions
39180,861,8,2436.33,1,2,4,7,Regulars
39181,18,6,1649.34,5,1,3,9,Regulars
39182,525,13,2478.46,1,4,4,9,At Risk
39183,176,11,2171.75,3,3,4,10,Big Spenders
39184,632,7,2670.6200000000003,1,1,5,7,Regulars
39185,16,12,1098.91,5,4,2,11,Loyal
39186,28,16,5183.99,5,5,5,15,Champions
39187,49,10,1119.2,5,3,2,10,Loyal
39188,49,14,3808.22,5,5,5,15,Champions
39189,591,10,1213.24,1,3,2,6,Regulars
39190,24,12,1469.0200000000002,5,4,3,12,Loyal
39191,140,14,4221.07,4,5,5,14,Champions
39192,688,11,864.4200000000001,1,3,2,6,Regulars
39193,9,14,984.4300000000001,5,5,2,12,Loyal
39194,693,7,689.26,1,1,1,3,Hibernating
39195,444,11,909.35,2,3,2,7,Regulars
39196,198,11,2393.01,3,3,4,10,Big Spenders
39197,84,16,1184.12,4,5,2,11,Loyal
39198,311,9,2851.5499999999997,2,2,5,9,Regulars
39199,5,12,1276.71,5,4,3,12,Loyal
39200,478,11,4554.73,1,3,5,9,Regulars
39201,35,9,1019.0899999999999,5,2,2,9,Regulars
39202,291,12,1406.08,2,4,3,9,At Risk
39203,468,7,2464.8299999999995,1,1,4,6,Regulars
39204,529,12,1914.69,1,4,4,9,At Risk
39205,670,11,2561.78,1,3,4,8,Regulars
39206,48,10,581.71,5,3,1,9,Loyal
39207,193,13,1066.61,3,4,2,9,Regulars
39208,403,9,5369.34,2,2,5,9,Regulars
39209,55,14,2231.47,5,5,4,14,Champions
39210,358,12,2025.51,2,4,4,10,At Risk
39211,105,8,1272.19,4,2,3,9,Regulars
39212,449,10,4738.51,2,3,5,10,Regulars
39213,601,15,3407.55,1,5,5,11,At Risk
39214,724,12,742.88,1,4,1,6,At Risk
39215,48,9,2726.15,5,2,5,12,Big Spenders
39216,557,8,942.88,1,2,2,5,Hibernating
39217,117,15,2424.48,4,5,4,13,Champions
39218,117,7,598.9,4,1,1,6,Regulars
39219,600,11,2027.76,1,3,4,8,Regulars
39220,174,11,3430.7599999999998,3,3,5,11,Big Spenders
39221,18,10,2429.12,5,3,4,12,Loyal
39222,175,8,2296.7,3,2,4,9,Big Spenders
39223,253,11,1236.02,2,3,2,7,Regulars
39224,27,10,629.34,5,3,1,9,Loyal
39225,165,9,2675.43,3,2,5,10,Big Spenders
39226,532,3,256.24,1,1,1,3,Hibernating
39227,1215,3,214.73,1,1,1,3,Hibernating
39228,181,13,1802.7099999999998,3,4,4,11,Big Spenders
39229,52,12,4372.52,5,4,5,14,Champions
39230,192,11,1069.73,3,3,2,8,Regulars
39231,48,10,1830.6999999999998,5,3,4,12,Loyal
39232,192,12,1272.84,3,4,3,10,Regulars
39233,203,12,1221.46,3,4,2,9,Regulars
39234,36,9,2012.0,5,2,4,11,Big Spenders
39235,174,6,2185.8199999999997,3,1,4,8,Big Spenders
39236,1111,6,689.38,1,1,1,3,Hibernating
39237,249,7,663.71,2,1,1,4,Hibernating
39238,112,8,1081.2,4,2,2,8,Regulars
39239,235,18,4212.41,3,5,5,13,Big Spenders
39240,333,10,992.8,2,3,2,7,Regulars
39241,28,11,5398.28,5,3,5,13,Loyal
39242,363,14,2604.7599999999998,2,5,5,12,At Risk
39243,61,8,867.43,5,2,2,9,Regulars
39244,50,11,1604.55,5,3,3,11,Loyal
39245,161,10,1498.22,3,3,3,9,Regulars
39246,190,8,545.26,3,2,1,6,Regulars
39247,9,17,2006.3799999999999,5,5,4,14,Champions
39248,272,9,1343.3700000000001,2,2,3,7,Regulars
39249,322,9,2700.34,2,2,5,9,Regulars
39250,52,11,2445.84,5,3,4,12,Loyal
39251,760,14,2062.54,1,5,4,10,At Risk
39252,6,12,1241.92,5,4,3,12,Loyal
39253,407,7,2066.63,2,1,4,7,Regulars
39254,67,13,4007.28,4,4,5,13,Champions
39255,672,11,1388.1000000000001,1,3,3,7,Regulars
39256,23,12,1416.46,5,4,3,12,Loyal
39257,292,8,2456.86,2,2,4,8,Regulars
39258,208,8,3772.9800000000005,3,2,5,10,Big Spenders
39259,75,14,3957.71,4,5,5,14,Champions
39260,878,7,1993.8799999999999,1,1,4,6,Regulars
39261,123,16,3518.46,4,5,5,14,Champions
39262,64,12,2179.25,5,4,4,13,Champions
39263,724,10,796.51,1,3,1,5,Regulars
39264,33,17,1656.0900000000001,5,5,3,13,Loyal
39265,154,7,530.48,3,1,1,5,Regulars
39266,92,11,1611.34,4,3,3,10,Loyal
39267,43,11,2283.77,5,3,4,12,Loyal
39268,39,10,586.14,5,3,1,9,Loyal
39269,305,9,3490.97,2,2,5,9,Regulars
39270,142,15,5114.33,4,5,5,14,Champions
39271,512,15,1432.87,1,5,3,9,At Risk
39272,107,13,1027.64,4,4,2,10,Loyal
39273,513,5,292.76,1,1,1,3,Hibernating
39274,147,18,2734.38,4,5,5,14,Champions
39275,598,10,2998.95,1,3,5,9,Regulars
39276,209,11,2581.09,3,3,5,11,Big Spenders
39277,64,9,401.87,5,2,1,8,Regulars
39278,152,8,652.89,3,2,1,6,Regulars
39279,227,12,1815.33,3,4,4,11,Big Spenders
39280,60,12,2327.68,5,4,4,13,Champions
39281,450,9,1232.1399999999999,2,2,2,6,Hibernating
39282,36,10,1039.11,5,3,2,10,Loyal
39283,358,11,848.92,2,3,2,7,Regulars
39284,218,16,1212.12,3,5,2,10,Regulars
39285,160,13,998.04,3,4,2,9,Regulars
39286,467,11,2314.3,1,3,4,8,Regulars
39287,211,6,2442.38,3,1,4,8,Big Spenders
39288,229,14,1145.63,3,5,2,10,Regulars
39289,99,10,2110.63,4,3,4,11,Loyal
39290,841,6,489.24999999999994,1,1,1,3,Hibernating
39291,170,11,1412.4199999999998,3,3,3,9,Regulars
39292,111,7,1423.51,4,1,3,8,Regulars
39293,882,5,478.12000000000006,1,1,1,3,Hibernating
39294,467,9,2833.9199999999996,1,2,5,8,Regulars
39295,72,16,1621.45,4,5,3,12,Loyal
39296,144,7,250.06,4,1,1,6,Regulars
39297,169,11,1804.4999999999998,3,3,4,10,Big Spenders
39298,108,10,1270.34,4,3,3,10,Loyal
39299,271,8,1692.74,2,2,3,7,Regulars
39300,74,10,1257.27,4,3,3,10,Loyal
39301,1671,2,122.21000000000001,1,1,1,3,Hibernating
39302,41,14,2131.14,5,5,4,14,Champions
39303,1,13,1622.81,5,4,3,12,Loyal
39304,83,11,3483.9199999999996,4,3,5,12,Loyal
39305,813,9,1001.22,1,2,2,5,Hibernating
39306,761,10,1738.35,1,3,4,8,Regulars
39307,262,10,3646.96,2,3,5,10,Regulars
39308,8,14,1008.37,5,5,2,12,Loyal
39309,151,10,2127.19,3,3,4,10,Big Spenders
39310,802,7,516.25,1,1,1,3,Hibernating
39311,112,12,1057.53,4,4,2,10,Loyal
39312,363,5,523.34,2,1,1,4,Hibernating
39313,226,13,1144.38,3,4,2,9,Regulars
39314,503,6,759.64,1,1,1,3,Hibernating
39315,47,24,2904.33,5,5,5,15,Champions
39316,40,8,1345.56,5,2,3,10,Regulars
39317,223,20,3258.32,3,5,5,13,Big Spenders
39318,375,6,334.62,2,1,1,4,Hibernating
39319,853,10,1206.68,1,3,2,6,Regulars
39320,223,12,3588.2599999999998,3,4,5,12,Big Spenders
39321,272,13,785.92,2,4,1,7,At Risk
39322,60,12,5140.81,5,4,5,14,Champions
39323,293,5,402.5,2,1,1,4,Hibernating
39324,609,10,1524.91,1,3,3,7,Regulars
39325,358,8,1165.51,2,2,2,6,Hibernating
39326,192,12,1282.11,3,4,3,10,Regulars
39327,179,10,1721.8999999999999,3,3,3,9,Regulars
39328,41,10,1285.37,5,3,3,11,Loyal
39329,1054,5,1405.0400000000002,1,1,3,5,Regulars
39330,281,9,608.46,2,2,1,5,Hibernating
39331,21,12,934.12,5,4,2,11,Loyal
39332,232,9,702.09,3,2,1,6,Regulars
39333,354,8,682.16,2,2,1,5,Hibernating
39334,68,12,1801.3899999999999,4,4,4,12,Champions
39335,293,10,2039.64,2,3,4,9,Regulars
39336,17,10,960.67,5,3,2,10,Loyal
39337,350,9,987.95,2,2,2,6,Hibernating
39338,253,14,1515.8899999999999,2,5,3,10,At Risk
39339,972,11,1036.93,1,3,2,6,Regulars
39340,73,9,752.81,4,2,1,7,Regulars
39341,689,9,2351.6000000000004,1,2,4,7,Regulars
39342,110,18,2881.4900000000002,4,5,5,14,Champions
39343,57,17,1849.75,5,5,4,14,Champions
39344,8,18,2553.7,5,5,4,14,Champions
39345,140,6,1421.52,4,1,3,8,Regulars
39346,214,10,1636.78,3,3,3,9,Regulars
39347,36,13,1598.9899999999998,5,4,3,12,Loyal
39348,135,9,761.2199999999999,4,2,1,7,Regulars
39349,385,8,774.6999999999999,2,2,1,5,Hibernating
39350,612,9,3698.1099999999997,1,2,5,8,Regulars
39351,143,16,2227.7400000000002,4,5,4,13,Champions
39352,1037,9,1751.66,1,2,4,7,Regulars
39353,0,11,2955.0399999999995,5,3,5,13,Loyal
39354,58,9,1262.24,5,2,3,10,Regulars
39355,20,15,1621.19,5,5,3,13,Loyal
39356,324,6,787.26,2,1,1,4,Hibernating
39357,35,10,1009.89,5,3,2,10,Loyal
39358,128,14,3184.39,4,5,5,14,Champions
39359,153,11,1684.89,3,3,3,9,Regulars
39360,274,16,2010.3,2,5,4,11,At Risk
39361,730,12,914.11,1,4,2,7,At Risk
39362,24,14,3543.8100000000004,5,5,5,15,Champions
39363,31,7,436.77,5,1,1,7,Regulars
39364,59,15,2180.3900000000003,5,5,4,14,Champions
39365,148,5,270.65999999999997,3,1,1,5,Regulars
39366,263,6,2213.95,2,1,4,7,Regulars
39367,225,13,1193.86,3,4,2,9,Regulars
39368,330,6,1099.31,2,1,2,5,Hibernating
39369,105,11,2766.63,4,3,5,12,Loyal
39370,134,10,1275.35,4,3,3,10,Loyal
39371,444,5,442.41999999999996,2,1,1,4,Hibernating
39372,663,9,3475.7000000000003,1,2,5,8,Regulars
39373,47,12,1204.3,5,4,2,11,Loyal
39374,922,8,750.73,1,2,1,4,Hibernating
39375,50,10,1069.71,5,3,2,10,Loyal
39376,189,22,8182.56,3,5,5,13,Big Spenders
39377,9,7,1069.47,5,1,2,8,Regulars
39378,125,13,1077.26,4,4,2,10,Loyal
39379,145,12,886.5699999999999,4,4,2,10,Loyal
39380,90,10,734.62,4,3,1,8,Loyal
39381,108,10,909.96,4,3,2,9,Loyal
39382,67,12,4959.69,4,4,5,13,Champions
39383,129,13,3229.0099999999998,4,4,5,13,Champions
39384,1019,6,1999.41,1,1,4,6,Regulars
39385,184,11,2021.29,3,3,4,10,Big Spenders
39386,6,8,965.74,5,2,2,9,Regulars
39387,78,6,1239.68,4,1,2,7,Regulars
39388,12,8,1426.4799999999998,5,2,3,10,Regulars
39389,179,11,2265.6400000000003,3,3,4,10,Big Spenders
39390,613,11,3400.0600000000004,1,3,5,9,Regulars
39391,310,14,1937.55,2,5,4,11,At Risk
39392,661,6,615.71,1,1,1,3,Hibernating
39393,287,9,3314.24,2,2,5,9,Regulars
39394,397,11,996.05,2,3,2,7,Regulars
39395,813,9,619.26,1,2,1,4,Hibernating
39396,302,11,2429.13,2,3,4,9,Regulars
39397,31,17,6914.65,5,5,5,15,Champions
39398,626,7,729.69,1,1,1,3,Hibernating
39399,351,11,1405.29,2,3,3,8,Regulars
39400,368,13,3666.9900000000002,2,4,5,11,At Risk
39401,408,6,2299.71,2,1,4,7,Regulars
39402,198,7,388.53999999999996,3,1,1,5,Regulars
39403,1553,7,1388.77,1,1,3,5,Regulars
39404,53,13,1675.8400000000001,5,4,3,12,Loyal
39405,445,13,1976.26,2,4,4,10,At Risk
39406,374,6,478.52000000000004,2,1,1,4,Hibernating
39407,77,18,3711.8399999999997,4,5,5,14,Champions
39408,181,18,3751.09,3,5,5,13,Big Spenders
39409,517,16,2466.7400000000002,1,5,4,10,At Risk
39410,138,18,1847.8999999999999,4,5,4,13,Champions
39411,86,14,1497.9699999999998,4,5,3,12,Loyal
39412,206,13,3679.15,3,4,5,12,Big Spenders
39413,15,5,1362.37,5,1,3,9,Regulars
39414,1329,6,1445.48,1,1,3,5,Regulars
39415,50,12,2033.53,5,4,4,13,Champions
39416,328,6,903.1500000000001,2,1,2,5,Hibernating
39417,665,7,449.27,1,1,1,3,Hibernating
39418,1082,9,1258.86,1,2,3,6,Regulars
39419,258,11,945.25,2,3,2,7,Regulars
39420,118,11,1883.18,4,3,4,11,Loyal
39421,338,13,1168.01,2,4,2,8,At Risk
39422,706,8,1652.92,1,2,3,6,Regulars
39423,196,7,1379.6999999999998,3,1,3,7,Regulars
39424,27,14,3435.17,5,5,5,15,Champions
39425,934,8,1920.64,1,2,4,7,Regulars
39426,332,12,1401.02,2,4,3,9,At Risk
39427,56,13,4211.29,5,4,5,14,Champions
39428,40,15,1695.99,5,5,3,13,Loyal
39429,47,7,491.45,5,1,1,7,Regulars
39430,941,5,265.65,1,1,1,3,Hibernating
39431,53,10,1079.99,5,3,2,10,Loyal
39432,30,10,3101.1000000000004,5,3,5,13,Loyal
39433,90,18,3211.33,4,5,5,14,Champions
39434,174,10,1717.6899999999998,3,3,3,9,Regulars
39435,334,7,696.06,2,1,1,4,Hibernating
39436,599,13,4690.16,1,4,5,10,At Risk
39437,70,7,1308.0200000000002,4,1,3,8,Regulars
39438,20,16,1850.88,5,5,4,14,Champions
39439,74,9,1360.81,4,2,3,9,Regulars
39440,696,10,1138.77,1,3,2,6,Regulars
39441,6,8,1308.47,5,2,3,10,Regulars
39442,859,9,2634.3,1,2,5,8,Regulars
39443,149,4,341.53,3,1,1,5,Regulars
39444,3,9,1293.69,5,2,3,10,Regulars
39445,54,13,2265.58,5,4,4,13,Champions
39446,18,10,1966.16,5,3,4,12,Loyal
39447,34,12,2468.57,5,4,4,13,Champions
39448,147,9,1418.1,4,2,3,9,Regulars
39449,646,8,1451.9900000000002,1,2,3,6,Regulars
39450,310,9,1537.76,2,2,3,7,Regulars
39451,39,12,2671.83,5,4,5,14,Champions
39452,1235,2,31.04,1,1,1,3,Hibernating
39453,172,12,1607.61,3,4,3,10,Regulars
39454,169,16,2672.2200000000003,3,5,5,13,Big Spenders
39455,181,16,1840.49,3,5,4,12,Big Spenders
39456,153,14,1957.25,3,5,4,12,Big Spenders
39457,190,9,1329.52,3,2,3,8,Regulars
39458,773,6,1185.48,1,1,2,4,Hibernating
39459,119,13,1129.75,4,4,2,10,Loyal
39460,17,11,1513.04,5,3,3,11,Loyal
39461,372,10,1599.36,2,3,3,8,Regulars
39462,215,11,1319.12,3,3,3,9,Regulars
39463,109,14,2553.7,4,5,4,13,Champions
39464,68,12,1685.18,4,4,3,11,Loyal
39465,144,12,1118.35,4,4,2,10,Loyal
39466,323,9,1260.5900000000001,2,2,3,7,Regulars
39467,475,14,1764.45,1,5,4,10,At Risk
39468,1020,11,1693.17,1,3,3,7,Regulars
39469,86,9,655.1,4,2,1,7,Regulars
39470,544,10,4153.09,1,3,5,9,Regulars
39471,328,6,1094.7,2,1,2,5,Hibernating
39472,416,9,999.33,2,2,2,6,Hibernating
39473,1,8,1897.67,5,2,4,11,Big Spenders
39474,690,11,1991.46,1,3,4,8,Regulars
39475,9,16,2499.64,5,5,4,14,Champions
39476,198,7,555.94,3,1,1,5,Regulars
39477,175,9,777.71,3,2,1,6,Regulars
39478,291,11,1244.22,2,3,3,8,Regulars
39479,441,9,1845.04,2,2,4,8,Regulars
39480,19,8,666.44,5,2,1,8,Regulars
39481,278,4,1339.58,2,1,3,6,Regulars
39482,1161,5,1884.9400000000003,1,1,4,6,Regulars
39483,306,13,3503.44,2,4,5,11,At Risk
39484,529,6,1334.83,1,1,3,5,Regulars
39485,266,10,1835.65,2,3,4,9,Regulars
39486,252,10,1050.69,2,3,2,7,Regulars
39487,22,18,3684.19,5,5,5,15,Champions
39488,173,15,1344.8899999999999,3,5,3,11,Regulars
39489,333,11,982.27,2,3,2,7,Regulars
39490,34,4,77.98,5,1,1,7,Regulars
39491,808,7,1433.3899999999999,1,1,3,5,Regulars
39492,42,8,1066.12,5,2,2,9,Regulars
39493,871,3,204.71,1,1,1,3,Hibernating
39494,392,8,1872.6599999999999,2,2,4,8,Regulars
39495,119,13,2949.8900000000003,4,4,5,13,Champions
39496,96,10,1860.82,4,3,4,11,Loyal
39497,117,12,3662.16,4,4,5,13,Champions
39498,312,7,959.99,2,1,2,5,Hibernating
39499,218,11,1153.53,3,3,2,8,Regulars
39500,174,9,926.88,3,2,2,7,Regulars
39501,10,15,3155.5,5,5,5,15,Champions
39502,274,15,1515.77,2,5,3,10,At Risk
39503,28,12,2026.6,5,4,4,13,Champions
39504,328,8,2285.4,2,2,4,8,Regulars
39505,90,13,3581.1400000000003,4,4,5,13,Champions
39506,879,4,360.0,1,1,1,3,Hibernating
39507,217,13,1350.58,3,4,3,10,Regulars
39508,82,13,1557.75,4,4,3,11,Loyal
39509,27,12,2667.75,5,4,5,14,Champions
39510,337,9,2950.85,2,2,5,9,Regulars
39511,125,12,1531.22,4,4,3,11,Loyal
39512,220,12,5668.33,3,4,5,12,Big Spenders
39513,456,9,1254.4,2,2,3,7,Regulars
39514,497,4,290.3,1,1,1,3,Hibernating
39515,83,6,434.77,4,1,1,6,Regulars
39516,159,8,1390.78,3,2,3,8,Regulars
39517,436,14,1641.5500000000002,2,5,3,10,At Risk
39518,353,16,2948.95,2,5,5,12,At Risk
39519,302,9,3218.58,2,2,5,9,Regulars
39520,158,12,1523.67,3,4,3,10,Regulars
39521,530,7,1091.25,1,1,2,4,Hibernating
39522,237,8,846.81,3,2,2,7,Regulars
39523,302,11,1100.37,2,3,2,7,Regulars
39524,99,6,847.51,4,1,2,7,Regulars
39525,469,8,911.9,1,2,2,5,Hibernating
39526,469,9,2702.24,1,2,5,8,Regulars
39527,892,7,782.91,1,1,1,3,Hibernating
39528,629,8,1290.91,1,2,3,6,Regulars
39529,210,15,1931.1499999999999,3,5,4,12,Big Spenders
39530,97,16,1716.87,4,5,3,12,Loyal
39531,740,10,1091.4099999999999,1,3,2,6,Regulars
39532,50,10,898.22,5,3,2,10,Loyal
39533,644,11,1272.39,1,3,3,7,Regulars
39534,25,16,2934.3,5,5,5,15,Champions
39535,33,7,1064.9,5,1,2,8,Regulars
39536,89,11,3998.28,4,3,5,12,Loyal
39537,167,4,439.16999999999996,3,1,1,5,Regulars
39538,660,11,3937.2200000000003,1,3,5,9,Regulars
39539,165,10,1059.71,3,3,2,8,Regulars
39540,726,6,638.4,1,1,1,3,Hibernating
39541,624,8,966.59,1,2,2,5,Hibernating
39542,82,10,1064.5900000000001,4,3,2,9,Loyal
39543,847,9,1853.84,1,2,4,7,Regulars
39544,1217,7,975.1199999999999,1,1,2,4,Hibernating
39545,244,12,3174.52,3,4,5,12,Big Spenders
39546,0,11,1426.68,5,3,3,11,Loyal
39547,287,6,752.9499999999999,2,1,1,4,Hibernating
39548,255,12,1958.98,2,4,4,10,At Risk
39549,382,12,3123.03,2,4,5,11,At Risk
39550,83,12,1358.93,4,4,3,11,Loyal
39551,402,9,993.16,2,2,2,6,Hibernating
39552,172,10,839.12,3,3,1,7,Regulars
39553,803,6,999.57,1,1,2,4,Hibernating
39554,420,10,2922.1000000000004,2,3,5,10,Regulars
39555,1012,8,1513.56,1,2,3,6,Regulars
39556,1459,6,3486.36,1,1,5,7,Regulars
39557,19,17,2823.13,5,5,5,15,Champions
39558,319,10,718.5,2,3,1,6,Regulars
39559,167,12,742.54,3,4,1,8,Regulars
39560,29,9,2281.51,5,2,4,11,Big Spenders
39561,963,8,923.01,1,2,2,5,Hibernating
39562,355,12,1848.57,2,4,4,10,At Risk
39563,292,11,1350.71,2,3,3,8,Regulars
39564,839,8,1506.3799999999999,1,2,3,6,Regulars
39565,552,12,2573.9100000000003,1,4,5,10,At Risk
39566,120,10,3425.3300000000004,4,3,5,12,Loyal
39567,917,12,2478.28,1,4,4,9,At Risk
39568,346,10,956.8199999999999,2,3,2,7,Regulars
39569,429,8,1483.95,2,2,3,7,Regulars
39570,19,14,1107.71,5,5,2,12,Loyal
39571,68,11,2057.83,4,3,4,11,Loyal
39572,2,15,1843.3600000000001,5,5,4,14,Champions
39573,46,16,2211.4900000000002,5,5,4,14,Champions
39574,121,12,908.62,4,4,2,10,Loyal
39575,280,13,3141.45,2,4,5,11,At Risk
39576,597,6,469.09999999999997,1,1,1,3,Hibernating
39577,244,8,478.33000000000004,3,2,1,6,Regulars
39578,261,13,3044.85,2,4,5,11,At Risk
39579,29,8,3579.7799999999997,5,2,5,12,Big Spenders
39580,530,8,1365.27,1,2,3,6,Regulars
39581,414,5,454.19,2,1,1,4,Hibernating
39582,103,8,662.0699999999999,4,2,1,7,Regulars
39583,184,9,1520.27,3,2,3,8,Regulars
39584,156,8,1066.2,3,2,2,7,Regulars
39585,284,12,1742.22,2,4,4,10,At Risk
39586,26,13,2461.7599999999998,5,4,4,13,Champions
39587,758,5,417.87,1,1,1,3,Hibernating
39588,649,7,1184.1200000000001,1,1,2,4,Hibernating
39589,21,12,1542.1599999999999,5,4,3,12,Loyal
39590,111,11,2253.2000000000003,4,3,4,11,Loyal
39591,46,11,1348.68,5,3,3,11,Loyal
39592,229,12,5467.08,3,4,5,12,Big Spenders
39593,408,6,1527.72,2,1,3,6,Regulars
39594,266,9,1572.27,2,2,3,7,Regulars
39595,93,8,1266.0700000000002,4,2,3,9,Regulars
39596,94,12,1255.1100000000001,4,4,3,11,Loyal
39597,56,11,1467.79,5,3,3,11,Loyal
39598,119,12,2390.65,4,4,4,12,Champions
39599,167,9,1329.8600000000001,3,2,3,8,Regulars
39600,339,10,1084.25,2,3,2,7,Regulars
39601,6,11,1775.3400000000001,5,3,4,12,Loyal
39602,155,9,3176.1099999999997,3,2,5,10,Big Spenders
39603,1137,3,202.75,1,1,1,3,Hibernating
39604,127,14,2575.34,4,5,5,14,Champions
39605,65,11,2950.64,5,3,5,13,Loyal
39606,231,9,1444.2,3,2,3,8,Regulars
39607,1069,9,2080.26,1,2,4,7,Regulars
39608,168,10,1019.35,3,3,2,8,Regulars
39609,57,9,2135.4300000000003,5,2,4,11,Big Spenders
39610,63,18,2155.3199999999997,5,5,4,14,Champions
39611,136,12,1365.21,4,4,3,11,Loyal
39612,62,10,2245.44,5,3,4,12,Loyal
39613,331,5,849.38,2,1,2,5,Hibernating
39614,10,11,2704.56,5,3,5,13,Loyal
39615,37,14,2165.9700000000003,5,5,4,14,Champions
39616,270,13,2229.31,2,4,4,10,At Risk
39617,72,10,2245.31,4,3,4,11,Loyal
39618,128,14,3331.9700000000003,4,5,5,14,Champions
39619,110,10,1381.66,4,3,3,10,Loyal
39620,166,13,3875.0999999999995,3,4,5,12,Big Spenders
39621,323,12,2610.3700000000003,2,4,5,11,At Risk
39622,5,11,1532.09,5,3,3,11,Loyal
39623,457,14,1677.9,2,5,3,10,At Risk
39624,913,8,1972.5900000000001,1,2,4,7,Regulars
39625,48,9,1306.73,5,2,3,10,Regulars
39626,593,15,6750.96,1,5,5,11,At Risk
39627,85,10,4866.99,4,3,5,12,Loyal
39628,21,13,4398.72,5,4,5,14,Champions
39629,378,17,3614.4300000000003,2,5,5,12,At Risk
39630,249,11,2516.86,2,3,4,9,Regulars
39631,370,10,3240.2,2,3,5,10,Regulars
39632,122,7,435.09,4,1,1,6,Regulars
39633,402,11,1543.37,2,3,3,8,Regulars
39634,490,4,632.8299999999999,1,1,1,3,Hibernating
39635,18,15,1993.61,5,5,4,14,Champions
39636,223,8,987.2099999999999,3,2,2,7,Regulars
39637,14,11,1904.9099999999999,5,3,4,12,Loyal
39638,98,11,5576.009999999999,4,3,5,12,Loyal
39639,99,14,1824.64,4,5,4,13,Champions
39640,130,9,2080.92,4,2,4,10,Big Spenders
39641,632,8,563.01,1,2,1,4,Hibernating
39642,165,18,1856.3700000000001,3,5,4,12,Big Spenders
39643,12,8,968.24,5,2,2,9,Regulars
39644,8,13,841.69,5,4,1,10,Loyal
39645,551,5,218.94,1,1,1,3,Hibernating
39646,598,9,1124.7,1,2,2,5,Hibernating
39647,403,11,1235.52,2,3,2,7,Regulars
39648,172,7,1046.8600000000001,3,1,2,6,Regulars
39649,121,6,328.09000000000003,4,1,1,6,Regulars
39650,224,13,2828.02,3,4,5,12,Big Spenders
39651,404,12,950.9599999999999,2,4,2,8,At Risk
39652,428,6,450.68000000000006,2,1,1,4,Hibernating
39653,150,8,890.5600000000001,3,2,2,7,Regulars
39654,808,2,942.04,1,1,2,4,Hibernating
39655,60,10,975.11,5,3,2,10,Loyal
39656,5,11,1212.6,5,3,2,10,Loyal
39657,757,7,2715.54,1,1,5,7,Regulars
39658,346,15,2550.67,2,5,4,11,At Risk
39659,424,10,3050.3900000000003,2,3,5,10,Regulars
39660,331,13,977.98,2,4,2,8,At Risk
39661,496,10,1963.74,1,3,4,8,Regulars
39662,135,9,1528.84,4,2,3,9,Regulars
39663,125,16,4642.0,4,5,5,14,Champions
39664,107,12,3143.81,4,4,5,13,Champions
39665,259,6,860.8399999999999,2,1,2,5,Hibernating
39666,128,14,2683.7,4,5,5,14,Champions
39667,571,10,1094.73,1,3,2,6,Regulars
39668,508,9,2485.9300000000003,1,2,4,7,Regulars
39669,1170,6,1710.3000000000002,1,1,3,5,Regulars
39670,337,9,1130.82,2,2,2,6,Hibernating
39671,90,7,1084.31,4,1,2,7,Regulars
39672,7,11,1566.94,5,3,3,11,Loyal
39673,9,12,1738.79,5,4,4,13,Champions
39674,97,11,2474.85,4,3,4,11,Loyal
39675,2083,3,308.14,1,1,1,3,Hibernating
39676,18,6,669.6600000000001,5,1,1,7,Regulars
39677,734,5,368.78,1,1,1,3,Hibernating
39678,163,6,1346.53,3,1,3,7,Regulars
39679,86,10,600.39,4,3,1,8,Loyal
39680,211,7,317.11,3,1,1,5,Regulars
39681,187,9,1204.07,3,2,2,7,Regulars
39682,66,9,496.04,4,2,1,7,Regulars
39683,756,11,833.56,1,3,1,5,Regulars
39684,197,14,1773.7,3,5,4,12,Big Spenders
39685,712,5,475.84,1,1,1,3,Hibernating
39686,181,6,709.21,3,1,1,5,Regulars
39687,204,7,1119.52,3,1,2,6,Regulars
39688,305,15,6227.14,2,5,5,12,At Risk
39689,122,14,4683.79,4,5,5,14,Champions
39690,599,5,592.6800000000001,1,1,1,3,Hibernating
39691,5,11,1795.97,5,3,4,12,Loyal
39692,150,8,401.09,3,2,1,6,Regulars
39693,27,6,294.52,5,1,1,7,Regulars
39694,37,12,1663.24,5,4,3,12,Loyal
39695,259,8,2572.57,2,2,4,8,Regulars
39696,563,8,2091.9,1,2,4,7,Regulars
39697,419,10,1084.66,2,3,2,7,Regulars
39698,95,8,1501.0,4,2,3,9,Regulars
39699,514,6,519.8,1,1,1,3,Hibernating
39700,352,8,1838.21,2,2,4,8,Regulars
39701,68,7,1963.56,4,1,4,9,Big Spenders
39702,760,8,719.9499999999999,1,2,1,4,Hibernating
39703,176,12,2593.43,3,4,5,12,Big Spenders
39704,210,14,3429.72,3,5,5,13,Big Spenders
39705,42,6,403.84,5,1,1,7,Regulars
39706,1,11,1428.8700000000001,5,3,3,11,Loyal
39707,256,6,2411.75,2,1,4,7,Regulars
39708,85,11,801.16,4,3,1,8,Loyal
39709,564,7,2665.26,1,1,5,7,Regulars
39710,202,13,3021.38,3,4,5,12,Big Spenders
39711,203,12,2685.42,3,4,5,12,Big Spenders
39712,159,5,543.04,3,1,1,5,Regulars
39713,378,10,6043.22,2,3,5,10,Regulars
39714,6,21,4074.7,5,5,5,15,Champions
39715,282,13,3024.65,2,4,5,11,At Risk
39716,462,9,850.01,1,2,2,5,Hibernating
39717,49,11,2262.29,5,3,4,12,Loyal
39718,159,10,1816.6399999999999,3,3,4,10,Big Spenders
39719,63,11,2200.13,5,3,4,12,Loyal
39720,26,8,1416.3899999999999,5,2,3,10,Regulars
39721,175,7,1070.8200000000002,3,1,2,6,Regulars
39722,306,4,911.8499999999999,2,1,2,5,Hibernating
39723,142,17,3334.36,4,5,5,14,Champions
39724,92,7,662.38,4,1,1,6,Regulars
39725,160,13,1928.99,3,4,4,11,Big Spenders
39726,554,8,964.9,1,2,2,5,Hibernating
39727,561,8,2827.85,1,2,5,8,Regulars
39728,38,7,3623.96,5,1,5,11,Big Spenders
39729,179,13,2613.0600000000004,3,4,5,12,Big Spenders
39730,91,8,1176.06,4,2,2,8,Regulars
39731,387,14,1612.74,2,5,3,10,At Risk
39732,437,11,991.3499999999999,2,3,2,7,Regulars
39733,447,11,1492.3,2,3,3,8,Regulars
39734,223,11,2452.91,3,3,4,10,Big Spenders
39735,204,10,1556.31,3,3,3,9,Regulars
39736,525,7,1840.9,1,1,4,6,Regulars
39737,451,13,2196.0,2,4,4,10,At Risk
39738,40,10,1429.25,5,3,3,11,Loyal
39739,65,16,1608.89,5,5,3,13,Loyal
39740,20,10,868.05,5,3,2,10,Loyal
39741,546,7,1239.63,1,1,2,4,Hibernating
39742,305,18,2861.11,2,5,5,12,At Risk
39743,1171,4,294.09000000000003,1,1,1,3,Hibernating
39744,80,12,2838.59,4,4,5,13,Champions
39745,346,6,949.6,2,1,2,5,Hibernating
39746,267,12,724.35,2,4,1,7,At Risk
39747,429,13,2761.2400000000002,2,4,5,11,At Risk
39748,183,13,2109.3999999999996,3,4,4,11,Big Spenders
39749,152,13,1866.3500000000001,3,4,4,11,Big Spenders
39750,69,8,1000.34,4,2,2,8,Regulars
39751,383,11,1531.15,2,3,3,8,Regulars
39752,289,10,1186.7,2,3,2,7,Regulars
39753,78,22,2248.5,4,5,4,13,Champions
39754,141,10,842.56,4,3,1,8,Loyal
39755,238,12,1824.58,3,4,4,11,Big Spenders
39756,623,12,3599.76,1,4,5,10,At Risk
39757,180,9,955.51,3,2,2,7,Regulars
39758,98,11,1294.52,4,3,3,10,Loyal
39759,28,10,2978.32,5,3,5,13,Loyal
39760,59,11,1915.69,5,3,4,12,Loyal
39761,309,10,3504.3799999999997,2,3,5,10,Regulars
39762,139,16,3361.59,4,5,5,14,Champions
39763,35,7,539.24,5,1,1,7,Regulars
39764,30,10,816.08,5,3,1,9,Loyal
39765,995,7,1270.1,1,1,3,5,Regulars
39766,580,7,1662.7300000000002,1,1,3,5,Regulars
39767,602,5,554.52,1,1,1,3,Hibernating
39768,144,10,2045.6100000000001,4,3,4,11,Loyal
39769,573,5,1153.8899999999999,1,1,2,4,Hibernating
39770,43,9,1728.7,5,2,4,11,Big Spenders
39771,548,5,1203.92,1,1,2,4,Hibernating
39772,165,6,1168.23,3,1,2,6,Regulars
39773,185,7,498.94,3,1,1,5,Regulars
39774,38,11,1623.54,5,3,3,11,Loyal
39775,814,6,1774.52,1,1,4,6,Regulars
39776,88,9,1075.55,4,2,2,8,Regulars
39777,211,13,3711.7200000000003,3,4,5,12,Big Spenders
39778,151,15,2915.78,3,5,5,13,Big Spenders
39779,60,12,1115.15,5,4,2,11,Loyal
39780,23,10,3795.95,5,3,5,13,Loyal
39781,1029,13,3689.19,1,4,5,10,At Risk
39782,530,7,821.67,1,1,1,3,Hibernating
39783,498,11,2648.21,1,3,5,9,Regulars
39784,133,11,1915.93,4,3,4,11,Loyal
39785,757,12,2566.04,1,4,4,9,At Risk
39786,17,14,1737.3200000000002,5,5,4,14,Champions
39787,85,6,963.5699999999999,4,1,2,7,Regulars
39788,1321,5,1136.96,1,1,2,4,Hibernating
39789,790,8,3487.21,1,2,5,8,Regulars
39790,201,14,2992.19,3,5,5,13,Big Spenders
39791,463,9,861.27,1,2,2,5,Hibernating
39792,392,17,2392.87,2,5,4,11,At Risk
39793,141,11,2648.71,4,3,5,12,Loyal
39794,173,11,2565.37,3,3,4,10,Big Spenders
39795,385,11,1333.6100000000001,2,3,3,8,Regulars
39796,13,15,4820.56,5,5,5,15,Champions
39797,50,11,978.95,5,3,2,10,Loyal
39798,17,8,1411.17,5,2,3,10,Regulars
39799,159,9,661.89,3,2,1,6,Regulars
39800,3,12,681.41,5,4,1,10,Loyal
39801,50,6,892.89,5,1,2,8,Regulars
39802,453,13,1644.89,2,4,3,9,At Risk
39803,31,6,547.88,5,1,1,7,Regulars
39804,92,7,545.21,4,1,1,6,Regulars
39805,67,9,1388.58,4,2,3,9,Regulars
39806,479,12,2232.81,1,4,4,9,At Risk
39807,118,11,1225.7,4,3,2,9,Loyal
39808,122,8,938.6,4,2,2,8,Regulars
39809,136,8,1611.48,4,2,3,9,Regulars
39810,59,16,3738.16,5,5,5,15,Champions
39811,600,8,1363.75,1,2,3,6,Regulars
39812,349,10,2651.28,2,3,5,10,Regulars
39813,161,8,1739.1,3,2,4,9,Big Spenders
39814,442,8,885.98,2,2,2,6,Hibernating
39815,338,11,1718.0,2,3,3,8,Regulars
39816,332,11,1316.3,2,3,3,8,Regulars
39817,83,13,1108.18,4,4,2,10,Loyal
39818,120,13,1642.04,4,4,3,11,Loyal
39819,1018,9,1039.05,1,2,2,5,Hibernating
39820,74,9,1486.85,4,2,3,9,Regulars
39821,862,9,1204.6499999999999,1,2,2,5,Hibernating
39822,307,8,1203.81,2,2,2,6,Hibernating
39823,182,13,1369.81,3,4,3,10,Regulars
39824,80,8,1067.55,4,2,2,8,Regulars
39825,363,6,1578.2,2,1,3,6,Regulars
39826,256,14,4424.549999999999,2,5,5,12,At Risk
39827,132,12,1589.64,4,4,3,11,Loyal
39828,308,19,4233.87,2,5,5,12,At Risk
39829,327,10,3504.77,2,3,5,10,Regulars
39830,296,10,1434.83,2,3,3,8,Regulars
39831,160,10,3251.14,3,3,5,11,Big Spenders
39832,271,12,1516.0,2,4,3,9,At Risk
39833,54,8,3114.38,5,2,5,12,Big Spenders
39834,546,10,3042.0899999999997,1,3,5,9,Regulars
39835,89,16,1994.83,4,5,4,13,Champions
39836,315,16,1401.79,2,5,3,10,At Risk
39837,124,12,1213.51,4,4,2,10,Loyal
39838,496,6,292.76,1,1,1,3,Hibernating
39839,573,5,1043.23,1,1,2,4,Hibernating
39840,86,16,3858.5400000000004,4,5,5,14,Champions
39841,693,5,2188.19,1,1,4,6,Regulars
39842,778,11,1487.04,1,3,3,7,Regulars
39843,71,12,2773.11,4,4,5,13,Champions
39844,8,7,759.29,5,1,1,7,Regulars
39845,628,8,803.23,1,2,1,4,Hibernating
39846,103,11,2951.6299999999997,4,3,5,12,Loyal
39847,759,11,687.28,1,3,1,5,Regulars
39848,113,11,1099.83,4,3,2,9,Loyal
39849,612,6,1311.07,1,1,3,5,Regulars
39850,87,12,2277.77,4,4,4,12,Champions
39851,42,8,2354.99,5,2,4,11,Big Spenders
39852,313,10,1168.69,2,3,2,7,Regulars
39853,249,12,2712.54,2,4,5,11,At Risk
39854,200,12,3312.49,3,4,5,12,Big Spenders
39855,107,9,675.6,4,2,1,7,Regulars
39856,12,15,3015.64,5,5,5,15,Champions
39857,209,12,1739.9,3,4,4,11,Big Spenders
39858,438,9,1681.63,2,2,3,7,Regulars
39859,212,16,2774.15,3,5,5,13,Big Spenders
39860,436,11,2766.54,2,3,5,10,Regulars
39861,517,12,1397.29,1,4,3,8,At Risk
39862,204,10,1481.87,3,3,3,9,Regulars
39863,45,8,1168.1299999999999,5,2,2,9,Regulars
39864,593,12,3711.63,1,4,5,10,At Risk
39865,224,15,2616.27,3,5,5,13,Big Spenders
39866,396,8,3029.17,2,2,5,9,Regulars
39867,108,7,712.78,4,1,1,6,Regulars
39868,176,9,3850.54,3,2,5,10,Big Spenders
39869,289,11,1922.5900000000001,2,3,4,9,Regulars
39870,85,10,719.61,4,3,1,8,Loyal
39871,1229,5,538.75,1,1,1,3,Hibernating
39872,1124,4,789.4699999999999,1,1,1,3,Hibernating
39873,28,7,1013.93,5,1,2,8,Regulars
39874,117,13,1970.9099999999999,4,4,4,12,Champions
39875,67,18,2581.3599999999997,4,5,5,14,Champions
39876,554,12,1474.3700000000001,1,4,3,8,At Risk
39877,151,9,2090.5099999999998,3,2,4,9,Big Spenders
39878,373,10,1618.07,2,3,3,8,Regulars
39879,188,11,1007.08,3,3,2,8,Regulars
39880,348,9,2068.48,2,2,4,8,Regulars
39881,133,12,1222.93,4,4,2,10,Loyal
39882,324,12,1925.58,2,4,4,10,At Risk
39883,402,16,1635.81,2,5,3,10,At Risk
39884,17,6,517.21,5,1,1,7,Regulars
39885,28,6,803.03,5,1,1,7,Regulars
39886,428,11,964.71,2,3,2,7,Regulars
39887,376,11,1003.3299999999999,2,3,2,7,Regulars
39888,113,10,798.0,4,3,1,8,Loyal
39889,14,18,4147.37,5,5,5,15,Champions
39890,297,6,927.33,2,1,2,5,Hibernating
39891,21,7,1144.04,5,1,2,8,Regulars
39892,212,8,3145.04,3,2,5,10,Big Spenders
39893,490,10,1336.24,1,3,3,7,Regulars
39894,165,11,2726.4900000000002,3,3,5,11,Big Spenders
39895,17,10,2003.8700000000001,5,3,4,12,Loyal
39896,294,13,1244.28,2,4,3,9,At Risk
39897,497,9,2774.02,1,2,5,8,Regulars
39898,308,10,1553.88,2,3,3,8,Regulars
39899,285,13,4807.79,2,4,5,11,At Risk
39900,793,6,351.47,1,1,1,3,Hibernating
39901,75,12,2354.16,4,4,4,12,Champions
39902,534,12,1245.19,1,4,3,8,At Risk
39903,192,11,5574.68,3,3,5,11,Big Spenders
39904,76,14,2256.27,4,5,4,13,Champions
39905,21,8,821.3199999999999,5,2,1,8,Regulars
39906,607,6,669.8199999999999,1,1,1,3,Hibernating
39907,524,11,1791.57,1,3,4,8,Regulars
39908,210,13,1806.81,3,4,4,11,Big Spenders
39909,775,9,596.0500000000001,1,2,1,4,Hibernating
39910,357,8,708.1,2,2,1,5,Hibernating
39911,330,12,1269.31,2,4,3,9,At Risk
39912,100,9,3211.73,4,2,5,11,Big Spenders
39913,239,9,683.36,3,2,1,6,Regulars
39914,211,9,1077.59,3,2,2,7,Regulars
39915,145,11,3746.17,4,3,5,12,Loyal
39916,208,6,395.79,3,1,1,5,Regulars
39917,305,8,2621.9900000000002,2,2,5,9,Regulars
39918,308,11,1510.4199999999998,2,3,3,8,Regulars
39919,239,18,6434.96,3,5,5,13,Big Spenders
39920,172,7,2878.55,3,1,5,9,Big Spenders
39921,135,8,1232.5,4,2,2,8,Regulars
39922,554,7,539.6,1,1,1,3,Hibernating
39923,168,9,2095.4700000000003,3,2,4,9,Big Spenders
39924,39,10,1707.5,5,3,3,11,Loyal
39925,129,10,2555.07,4,3,4,11,Loyal
39926,221,5,564.04,3,1,1,5,Regulars
39927,99,12,3893.7000000000003,4,4,5,13,Champions
39928,0,8,2832.1800000000003,5,2,5,12,Big Spenders
39929,94,13,2891.81,4,4,5,13,Champions
39930,286,11,1506.98,2,3,3,8,Regulars
39931,356,5,1129.09,2,1,2,5,Hibernating
39932,823,6,799.6700000000001,1,1,1,3,Hibernating
39933,122,14,1561.95,4,5,3,12,Loyal
39934,281,7,586.33,2,1,1,4,Hibernating
39935,592,11,2009.2399999999998,1,3,4,8,Regulars
39936,202,9,1108.63,3,2,2,7,Regulars
39937,12,8,1203.6000000000001,5,2,2,9,Regulars
39938,232,6,549.22,3,1,1,5,Regulars
39939,147,14,4440.25,4,5,5,14,Champions
39940,55,11,1022.76,5,3,2,10,Loyal
39941,959,8,1194.0800000000002,1,2,2,5,Hibernating
39942,38,8,531.48,5,2,1,8,Regulars
39943,788,3,132.08999999999997,1,1,1,3,Hibernating
39944,511,12,1809.3899999999999,1,4,4,9,At Risk
39945,258,9,801.46,2,2,1,5,Hibernating
39946,259,12,2324.62,2,4,4,10,At Risk
39947,140,10,2109.36,4,3,4,11,Loyal
39948,13,10,1093.02,5,3,2,10,Loyal
39949,7,16,3621.5,5,5,5,15,Champions
39950,172,9,629.88,3,2,1,6,Regulars
39951,572,7,1530.0300000000002,1,1,3,5,Regulars
39952,12,12,1212.6999999999998,5,4,2,11,Loyal
39953,192,11,2540.94,3,3,4,10,Big Spenders
39954,477,12,1304.6299999999999,1,4,3,8,At Risk
39955,99,5,938.3100000000001,4,1,2,7,Regulars
39956,195,11,1266.07,3,3,3,9,Regulars
39957,191,13,1735.1200000000001,3,4,4,11,Big Spenders
39958,35,14,1567.29,5,5,3,13,Loyal
39959,42,8,1262.3000000000002,5,2,3,10,Regulars
39960,15,10,1681.4500000000003,5,3,3,11,Loyal
39961,383,9,1185.4,2,2,2,6,Hibernating
39962,203,11,2542.92,3,3,4,10,Big Spenders
39963,367,12,1645.52,2,4,3,9,At Risk
39964,98,10,1356.04,4,3,3,10,Loyal
39965,231,13,3583.31,3,4,5,12,Big Spenders
39966,77,5,1245.9499999999998,4,1,3,8,Regulars
39967,300,6,1679.16,2,1,3,6,Regulars
39968,69,9,5173.87,4,2,5,11,Big Spenders
39969,395,9,1369.26,2,2,3,7,Regulars
39970,246,12,1066.2,3,4,2,9,Regulars
39971,140,9,979.39,4,2,2,8,Regulars
39972,252,10,1612.98,2,3,3,8,Regulars
39973,6,13,1549.1,5,4,3,12,Loyal
39974,350,11,1965.21,2,3,4,9,Regulars
39975,56,10,2300.79,5,3,4,12,Loyal
39976,160,8,479.32000000000005,3,2,1,6,Regulars
39977,170,9,1168.53,3,2,2,7,Regulars
39978,56,13,2521.13,5,4,4,13,Champions
39979,435,8,852.49,2,2,2,6,Hibernating
39980,607,9,1512.69,1,2,3,6,Regulars
39981,238,11,1272.3,3,3,3,9,Regulars
39982,177,12,2042.95,3,4,4,11,Big Spenders
39983,178,15,1307.18,3,5,3,11,Regulars
39984,893,5,1649.2699999999998,1,1,3,5,Regulars
39985,1173,11,2757.4500000000003,1,3,5,9,Regulars
39986,117,7,808.74,4,1,1,6,Regulars
39987,87,14,1697.38,4,5,3,12,Loyal
39988,47,7,760.1,5,1,1,7,Regulars
39989,1,8,1001.45,5,2,2,9,Regulars
39990,830,12,3831.71,1,4,5,10,At Risk
39991,184,10,4151.43,3,3,5,11,Big Spenders
39992,806,5,373.12,1,1,1,3,Hibernating
39993,33,14,1253.34,5,5,3,13,Loyal
39994,1292,5,2654.82,1,1,5,7,Regulars
39995,146,4,901.9,4,1,2,7,Regulars
39996,500,9,1076.47,1,2,2,5,Hibernating
39997,151,8,832.47,3,2,1,6,Regulars
39998,24,8,1117.02,5,2,2,9,Regulars
39999,531,10,1514.8999999999999,1,3,3,7,Regulars
40000,271,11,3066.6000000000004,2,3,5,10,Regulars
40001,1059,10,803.9200000000001,1,3,1,5,Regulars
40002,47,15,2424.53,5,5,4,14,Champions
40003,622,7,2610.76,1,1,5,7,Regulars
40004,161,7,948.82,3,1,2,6,Regulars
40005,335,9,920.8,2,2,2,6,Hibernating
40006,411,15,1650.71,2,5,3,10,At Risk
40007,26,9,681.19,5,2,1,8,Regulars
40008,0,14,3479.21,5,5,5,15,Champions
40009,884,7,463.4,1,1,1,3,Hibernating
40010,718,12,2529.21,1,4,4,9,At Risk
40011,122,7,1302.36,4,1,3,8,Regulars
40012,56,15,2566.86,5,5,4,14,Champions
40013,267,11,1245.1200000000001,2,3,3,8,Regulars
40014,148,9,382.94,3,2,1,6,Regulars
40015,164,11,2998.6,3,3,5,11,Big Spenders
40016,20,13,1817.69,5,4,4,13,Champions
40017,227,11,699.2099999999999,3,3,1,7,Regulars
40018,90,8,1524.6299999999999,4,2,3,9,Regulars
40019,147,18,1827.69,4,5,4,13,Champions
40020,13,13,1720.08,5,4,3,12,Loyal
40021,92,10,4767.32,4,3,5,12,Loyal
40022,278,8,947.46,2,2,2,6,Hibernating
40023,623,9,735.27,1,2,1,4,Hibernating
40024,171,12,1527.01,3,4,3,10,Regulars
40025,380,11,1247.04,2,3,3,8,Regulars
40026,589,12,2991.3900000000003,1,4,5,10,At Risk
40027,26,14,5626.96,5,5,5,15,Champions
40028,303,11,2211.05,2,3,4,9,Regulars
40029,258,10,3817.9500000000003,2,3,5,10,Regulars
40030,90,8,730.7099999999999,4,2,1,7,Regulars
40031,57,13,2423.3399999999997,5,4,4,13,Champions
40032,670,13,4950.87,1,4,5,10,At Risk
40033,548,11,1319.6100000000001,1,3,3,7,Regulars
40034,140,13,1979.5900000000001,4,4,4,12,Champions
40035,49,12,1895.46,5,4,4,13,Champions
40036,93,13,897.36,4,4,2,10,Loyal
40037,438,7,619.73,2,1,1,4,Hibernating
40038,1256,6,784.93,1,1,1,3,Hibernating
40039,211,12,1412.92,3,4,3,10,Regulars
40040,601,8,593.31,1,2,1,4,Hibernating
40041,91,12,2833.8900000000003,4,4,5,13,Champions
40042,47,8,1183.62,5,2,2,9,Regulars
40043,39,17,1771.05,5,5,4,14,Champions
40044,45,11,1431.1799999999998,5,3,3,11,Loyal
40045,772,4,511.61999999999995,1,1,1,3,Hibernating
40046,65,13,2112.96,5,4,4,13,Champions
40047,398,11,2191.25,2,3,4,9,Regulars
40048,39,8,826.1899999999999,5,2,1,8,Regulars
40049,130,17,3232.38,4,5,5,14,Champions
40050,128,8,1200.96,4,2,2,8,Regulars
40051,2,10,3117.8999999999996,5,3,5,13,Loyal
40052,65,17,1835.22,5,5,4,14,Champions
40053,558,10,848.3199999999999,1,3,2,6,Regulars
40054,100,7,478.46,4,1,1,6,Regulars
40055,6,19,1837.92,5,5,4,14,Champions
40056,99,6,3257.24,4,1,5,10,Big Spenders
40057,102,11,750.97,4,3,1,8,Loyal
40058,26,10,1562.0600000000002,5,3,3,11,Loyal
40059,45,14,4946.860000000001,5,5,5,15,Champions
40060,110,12,1756.91,4,4,4,12,Champions
40061,903,8,790.11,1,2,1,4,Hibernating
40062,278,9,916.0400000000001,2,2,2,6,Hibernating
40063,394,13,2056.46,2,4,4,10,At Risk
40064,333,14,3449.6600000000003,2,5,5,12,At Risk
40065,221,11,1718.11,3,3,3,9,Regulars
40066,468,5,1441.35,1,1,3,5,Regulars
40067,72,8,572.54,4,2,1,7,Regulars
40068,6,12,841.1,5,4,1,10,Loyal
40069,69,15,1695.2800000000002,4,5,3,12,Loyal
40070,32,11,1304.53,5,3,3,11,Loyal
40071,406,9,1680.8300000000002,2,2,3,7,Regulars
40072,218,5,246.70999999999998,3,1,1,5,Regulars
40073,251,10,2874.8399999999997,2,3,5,10,Regulars
40074,122,12,1177.97,4,4,2,10,Loyal
40075,739,8,710.8199999999999,1,2,1,4,Hibernating
40076,367,7,700.4200000000001,2,1,1,4,Hibernating
40077,185,12,1876.13,3,4,4,11,Big Spenders
40078,190,12,1586.8899999999999,3,4,3,10,Regulars
40079,717,4,424.51,1,1,1,3,Hibernating
40080,315,11,1806.6399999999999,2,3,4,9,Regulars
40081,226,8,632.32,3,2,1,6,Regulars
40082,271,11,1756.3100000000002,2,3,4,9,Regulars
40083,78,8,2131.6,4,2,4,10,Big Spenders
40084,130,11,3577.62,4,3,5,12,Loyal
40085,32,9,589.86,5,2,1,8,Regulars
40086,18,11,1008.8000000000001,5,3,2,10,Loyal
40087,38,9,2053.01,5,2,4,11,Big Spenders
40088,19,12,1628.1299999999999,5,4,3,12,Loyal
40089,133,11,1263.65,4,3,3,10,Loyal
40090,67,10,767.4,4,3,1,8,Loyal
40091,972,9,632.3199999999999,1,2,1,4,Hibernating
40092,269,10,1820.74,2,3,4,9,Regulars
40093,227,12,1321.61,3,4,3,10,Regulars
40094,5,15,1512.6,5,5,3,13,Loyal
40095,597,10,831.11,1,3,1,5,Regulars
40096,269,13,1125.89,2,4,2,8,At Risk
40097,53,12,1363.05,5,4,3,12,Loyal
40098,41,14,1852.9,5,5,4,14,Champions
40099,524,6,1004.3100000000001,1,1,2,4,Hibernating
40100,814,3,1666.85,1,1,3,5,Regulars
40101,96,8,2243.97,4,2,4,10,Big Spenders
40102,250,6,3297.12,2,1,5,8,Regulars
40103,60,15,2615.46,5,5,5,15,Champions
40104,19,13,4655.389999999999,5,4,5,14,Champions
40105,41,16,3186.66,5,5,5,15,Champions
40106,210,11,2242.52,3,3,4,10,Big Spenders
40107,109,9,1635.08,4,2,3,9,Regulars
40108,413,11,4465.25,2,3,5,10,Regulars
40109,111,11,2607.2400000000002,4,3,5,12,Loyal
40110,171,9,900.1800000000001,3,2,2,7,Regulars
40111,278,13,1803.58,2,4,4,10,At Risk
40112,531,8,1510.29,1,2,3,6,Regulars
40113,54,5,653.5899999999999,5,1,1,7,Regulars
40114,0,12,2351.2799999999997,5,4,4,13,Champions
40115,373,6,1352.55,2,1,3,6,Regulars
40116,2,14,2878.36,5,5,5,15,Champions
40117,610,6,680.33,1,1,1,3,Hibernating
40118,35,13,3008.06,5,4,5,14,Champions
40119,21,11,564.09,5,3,1,9,Loyal
40120,234,7,1878.51,3,1,4,8,Big Spenders
40121,1385,9,1457.99,1,2,3,6,Regulars
40122,2,16,3031.56,5,5,5,15,Champions
40123,649,8,1175.8600000000001,1,2,2,5,Hibernating
40124,371,7,2218.11,2,1,4,7,Regulars
40125,823,7,832.42,1,1,1,3,Hibernating
40126,153,9,1600.41,3,2,3,8,Regulars
40127,15,11,2871.41,5,3,5,13,Loyal
40128,615,9,805.83,1,2,1,4,Hibernating
40129,72,10,1012.29,4,3,2,9,Loyal
40130,321,12,1998.3799999999999,2,4,4,10,At Risk
40131,723,11,1129.11,1,3,2,6,Regulars
40132,113,9,979.3,4,2,2,8,Regulars
40133,480,10,2383.96,1,3,4,8,Regulars
40134,192,17,1984.62,3,5,4,12,Big Spenders
40135,142,10,1161.7,4,3,2,9,Loyal
40136,110,6,1041.15,4,1,2,7,Regulars
40137,2,12,1899.62,5,4,4,13,Champions
40138,830,6,861.6099999999999,1,1,2,4,Hibernating
40139,275,10,3188.81,2,3,5,10,Regulars
40140,176,9,1728.4199999999998,3,2,4,9,Big Spenders
40141,617,13,2996.27,1,4,5,10,At Risk
40142,103,8,490.83000000000004,4,2,1,7,Regulars
40143,54,11,2275.47,5,3,4,12,Loyal
40144,828,7,2678.44,1,1,5,7,Regulars
40145,240,12,2198.3,3,4,4,11,Big Spenders
40146,39,11,6126.75,5,3,5,13,Loyal
40147,119,11,940.3699999999999,4,3,2,9,Loyal
40148,402,11,786.26,2,3,1,6,Regulars
40149,1,8,1034.25,5,2,2,9,Regulars
40150,153,9,505.46000000000004,3,2,1,6,Regulars
40151,492,11,977.86,1,3,2,6,Regulars
40152,61,10,1510.97,5,3,3,11,Loyal
40153,108,9,1593.9199999999998,4,2,3,9,Regulars
40154,375,7,2077.7,2,1,4,7,Regulars
40155,118,13,1695.15,4,4,3,11,Loyal
40156,322,14,2372.28,2,5,4,11,At Risk
40157,171,18,3091.21,3,5,5,13,Big Spenders
40158,278,9,1979.3600000000001,2,2,4,8,Regulars
40159,441,12,1579.0900000000001,2,4,3,9,At Risk
40160,55,13,889.0799999999999,5,4,2,11,Loyal
40161,130,10,2661.05,4,3,5,12,Loyal
40162,201,4,752.26,3,1,1,5,Regulars
40163,162,10,1091.0,3,3,2,8,Regulars
40164,3,13,1149.89,5,4,2,11,Loyal
40165,154,10,2027.89,3,3,4,10,Big Spenders
40166,245,6,1098.1200000000001,3,1,2,6,Regulars
40167,364,12,1491.88,2,4,3,9,At Risk
40168,177,8,2292.46,3,2,4,9,Big Spenders
40169,332,10,1173.78,2,3,2,7,Regulars
40170,3,14,2857.45,5,5,5,15,Champions
40171,166,8,672.48,3,2,1,6,Regulars
40172,218,7,1033.75,3,1,2,6,Regulars
40173,170,13,2315.51,3,4,4,11,Big Spenders
40174,296,11,3265.3,2,3,5,10,Regulars
40175,522,6,4040.42,1,1,5,7,Regulars
40176,346,11,1423.68,2,3,3,8,Regulars
40177,148,10,1112.39,3,3,2,8,Regulars
40178,149,13,2240.31,3,4,4,11,Big Spenders
40179,519,8,1804.08,1,2,4,7,Regulars
40180,124,15,2704.79,4,5,5,14,Champions
40181,476,9,1412.11,1,2,3,6,Regulars
40182,199,8,672.4,3,2,1,6,Regulars
40183,110,8,1557.39,4,2,3,9,Regulars
40184,287,12,1826.5,2,4,4,10,At Risk
40185,440,5,2071.26,2,1,4,7,Regulars
40186,336,13,2264.75,2,4,4,10,At Risk
40187,88,9,1379.94,4,2,3,9,Regulars
40188,519,11,1560.75,1,3,3,7,Regulars
40189,108,11,1086.2,4,3,2,9,Loyal
40190,87,9,754.38,4,2,1,7,Regulars
40191,29,10,1031.14,5,3,2,10,Loyal
40192,96,12,2093.75,4,4,4,12,Champions
40193,124,9,2321.97,4,2,4,10,Big Spenders
40194,174,10,2130.9700000000003,3,3,4,10,Big Spenders
40195,119,8,677.64,4,2,1,7,Regulars
40196,504,9,1103.3799999999999,1,2,2,5,Hibernating
40197,597,9,1584.9299999999998,1,2,3,6,Regulars
40198,89,15,2949.21,4,5,5,14,Champions
40199,1043,12,2732.1499999999996,1,4,5,10,At Risk
40200,108,12,1369.36,4,4,3,11,Loyal
40201,9,14,3937.39,5,5,5,15,Champions
40202,10,13,1475.04,5,4,3,12,Loyal
40203,66,6,1365.46,4,1,3,8,Regulars
40204,300,8,2856.82,2,2,5,9,Regulars
40205,505,9,1783.95,1,2,4,7,Regulars
40206,56,10,1982.14,5,3,4,12,Loyal
40207,30,6,313.12,5,1,1,7,Regulars
40208,292,14,2228.54,2,5,4,11,At Risk
40209,37,12,1649.04,5,4,3,12,Loyal
40210,71,21,4095.73,4,5,5,14,Champions
40211,12,12,1999.4,5,4,4,13,Champions
40212,565,7,1550.48,1,1,3,5,Regulars
40213,162,7,495.09000000000003,3,1,1,5,Regulars
40214,225,7,544.34,3,1,1,5,Regulars
40215,1488,6,2547.4500000000003,1,1,4,6,Regulars
40216,21,14,1999.9099999999999,5,5,4,14,Champions
40217,303,10,1284.27,2,3,3,8,Regulars
40218,179,17,2365.38,3,5,4,12,Big Spenders
40219,286,11,1699.05,2,3,3,8,Regulars
40220,215,21,4569.58,3,5,5,13,Big Spenders
40221,159,8,536.11,3,2,1,6,Regulars
40222,575,15,3080.04,1,5,5,11,At Risk
40223,308,12,4243.07,2,4,5,11,At Risk
40224,1434,9,822.09,1,2,1,4,Hibernating
40225,458,7,1306.34,2,1,3,6,Regulars
40226,24,6,865.71,5,1,2,8,Regulars
40227,93,9,1959.46,4,2,4,10,Big Spenders
40228,310,17,2706.13,2,5,5,12,At Risk
40229,380,10,2421.92,2,3,4,9,Regulars
40230,259,13,1590.3700000000001,2,4,3,9,At Risk
40231,428,12,1159.33,2,4,2,8,At Risk
40232,171,14,1171.98,3,5,2,10,Regulars
40233,119,7,1810.4300000000003,4,1,4,9,Big Spenders
40234,139,7,3629.7200000000003,4,1,5,10,Big Spenders
40235,170,12,2242.7599999999998,3,4,4,11,Big Spenders
40236,285,19,1288.81,2,5,3,10,At Risk
40237,148,10,1075.1699999999998,3,3,2,8,Regulars
40238,14,11,1963.7399999999998,5,3,4,12,Loyal
40239,295,5,1075.79,2,1,2,5,Hibernating
40240,718,10,866.28,1,3,2,6,Regulars
40241,217,8,826.9799999999999,3,2,1,6,Regulars
40242,428,8,710.9,2,2,1,5,Hibernating
40243,52,14,1894.0,5,5,4,14,Champions
40244,134,8,951.06,4,2,2,8,Regulars
40245,40,9,1074.66,5,2,2,9,Regulars
40246,275,13,1729.27,2,4,4,10,At Risk
40247,343,6,686.9,2,1,1,4,Hibernating
40248,41,7,951.54,5,1,2,8,Regulars
40249,303,11,4125.45,2,3,5,10,Regulars
40250,505,7,1777.94,1,1,4,6,Regulars
40251,151,9,1923.96,3,2,4,9,Big Spenders
40252,203,10,2560.08,3,3,4,10,Big Spenders
40253,130,11,1424.34,4,3,3,10,Loyal
40254,105,4,572.22,4,1,1,6,Regulars
40255,422,7,956.98,2,1,2,5,Hibernating
40256,324,6,742.95,2,1,1,4,Hibernating
40257,60,14,3256.9300000000003,5,5,5,15,Champions
40258,184,10,838.69,3,3,1,7,Regulars
40259,443,14,3792.98,2,5,5,12,At Risk
40260,145,9,2573.68,4,2,4,10,Big Spenders
40261,546,7,2993.14,1,1,5,7,Regulars
40262,735,4,630.53,1,1,1,3,Hibernating
40263,91,13,1556.5,4,4,3,11,Loyal
40264,7,8,3904.01,5,2,5,12,Big Spenders
40265,166,12,1610.5500000000002,3,4,3,10,Regulars
40266,192,7,770.49,3,1,1,5,Regulars
40267,216,9,4325.51,3,2,5,10,Big Spenders
40268,116,10,673.4,4,3,1,8,Loyal
40269,29,9,907.08,5,2,2,9,Regulars
40270,85,7,621.99,4,1,1,6,Regulars
40271,233,10,1953.57,3,3,4,10,Big Spenders
40272,391,15,994.35,2,5,2,9,At Risk
40273,279,6,707.0000000000001,2,1,1,4,Hibernating
40274,361,11,1807.22,2,3,4,9,Regulars
40275,333,8,1232.44,2,2,2,6,Hibernating
40276,721,7,524.8299999999999,1,1,1,3,Hibernating
40277,107,13,1421.32,4,4,3,11,Loyal
40278,245,9,1886.0,3,2,4,9,Big Spenders
40279,22,13,1564.3600000000001,5,4,3,12,Loyal
40280,227,16,2042.95,3,5,4,12,Big Spenders
40281,68,19,2836.97,4,5,5,14,Champions
40282,880,7,1044.92,1,1,2,4,Hibernating
40283,2,15,1986.3400000000001,5,5,4,14,Champions
40284,581,9,1044.8100000000002,1,2,2,5,Hibernating
40285,2,7,652.47,5,1,1,7,Regulars
40286,72,13,1053.79,4,4,2,10,Loyal
40287,490,9,4344.45,1,2,5,8,Regulars
40288,142,9,1803.46,4,2,4,10,Big Spenders
40289,342,6,990.6500000000001,2,1,2,5,Hibernating
40290,68,12,1043.79,4,4,2,10,Loyal
40291,272,13,2084.98,2,4,4,10,At Risk
40292,73,15,1568.3700000000001,4,5,3,12,Loyal
40293,88,19,2745.98,4,5,5,14,Champions
40294,624,10,1752.22,1,3,4,8,Regulars
40295,253,13,2916.26,2,4,5,11,At Risk
40296,3,9,1148.55,5,2,2,9,Regulars
40297,523,11,973.6,1,3,2,6,Regulars
40298,383,7,751.2,2,1,1,4,Hibernating
40299,117,14,2775.77,4,5,5,14,Champions
40300,124,13,1015.56,4,4,2,10,Loyal
40301,0,12,2006.35,5,4,4,13,Champions
40302,581,7,309.5,1,1,1,3,Hibernating
40303,1296,6,556.55,1,1,1,3,Hibernating
40304,541,13,1743.3999999999999,1,4,4,9,At Risk
40305,52,13,1930.57,5,4,4,13,Champions
40306,174,10,5619.23,3,3,5,11,Big Spenders
40307,186,6,440.92,3,1,1,5,Regulars
40308,160,14,1401.08,3,5,3,11,Regulars
40309,0,5,721.6800000000001,5,1,1,7,Regulars
40310,163,13,3321.75,3,4,5,12,Big Spenders
40311,172,10,1252.8899999999999,3,3,3,9,Regulars
40312,325,12,4321.09,2,4,5,11,At Risk
40313,105,18,3532.57,4,5,5,14,Champions
40314,625,10,687.6,1,3,1,5,Regulars
40315,398,12,2052.02,2,4,4,10,At Risk
40316,391,14,1598.6200000000001,2,5,3,10,At Risk
40317,56,13,2086.77,5,4,4,13,Champions
40318,252,15,1141.0,2,5,2,9,At Risk
40319,217,10,3476.59,3,3,5,11,Big Spenders
40320,95,6,322.6,4,1,1,6,Regulars
40321,96,12,2687.24,4,4,5,13,Champions
40322,302,9,1644.72,2,2,3,7,Regulars
40323,56,10,504.23,5,3,1,9,Loyal
40324,195,8,1624.73,3,2,3,8,Regulars
40325,1328,7,1158.4299999999998,1,1,2,4,Hibernating
40326,505,6,857.26,1,1,2,4,Hibernating
40327,25,8,643.9,5,2,1,8,Regulars
40328,243,11,1400.5,3,3,3,9,Regulars
40329,39,7,1000.03,5,1,2,8,Regulars
40330,9,14,2045.73,5,5,4,14,Champions
40331,212,12,1322.0900000000001,3,4,3,10,Regulars
40332,287,11,866.66,2,3,2,7,Regulars
40333,44,13,2672.62,5,4,5,14,Champions
40334,192,7,544.29,3,1,1,5,Regulars
40335,235,6,1068.8,3,1,2,6,Regulars
40336,379,8,1012.49,2,2,2,6,Hibernating
40337,44,12,1433.0,5,4,3,12,Loyal
40338,31,3,640.87,5,1,1,7,Regulars
40339,412,10,2341.69,2,3,4,9,Regulars
40340,314,12,1542.09,2,4,3,9,At Risk
40341,990,5,2834.77,1,1,5,7,Regulars
40342,1020,10,752.6,1,3,1,5,Regulars
40343,851,7,2932.1000000000004,1,1,5,7,Regulars
40344,223,14,3237.0099999999998,3,5,5,13,Big Spenders
40345,97,12,1856.24,4,4,4,12,Champions
40346,126,11,1986.88,4,3,4,11,Loyal
40347,461,14,1837.0,1,5,4,10,At Risk
40348,266,11,2567.2799999999997,2,3,4,9,Regulars
40349,331,11,1411.58,2,3,3,8,Regulars
40350,21,6,2183.31,5,1,4,10,Big Spenders
40351,2,8,1586.89,5,2,3,10,Regulars
40352,499,6,474.52,1,1,1,3,Hibernating
40353,34,11,1619.23,5,3,3,11,Loyal
40354,45,15,4796.46,5,5,5,15,Champions
40355,62,15,3215.12,5,5,5,15,Champions
40356,762,10,1294.13,1,3,3,7,Regulars
40357,190,13,2112.56,3,4,4,11,Big Spenders
40358,645,7,934.8899999999999,1,1,2,4,Hibernating
40359,545,20,8130.379999999999,1,5,5,11,At Risk
40360,384,11,978.07,2,3,2,7,Regulars
40361,677,7,2565.3599999999997,1,1,4,6,Regulars
40362,42,10,1673.53,5,3,3,11,Loyal
40363,24,11,3086.77,5,3,5,13,Loyal
40364,527,12,1218.48,1,4,2,7,At Risk
40365,51,10,1307.0700000000002,5,3,3,11,Loyal
40366,215,9,2079.74,3,2,4,9,Big Spenders
40367,87,12,1326.28,4,4,3,11,Loyal
40368,111,12,1944.6000000000001,4,4,4,12,Champions
40369,704,9,2357.73,1,2,4,7,Regulars
40370,166,13,842.71,3,4,1,8,Regulars
40371,63,6,737.36,5,1,1,7,Regulars
40372,605,4,1102.63,1,1,2,4,Hibernating
40373,140,12,1473.43,4,4,3,11,Loyal
40374,870,4,396.81,1,1,1,3,Hibernating
40375,502,6,893.48,1,1,2,4,Hibernating
40376,882,7,691.79,1,1,1,3,Hibernating
40377,140,8,1905.8999999999999,4,2,4,10,Big Spenders
40378,499,10,1221.32,1,3,2,6,Regulars
40379,43,13,2264.48,5,4,4,13,Champions
40380,86,10,2579.76,4,3,5,12,Loyal
40381,158,8,1048.45,3,2,2,7,Regulars
40382,48,7,2427.1499999999996,5,1,4,10,Big Spenders
40383,14,15,2159.78,5,5,4,14,Champions
40384,39,10,2466.08,5,3,4,12,Loyal
40385,65,7,539.41,5,1,1,7,Regulars
40386,624,12,1350.23,1,4,3,8,At Risk
40387,342,7,498.85,2,1,1,4,Hibernating
40388,1290,7,847.43,1,1,2,4,Hibernating
40389,84,8,1136.56,4,2,2,8,Regulars
40390,204,11,1729.32,3,3,4,10,Big Spenders
40391,160,11,1265.56,3,3,3,9,Regulars
40392,213,10,1950.74,3,3,4,10,Big Spenders
40393,155,6,2495.21,3,1,4,8,Big Spenders
40394,181,11,1414.3,3,3,3,9,Regulars
40395,698,13,3066.4799999999996,1,4,5,10,At Risk
40396,2,11,2942.95,5,3,5,13,Loyal
40397,563,6,963.8900000000001,1,1,2,4,Hibernating
40398,114,16,1551.6799999999998,4,5,3,12,Loyal
40399,286,15,1711.61,2,5,3,10,At Risk
40400,127,13,2448.5,4,4,4,12,Champions
40401,16,14,4931.129999999999,5,5,5,15,Champions
40402,258,14,2003.82,2,5,4,11,At Risk
40403,244,15,1277.98,3,5,3,11,Regulars
40404,127,12,2984.87,4,4,5,13,Champions
40405,160,9,2309.75,3,2,4,9,Big Spenders
40406,219,9,1222.21,3,2,2,7,Regulars
40407,377,11,1316.78,2,3,3,8,Regulars
40408,154,3,238.19,3,1,1,5,Regulars
40409,295,12,1129.6499999999999,2,4,2,8,At Risk
40410,134,11,704.8000000000001,4,3,1,8,Loyal
40411,130,8,3752.04,4,2,5,11,Big Spenders
40412,652,15,3013.67,1,5,5,11,At Risk
40413,91,11,4033.7599999999998,4,3,5,12,Loyal
40414,596,6,907.63,1,1,2,4,Hibernating
40415,378,8,1060.0,2,2,2,6,Hibernating
40416,38,11,1366.4199999999998,5,3,3,11,Loyal
40417,269,8,464.43999999999994,2,2,1,5,Hibernating
40418,40,12,2856.79,5,4,5,14,Champions
40419,560,7,718.4,1,1,1,3,Hibernating
40420,169,12,2716.1400000000003,3,4,5,12,Big Spenders
40421,320,8,1379.45,2,2,3,7,Regulars
40422,125,10,871.24,4,3,2,9,Loyal
40423,1584,3,181.17000000000002,1,1,1,3,Hibernating
40424,291,14,1096.69,2,5,2,9,At Risk
40425,547,9,1201.48,1,2,2,5,Hibernating
40426,432,12,1517.51,2,4,3,9,At Risk
40427,177,15,1344.44,3,5,3,11,Regulars
40428,5,9,3316.71,5,2,5,12,Big Spenders
40429,42,9,1562.24,5,2,3,10,Regulars
40430,516,6,3076.0700000000006,1,1,5,7,Regulars
40431,268,7,971.95,2,1,2,5,Hibernating
40432,443,8,1347.3200000000002,2,2,3,7,Regulars
40433,332,9,779.8,2,2,1,5,Hibernating
40434,1601,2,261.98,1,1,1,3,Hibernating
40435,659,4,416.94,1,1,1,3,Hibernating
40436,200,9,3137.75,3,2,5,10,Big Spenders
40437,17,10,1042.27,5,3,2,10,Loyal
40438,96,7,996.9000000000001,4,1,2,7,Regulars
40439,213,9,1046.6599999999999,3,2,2,7,Regulars
40440,50,19,4850.16,5,5,5,15,Champions
40441,13,15,3479.19,5,5,5,15,Champions
40442,236,4,675.11,3,1,1,5,Regulars
40443,904,4,1204.65,1,1,2,4,Hibernating
40444,349,8,2376.68,2,2,4,8,Regulars
40445,397,9,1606.78,2,2,3,7,Regulars
40446,243,10,3017.7900000000004,3,3,5,11,Big Spenders
40447,82,8,893.27,4,2,2,8,Regulars
40448,296,16,1044.18,2,5,2,9,At Risk
40449,286,15,2729.44,2,5,5,12,At Risk
40450,464,9,1519.0,1,2,3,6,Regulars
40451,110,10,2688.27,4,3,5,12,Loyal
40452,149,15,1539.41,3,5,3,11,Regulars
40453,416,9,1737.67,2,2,4,8,Regulars
40454,20,14,1989.67,5,5,4,14,Champions
40455,571,12,2507.53,1,4,4,9,At Risk
40456,1132,4,281.31,1,1,1,3,Hibernating
40457,78,8,607.27,4,2,1,7,Regulars
40458,40,14,2256.86,5,5,4,14,Champions
40459,224,7,1647.09,3,1,3,7,Regulars
40460,87,11,2643.05,4,3,5,12,Loyal
40461,6,9,1667.38,5,2,3,10,Regulars
40462,794,11,1721.22,1,3,3,7,Regulars
40463,304,4,215.05,2,1,1,4,Hibernating
40464,106,13,6326.130000000001,4,4,5,13,Champions
40465,993,8,1884.1899999999998,1,2,4,7,Regulars
40466,108,8,1009.3000000000001,4,2,2,8,Regulars
40467,121,12,1366.73,4,4,3,11,Loyal
40468,764,8,971.2600000000001,1,2,2,5,Hibernating
40469,241,6,504.2,3,1,1,5,Regulars
40470,196,12,3284.14,3,4,5,12,Big Spenders
40471,749,12,1276.62,1,4,3,8,At Risk
40472,111,12,4938.7,4,4,5,13,Champions
40473,530,7,632.77,1,1,1,3,Hibernating
40474,129,14,3930.5299999999997,4,5,5,14,Champions
40475,626,11,825.74,1,3,1,5,Regulars
40476,71,12,1284.81,4,4,3,11,Loyal
40477,152,10,671.47,3,3,1,7,Regulars
40478,628,6,564.55,1,1,1,3,Hibernating
40479,1109,9,4091.95,1,2,5,8,Regulars
40480,227,14,3670.67,3,5,5,13,Big Spenders
40481,88,10,1093.14,4,3,2,9,Loyal
40482,139,10,802.97,4,3,1,8,Loyal
40483,406,8,565.56,2,2,1,5,Hibernating
40484,248,16,4968.39,2,5,5,12,At Risk
40485,138,10,2854.94,4,3,5,12,Loyal
40486,45,11,3382.62,5,3,5,13,Loyal
40487,258,11,1388.6200000000001,2,3,3,8,Regulars
40488,90,12,1371.23,4,4,3,11,Loyal
40489,508,15,2375.7000000000003,1,5,4,10,At Risk
40490,57,10,968.71,5,3,2,10,Loyal
40491,367,11,1732.01,2,3,4,9,Regulars
40492,39,16,2004.13,5,5,4,14,Champions
40493,24,10,2562.62,5,3,4,12,Loyal
40494,98,12,813.45,4,4,1,9,Loyal
40495,245,9,2553.7,3,2,4,9,Big Spenders
40496,2,12,1659.32,5,4,3,12,Loyal
40497,160,15,2444.04,3,5,4,12,Big Spenders
40498,433,11,1824.64,2,3,4,9,Regulars
40499,524,11,2304.16,1,3,4,8,Regulars
40500,74,14,3233.25,4,5,5,14,Champions
40501,82,18,3164.15,4,5,5,14,Champions
40502,148,15,3288.83,3,5,5,13,Big Spenders
40503,232,9,906.91,3,2,2,7,Regulars
40504,272,13,1692.6399999999999,2,4,3,9,At Risk
40505,420,8,2041.6599999999999,2,2,4,8,Regulars
40506,253,12,1189.16,2,4,2,8,At Risk
40507,1208,9,3782.1000000000004,1,2,5,8,Regulars
40508,1041,7,543.6,1,1,1,3,Hibernating
40509,442,11,1682.6000000000001,2,3,3,8,Regulars
40510,237,11,1710.03,3,3,3,9,Regulars
40511,63,19,3802.4399999999996,5,5,5,15,Champions
40512,395,10,1482.52,2,3,3,8,Regulars
40513,237,10,1934.46,3,3,4,10,Big Spenders
40514,428,19,1959.66,2,5,4,11,At Risk
40515,730,9,1887.8600000000001,1,2,4,7,Regulars
40516,111,13,1770.17,4,4,4,12,Champions
40517,139,11,4753.91,4,3,5,12,Loyal
40518,63,6,1058.29,5,1,2,8,Regulars
40519,36,17,3429.45,5,5,5,15,Champions
40520,4,17,3323.38,5,5,5,15,Champions
40521,200,4,149.29000000000002,3,1,1,5,Regulars
40522,17,10,975.51,5,3,2,10,Loyal
40523,7,9,1434.22,5,2,3,10,Regulars
40524,30,10,877.5699999999999,5,3,2,10,Loyal
40525,585,12,1724.57,1,4,3,8,At Risk
40526,527,14,1579.22,1,5,3,9,At Risk
40527,790,10,1456.4099999999999,1,3,3,7,Regulars
40528,193,8,731.8100000000001,3,2,1,6,Regulars
40529,432,11,1554.78,2,3,3,8,Regulars
40530,474,11,788.76,1,3,1,5,Regulars
40531,262,6,641.76,2,1,1,4,Hibernating
40532,497,15,4937.01,1,5,5,11,At Risk
40533,47,12,1357.6200000000001,5,4,3,12,Loyal
40534,164,10,712.55,3,3,1,7,Regulars
40535,541,10,2535.7999999999997,1,3,4,8,Regulars
40536,106,11,1017.48,4,3,2,9,Loyal
40537,209,11,1374.83,3,3,3,9,Regulars
40538,451,13,1584.3799999999999,2,4,3,9,At Risk
40539,251,14,1787.84,2,5,4,11,At Risk
40540,499,11,1784.86,1,3,4,8,Regulars
40541,25,13,1200.25,5,4,2,11,Loyal
40542,38,10,1566.6499999999999,5,3,3,11,Loyal
40543,18,12,2248.35,5,4,4,13,Champions
40544,73,8,576.76,4,2,1,7,Regulars
40545,277,20,1976.2199999999998,2,5,4,11,At Risk
40546,36,12,1522.02,5,4,3,12,Loyal
40547,855,12,3654.85,1,4,5,10,At Risk
40548,128,7,913.76,4,1,2,7,Regulars
40549,148,5,475.52,3,1,1,5,Regulars
40550,568,13,2391.4700000000003,1,4,4,9,At Risk
40551,285,12,2678.69,2,4,5,11,At Risk
40552,224,10,956.37,3,3,2,8,Regulars
40553,170,13,2437.49,3,4,4,11,Big Spenders
40554,68,10,1791.49,4,3,4,11,Loyal
40555,99,15,1835.98,4,5,4,13,Champions
40556,922,8,2205.55,1,2,4,7,Regulars
40557,23,10,900.11,5,3,2,10,Loyal
40558,149,12,1536.76,3,4,3,10,Regulars
40559,193,9,1895.56,3,2,4,9,Big Spenders
40560,198,10,848.07,3,3,2,8,Regulars
40561,1,8,3255.36,5,2,5,12,Big Spenders
40562,11,8,887.48,5,2,2,9,Regulars
40563,314,7,1236.8,2,1,2,5,Hibernating
40564,203,8,858.5799999999999,3,2,2,7,Regulars
40565,1210,8,2584.04,1,2,5,8,Regulars
40566,498,5,720.84,1,1,1,3,Hibernating
40567,481,9,656.24,1,2,1,4,Hibernating
40568,131,11,2737.69,4,3,5,12,Loyal
40569,251,10,2883.56,2,3,5,10,Regulars
40570,61,9,1438.29,5,2,3,10,Regulars
40571,314,12,1085.37,2,4,2,8,At Risk
40572,453,18,5003.72,2,5,5,12,At Risk
40573,29,13,1648.83,5,4,3,12,Loyal
40574,53,16,1336.72,5,5,3,13,Loyal
40575,1096,9,1123.56,1,2,2,5,Hibernating
40576,96,12,3143.05,4,4,5,13,Champions
40577,156,9,1714.19,3,2,3,8,Regulars
40578,298,11,1088.52,2,3,2,7,Regulars
40579,205,8,608.11,3,2,1,6,Regulars
40580,33,12,1544.86,5,4,3,12,Loyal
40581,597,11,835.66,1,3,1,5,Regulars
40582,1156,7,390.43,1,1,1,3,Hibernating
40583,588,10,953.55,1,3,2,6,Regulars
40584,22,14,3764.67,5,5,5,15,Champions
40585,302,6,532.8,2,1,1,4,Hibernating
40586,237,13,2454.98,3,4,4,11,Big Spenders
40587,383,8,770.0899999999999,2,2,1,5,Hibernating
40588,251,10,1443.76,2,3,3,8,Regulars
40589,122,7,1542.96,4,1,3,8,Regulars
40590,289,7,1651.24,2,1,3,6,Regulars
40591,120,12,1100.44,4,4,2,10,Loyal
40592,60,6,557.5999999999999,5,1,1,7,Regulars
40593,179,16,3716.92,3,5,5,13,Big Spenders
40594,47,13,3288.13,5,4,5,14,Champions
40595,59,13,3742.05,5,4,5,14,Champions
40596,79,17,1846.59,4,5,4,13,Champions
40597,821,4,1394.3600000000001,1,1,3,5,Regulars
40598,45,12,1587.1399999999999,5,4,3,12,Loyal
40599,1,13,835.6899999999999,5,4,1,10,Loyal
40600,6,8,2480.5899999999997,5,2,4,11,Big Spenders
40601,496,14,1354.34,1,5,3,9,At Risk
40602,224,7,1561.0500000000002,3,1,3,7,Regulars
40603,64,11,3728.8399999999997,5,3,5,13,Loyal
40604,391,9,1319.38,2,2,3,7,Regulars
40605,1190,4,1873.1,1,1,4,6,Regulars
40606,942,12,1082.33,1,4,2,7,At Risk
40607,16,12,1154.56,5,4,2,11,Loyal
40608,586,6,559.48,1,1,1,3,Hibernating
40609,45,6,901.26,5,1,2,8,Regulars
40610,103,7,896.4200000000001,4,1,2,7,Regulars
40611,241,11,861.5,3,3,2,8,Regulars
40612,142,15,1212.5900000000001,4,5,2,11,Loyal
40613,606,20,1960.1100000000001,1,5,4,10,At Risk
40614,269,14,3179.18,2,5,5,12,At Risk
40615,212,8,998.39,3,2,2,7,Regulars
40616,50,13,1471.84,5,4,3,12,Loyal
40617,6,12,2339.67,5,4,4,13,Champions
40618,181,5,1902.51,3,1,4,8,Big Spenders
40619,407,8,815.09,2,2,1,5,Hibernating
40620,1050,11,1292.61,1,3,3,7,Regulars
40621,514,8,1057.32,1,2,2,5,Hibernating
40622,165,8,3386.75,3,2,5,10,Big Spenders
40623,156,9,1021.74,3,2,2,7,Regulars
40624,171,13,2533.84,3,4,4,11,Big Spenders
40625,307,8,3523.34,2,2,5,9,Regulars
40626,31,12,1599.44,5,4,3,12,Loyal
40627,166,14,3007.8500000000004,3,5,5,13,Big Spenders
40628,1348,5,338.81,1,1,1,3,Hibernating
40629,251,6,517.3399999999999,2,1,1,4,Hibernating
40630,433,10,549.56,2,3,1,6,Regulars
40631,27,8,1463.06,5,2,3,10,Regulars
40632,511,8,3448.4300000000003,1,2,5,8,Regulars
40633,245,9,5340.7,3,2,5,10,Big Spenders
40634,63,8,1178.5,5,2,2,9,Regulars
40635,262,15,4036.1,2,5,5,12,At Risk
40636,372,9,1193.76,2,2,2,6,Hibernating
40637,166,8,1175.67,3,2,2,7,Regulars
40638,124,10,1045.4099999999999,4,3,2,9,Loyal
40639,1396,10,1471.89,1,3,3,7,Regulars
40640,376,7,2228.71,2,1,4,7,Regulars
40641,245,12,2331.65,3,4,4,11,Big Spenders
40642,53,11,1382.68,5,3,3,11,Loyal
40643,240,8,3190.34,3,2,5,10,Big Spenders
40644,637,5,688.42,1,1,1,3,Hibernating
40645,375,4,1316.75,2,1,3,6,Regulars
40646,728,8,631.74,1,2,1,4,Hibernating
40647,83,7,874.28,4,1,2,7,Regulars
40648,91,11,684.12,4,3,1,8,Loyal
40649,1219,10,952.5899999999999,1,3,2,6,Regulars
40650,1211,7,1474.1,1,1,3,5,Regulars
40651,316,8,449.21,2,2,1,5,Hibernating
40652,162,12,3907.7299999999996,3,4,5,12,Big Spenders
40653,292,10,687.93,2,3,1,6,Regulars
40654,20,10,3794.59,5,3,5,13,Loyal
40655,117,5,383.56,4,1,1,6,Regulars
40656,24,10,1181.97,5,3,2,10,Loyal
40657,394,6,2122.5299999999997,2,1,4,7,Regulars
40658,398,7,1417.7,2,1,3,6,Regulars
40659,74,12,2415.55,4,4,4,12,Champions
40660,428,10,1363.27,2,3,3,8,Regulars
40661,113,8,3312.36,4,2,5,11,Big Spenders
40662,215,21,3496.0699999999997,3,5,5,13,Big Spenders
40663,385,7,3178.26,2,1,5,8,Regulars
40664,91,8,494.79,4,2,1,7,Regulars
40665,482,7,1151.3200000000002,1,1,2,4,Hibernating
40666,0,6,795.83,5,1,1,7,Regulars
40667,42,10,1127.22,5,3,2,10,Loyal
40668,479,9,2076.17,1,2,4,7,Regulars
40669,218,13,1204.82,3,4,2,9,Regulars
40670,432,8,634.3899999999999,2,2,1,5,Hibernating
40671,342,8,2842.73,2,2,5,9,Regulars
40672,99,12,3208.2200000000003,4,4,5,13,Champions
40673,138,17,3784.98,4,5,5,14,Champions
40674,268,9,819.54,2,2,1,5,Hibernating
40675,0,15,3057.71,5,5,5,15,Champions
40676,517,14,1672.77,1,5,3,9,At Risk
40677,185,8,2338.91,3,2,4,9,Big Spenders
40678,26,15,977.38,5,5,2,12,Loyal
40679,61,10,2072.03,5,3,4,12,Loyal
40680,358,10,1770.12,2,3,4,9,Regulars
40681,217,12,1604.8100000000002,3,4,3,10,Regulars
40682,182,6,313.27000000000004,3,1,1,5,Regulars
40683,8,16,2140.39,5,5,4,14,Champions
40684,17,9,2847.9900000000002,5,2,5,12,Big Spenders
40685,186,12,1797.01,3,4,4,11,Big Spenders
40686,15,5,583.9,5,1,1,7,Regulars
40687,927,10,1865.12,1,3,4,8,Regulars
40688,119,11,717.1899999999999,4,3,1,8,Loyal
40689,202,5,1468.64,3,1,3,7,Regulars
40690,444,11,798.31,2,3,1,6,Regulars
40691,85,15,3971.99,4,5,5,14,Champions
40692,63,13,1912.71,5,4,4,13,Champions
40693,28,7,1198.52,5,1,2,8,Regulars
40694,409,8,983.42,2,2,2,6,Hibernating
40695,698,13,6172.57,1,4,5,10,At Risk
40696,511,6,1878.1399999999999,1,1,4,6,Regulars
40697,94,14,2247.05,4,5,4,13,Champions
40698,58,8,1531.47,5,2,3,10,Regulars
40699,711,9,1452.47,1,2,3,6,Regulars
40700,98,15,2165.6,4,5,4,13,Champions
40701,24,15,2261.85,5,5,4,14,Champions
40702,584,9,927.31,1,2,2,5,Hibernating
40703,82,8,2697.08,4,2,5,11,Big Spenders
40704,502,10,1307.73,1,3,3,7,Regulars
40705,306,10,3736.0,2,3,5,10,Regulars
40706,105,11,3115.48,4,3,5,12,Loyal
40707,721,6,1589.3400000000001,1,1,3,5,Regulars
40708,285,8,1299.6399999999999,2,2,3,7,Regulars
40709,140,7,887.6999999999999,4,1,2,7,Regulars
40710,92,7,1352.7800000000002,4,1,3,8,Regulars
40711,167,12,1011.29,3,4,2,9,Regulars
40712,430,8,706.83,2,2,1,5,Hibernating
40713,579,11,1139.8700000000001,1,3,2,6,Regulars
40714,48,10,1928.27,5,3,4,12,Loyal
40715,62,5,656.15,5,1,1,7,Regulars
40716,296,15,1642.8899999999999,2,5,3,10,At Risk
40717,31,13,1995.2,5,4,4,13,Champions
40718,205,12,1985.38,3,4,4,11,Big Spenders
40719,230,10,840.31,3,3,1,7,Regulars
40720,34,7,987.86,5,1,2,8,Regulars
40721,530,5,1146.89,1,1,2,4,Hibernating
40722,264,12,1194.0,2,4,2,8,At Risk
40723,204,9,2648.9300000000003,3,2,5,10,Big Spenders
40724,148,16,3721.32,3,5,5,13,Big Spenders
40725,541,14,1143.6200000000001,1,5,2,8,At Risk
40726,221,11,3905.88,3,3,5,11,Big Spenders
40727,159,10,1702.1399999999999,3,3,3,9,Regulars
40728,693,13,1401.54,1,4,3,8,At Risk
40729,239,8,2044.1799999999998,3,2,4,9,Big Spenders
40730,90,15,1588.32,4,5,3,12,Loyal
40731,266,12,1747.6299999999999,2,4,4,10,At Risk
40732,90,6,413.94,4,1,1,6,Regulars
40733,117,14,3099.16,4,5,5,14,Champions
40734,131,11,1024.92,4,3,2,9,Loyal
40735,330,5,2552.91,2,1,4,7,Regulars
40736,922,5,567.92,1,1,1,3,Hibernating
40737,345,6,2181.98,2,1,4,7,Regulars
40738,118,11,2534.26,4,3,4,11,Loyal
40739,77,12,2663.28,4,4,5,13,Champions
40740,215,10,1420.9299999999998,3,3,3,9,Regulars
40741,302,13,2777.9,2,4,5,11,At Risk
40742,170,8,1404.7,3,2,3,8,Regulars
40743,70,7,1196.06,4,1,2,7,Regulars
40744,254,8,1120.5,2,2,2,6,Hibernating
40745,19,17,2143.32,5,5,4,14,Champions
40746,524,5,545.5,1,1,1,3,Hibernating
40747,60,12,881.2900000000001,5,4,2,11,Loyal
40748,523,5,3903.42,1,1,5,7,Regulars
40749,311,17,4829.17,2,5,5,12,At Risk
40750,44,11,2339.11,5,3,4,12,Loyal
40751,65,6,2952.94,5,1,5,11,Big Spenders
40752,717,5,862.32,1,1,2,4,Hibernating
40753,5,10,2431.12,5,3,4,12,Loyal
40754,197,9,4624.5,3,2,5,10,Big Spenders
40755,310,15,3449.21,2,5,5,12,At Risk
40756,284,3,736.8000000000001,2,1,1,4,Hibernating
40757,130,10,831.04,4,3,1,8,Loyal
40758,132,7,618.52,4,1,1,6,Regulars
40759,249,8,1308.3899999999999,2,2,3,7,Regulars
40760,4,10,4365.85,5,3,5,13,Loyal
40761,8,17,3693.1,5,5,5,15,Champions
40762,55,13,4366.31,5,4,5,14,Champions
40763,430,6,1518.94,2,1,3,6,Regulars
40764,13,7,372.39,5,1,1,7,Regulars
40765,27,11,2855.92,5,3,5,13,Loyal
40766,400,12,3666.3500000000004,2,4,5,11,At Risk
40767,1176,6,345.07,1,1,1,3,Hibernating
40768,210,10,1721.25,3,3,3,9,Regulars
40769,54,11,810.94,5,3,1,9,Loyal
40770,797,14,2046.7299999999998,1,5,4,10,At Risk
40771,37,9,1357.39,5,2,3,10,Regulars
40772,346,8,1731.9099999999999,2,2,4,8,Regulars
40773,54,6,862.6999999999999,5,1,2,8,Regulars
40774,45,17,4017.48,5,5,5,15,Champions
40775,683,9,2012.57,1,2,4,7,Regulars
40776,179,11,839.57,3,3,1,7,Regulars
40777,423,9,513.24,2,2,1,5,Hibernating
40778,538,6,2521.03,1,1,4,6,Regulars
40779,588,11,1768.02,1,3,4,8,Regulars
40780,101,11,1720.42,4,3,3,10,Loyal
40781,614,7,4218.53,1,1,5,7,Regulars
40782,238,8,1121.16,3,2,2,7,Regulars
40783,1472,5,401.03999999999996,1,1,1,3,Hibernating
40784,97,12,893.78,4,4,2,10,Loyal
40785,580,8,1231.6699999999998,1,2,2,5,Hibernating
40786,108,14,5393.06,4,5,5,14,Champions
40787,32,11,1437.36,5,3,3,11,Loyal
40788,338,10,2487.05,2,3,4,9,Regulars
40789,301,10,2262.96,2,3,4,9,Regulars
40790,614,10,1091.79,1,3,2,6,Regulars
40791,245,14,4456.5199999999995,3,5,5,13,Big Spenders
40792,239,7,1330.81,3,1,3,7,Regulars
40793,497,12,2725.68,1,4,5,10,At Risk
40794,2,9,952.45,5,2,2,9,Regulars
40795,144,5,577.17,4,1,1,6,Regulars
40796,337,8,452.39,2,2,1,5,Hibernating
40797,48,14,4787.31,5,5,5,15,Champions
40798,59,7,1989.4299999999998,5,1,4,10,Big Spenders
40799,188,9,5447.77,3,2,5,10,Big Spenders
40800,223,7,1280.9399999999998,3,1,3,7,Regulars
40801,424,10,1909.49,2,3,4,9,Regulars
40802,342,9,796.28,2,2,1,5,Hibernating
40803,104,11,1156.58,4,3,2,9,Loyal
40804,329,9,3182.85,2,2,5,9,Regulars
40805,91,8,1112.04,4,2,2,8,Regulars
40806,500,6,1071.79,1,1,2,4,Hibernating
40807,240,8,735.65,3,2,1,6,Regulars
40808,290,15,2282.2400000000002,2,5,4,11,At Risk
40809,420,14,5474.91,2,5,5,12,At Risk
40810,180,10,1134.95,3,3,2,8,Regulars
40811,193,8,1234.56,3,2,2,7,Regulars
40812,424,7,1950.98,2,1,4,7,Regulars
40813,233,12,2719.36,3,4,5,12,Big Spenders
40814,19,13,1411.22,5,4,3,12,Loyal
40815,249,12,1503.1100000000001,2,4,3,9,At Risk
40816,144,11,1107.48,4,3,2,9,Loyal
40817,259,14,1057.5900000000001,2,5,2,9,At Risk
40818,70,17,2955.98,4,5,5,14,Champions
40819,5,12,1192.13,5,4,2,11,Loyal
40820,1100,7,218.4,1,1,1,3,Hibernating
40821,4,13,2044.35,5,4,4,13,Champions
40822,134,10,715.46,4,3,1,8,Loyal
40823,197,16,2746.92,3,5,5,13,Big Spenders
40824,1291,5,1800.9199999999998,1,1,4,6,Regulars
40825,22,15,2547.84,5,5,4,14,Champions
40826,29,11,1273.27,5,3,3,11,Loyal
40827,498,5,835.0400000000001,1,1,1,3,Hibernating
40828,48,8,1545.21,5,2,3,10,Regulars
40829,426,7,1087.46,2,1,2,5,Hibernating
40830,143,11,1935.88,4,3,4,11,Loyal
40831,30,9,829.5799999999999,5,2,1,8,Regulars
40832,534,5,426.20000000000005,1,1,1,3,Hibernating
40833,1254,3,73.97999999999999,1,1,1,3,Hibernating
40834,216,5,498.11,3,1,1,5,Regulars
40835,449,4,295.29,2,1,1,4,Hibernating
40836,103,7,1011.99,4,1,2,7,Regulars
40837,218,12,1332.8600000000001,3,4,3,10,Regulars
40838,134,13,2412.33,4,4,4,12,Champions
40839,157,12,2084.37,3,4,4,11,Big Spenders
40840,467,7,442.54,1,1,1,3,Hibernating
40841,11,14,1715.98,5,5,3,13,Loyal
40842,141,8,1222.85,4,2,2,8,Regulars
40843,672,6,2310.9900000000002,1,1,4,6,Regulars
40844,404,8,870.6,2,2,2,6,Hibernating
40845,539,6,2684.55,1,1,5,7,Regulars
40846,3,10,1053.5,5,3,2,10,Loyal
40847,90,10,1123.28,4,3,2,9,Loyal
40848,40,15,1823.67,5,5,4,14,Champions
40849,199,12,1999.02,3,4,4,11,Big Spenders
40850,216,9,1238.41,3,2,2,7,Regulars
40851,329,12,1199.43,2,4,2,8,At Risk
40852,205,17,4439.3,3,5,5,13,Big Spenders
40853,40,10,1679.08,5,3,3,11,Loyal
40854,610,5,2087.91,1,1,4,6,Regulars
40855,202,12,1400.27,3,4,3,10,Regulars
40856,96,12,1903.18,4,4,4,12,Champions
40857,345,10,886.32,2,3,2,7,Regulars
40858,542,13,3159.08,1,4,5,10,At Risk
40859,419,12,1431.79,2,4,3,9,At Risk
40860,385,7,1651.72,2,1,3,6,Regulars
40861,170,6,791.4300000000001,3,1,1,5,Regulars
40862,48,12,2265.4,5,4,4,13,Champions
40863,812,10,789.62,1,3,1,5,Regulars
40864,112,10,887.47,4,3,2,9,Loyal
40865,185,9,858.34,3,2,2,7,Regulars
40866,364,9,1681.58,2,2,3,7,Regulars
40867,141,13,1613.24,4,4,3,11,Loyal
40868,512,8,603.68,1,2,1,4,Hibernating
40869,293,6,745.04,2,1,1,4,Hibernating
40870,206,12,3109.0499999999997,3,4,5,12,Big Spenders
40871,104,8,2729.75,4,2,5,11,Big Spenders
40872,716,6,843.8299999999999,1,1,1,3,Hibernating
40873,133,10,2485.45,4,3,4,11,Loyal
40874,167,9,1051.71,3,2,2,7,Regulars
40875,888,5,273.85,1,1,1,3,Hibernating
40876,80,12,1747.2699999999998,4,4,4,12,Champions
40877,1366,6,427.12,1,1,1,3,Hibernating
40878,593,19,1735.37,1,5,4,10,At Risk
40879,71,7,1083.44,4,1,2,7,Regulars
40880,42,7,3256.880000000001,5,1,5,11,Big Spenders
40881,52,8,2221.91,5,2,4,11,Big Spenders
40882,429,14,2782.02,2,5,5,12,At Risk
40883,194,10,1097.74,3,3,2,8,Regulars
40884,17,12,4461.43,5,4,5,14,Champions
40885,383,14,1166.2,2,5,2,9,At Risk
40886,10,14,2003.1699999999998,5,5,4,14,Champions
40887,30,13,1537.24,5,4,3,12,Loyal
40888,3,16,2310.09,5,5,4,14,Champions
40889,49,18,2440.39,5,5,4,14,Champions
40890,345,2,295.07,2,1,1,4,Hibernating
40891,46,7,549.51,5,1,1,7,Regulars
40892,132,9,1082.07,4,2,2,8,Regulars
40893,564,8,825.96,1,2,1,4,Hibernating
40894,202,10,1880.0500000000002,3,3,4,10,Big Spenders
40895,17,10,1289.55,5,3,3,11,Loyal
40896,382,10,799.01,2,3,1,6,Regulars
40897,418,8,721.73,2,2,1,5,Hibernating
40898,567,11,2638.72,1,3,5,9,Regulars
40899,566,6,472.27,1,1,1,3,Hibernating
40900,418,6,1348.46,2,1,3,6,Regulars
40901,385,8,1837.96,2,2,4,8,Regulars
40902,606,3,913.1899999999999,1,1,2,4,Hibernating
40903,303,8,1081.35,2,2,2,6,Hibernating
40904,8,14,3152.7,5,5,5,15,Champions
40905,18,9,1427.51,5,2,3,10,Regulars
40906,256,13,2908.89,2,4,5,11,At Risk
40907,602,7,557.53,1,1,1,3,Hibernating
40908,155,14,2760.85,3,5,5,13,Big Spenders
40909,29,12,1184.07,5,4,2,11,Loyal
40910,65,17,2058.9700000000003,5,5,4,14,Champions
40911,20,9,670.59,5,2,1,8,Regulars
40912,293,11,1695.71,2,3,3,8,Regulars
40913,310,8,546.74,2,2,1,5,Hibernating
40914,104,19,1870.03,4,5,4,13,Champions
40915,274,7,1466.54,2,1,3,6,Regulars
40916,389,9,1120.56,2,2,2,6,Hibernating
40917,49,7,939.33,5,1,2,8,Regulars
40918,9,16,1981.35,5,5,4,14,Champions
40919,528,12,1631.04,1,4,3,8,At Risk
40920,242,18,2056.14,3,5,4,12,Big Spenders
40921,111,11,2639.92,4,3,5,12,Loyal
40922,170,10,751.0699999999999,3,3,1,7,Regulars
40923,185,10,1970.36,3,3,4,10,Big Spenders
40924,211,6,1332.53,3,1,3,7,Regulars
40925,249,13,1394.0,2,4,3,9,At Risk
40926,99,7,1358.7,4,1,3,8,Regulars
40927,859,4,196.36,1,1,1,3,Hibernating
40928,191,7,1807.46,3,1,4,8,Big Spenders
40929,658,8,2999.7699999999995,1,2,5,8,Regulars
40930,70,10,1081.31,4,3,2,9,Loyal
40931,119,8,1219.98,4,2,2,8,Regulars
40932,299,9,3524.0,2,2,5,9,Regulars
40933,433,5,354.43,2,1,1,4,Hibernating
40934,173,14,1558.4299999999998,3,5,3,11,Regulars
40935,693,6,561.57,1,1,1,3,Hibernating
40936,201,11,1601.9,3,3,3,9,Regulars
40937,244,7,353.28,3,1,1,5,Regulars
40938,185,12,3126.6499999999996,3,4,5,12,Big Spenders
40939,190,8,987.0699999999999,3,2,2,7,Regulars
40940,503,9,573.78,1,2,1,4,Hibernating
40941,460,8,1497.84,1,2,3,6,Regulars
40942,212,9,1960.04,3,2,4,9,Big Spenders
40943,675,12,2219.5,1,4,4,9,At Risk
40944,156,13,1227.6200000000001,3,4,2,9,Regulars
40945,388,16,2643.72,2,5,5,12,At Risk
40946,331,12,4224.17,2,4,5,11,At Risk
40947,288,11,1018.3,2,3,2,7,Regulars
40948,148,9,672.5,3,2,1,6,Regulars
40949,446,8,963.39,2,2,2,6,Hibernating
40950,310,7,920.56,2,1,2,5,Hibernating
40951,483,7,1688.8700000000001,1,1,3,5,Regulars
40952,70,9,2600.8900000000003,4,2,5,11,Big Spenders
40953,68,10,866.2,4,3,2,9,Loyal
40954,155,12,2761.04,3,4,5,12,Big Spenders
40955,14,17,2427.1099999999997,5,5,4,14,Champions
40956,60,15,2850.85,5,5,5,15,Champions
40957,60,12,1536.47,5,4,3,12,Loyal
40958,538,20,5327.58,1,5,5,11,At Risk
40959,212,10,857.64,3,3,2,8,Regulars
40960,523,11,1008.05,1,3,2,6,Regulars
40961,245,11,1329.43,3,3,3,9,Regulars
40962,77,3,199.7,4,1,1,6,Regulars
40963,174,20,4043.07,3,5,5,13,Big Spenders
40964,69,12,1102.76,4,4,2,10,Loyal
40965,175,5,1088.44,3,1,2,6,Regulars
40966,177,6,435.37,3,1,1,5,Regulars
40967,602,9,1422.5700000000002,1,2,3,6,Regulars
40968,0,10,1873.52,5,3,4,12,Loyal
40969,130,4,604.23,4,1,1,6,Regulars
40970,307,13,2069.51,2,4,4,10,At Risk
40971,248,18,2131.66,2,5,4,11,At Risk
40972,10,13,4846.09,5,4,5,14,Champions
40973,599,8,3424.06,1,2,5,8,Regulars
40974,40,6,599.7,5,1,1,7,Regulars
40975,47,9,1631.26,5,2,3,10,Regulars
40976,370,9,1210.1100000000001,2,2,2,6,Hibernating
40977,110,18,2928.61,4,5,5,14,Champions
40978,35,13,2907.09,5,4,5,14,Champions
40979,878,12,811.76,1,4,1,6,At Risk
40980,94,10,994.02,4,3,2,9,Loyal
40981,503,10,1038.49,1,3,2,6,Regulars
40982,797,13,2216.13,1,4,4,9,At Risk
40983,511,9,1977.8,1,2,4,7,Regulars
40984,254,7,1090.3400000000001,2,1,2,5,Hibernating
40985,606,8,1997.62,1,2,4,7,Regulars
40986,607,9,2291.79,1,2,4,7,Regulars
40987,103,5,806.7099999999999,4,1,1,6,Regulars
40988,122,12,3517.87,4,4,5,13,Champions
40989,182,9,1085.78,3,2,2,7,Regulars
40990,101,10,1001.5200000000001,4,3,2,9,Loyal
40991,19,11,1264.6399999999999,5,3,3,11,Loyal
40992,434,14,2999.72,2,5,5,12,At Risk
40993,119,11,1876.75,4,3,4,11,Loyal
40994,561,7,1625.3500000000001,1,1,3,5,Regulars
40995,198,6,1052.03,3,1,2,6,Regulars
40996,188,9,2357.06,3,2,4,9,Big Spenders
40997,684,10,2045.4800000000002,1,3,4,8,Regulars
40998,789,5,334.18,1,1,1,3,Hibernating
40999,331,4,859.77,2,1,2,5,Hibernating
41000,463,10,1578.06,1,3,3,7,Regulars
41001,597,10,1540.3500000000001,1,3,3,7,Regulars
41002,124,14,3977.0,4,5,5,14,Champions
41003,270,8,729.75,2,2,1,5,Hibernating
41004,134,12,1490.11,4,4,3,11,Loyal
41005,126,9,598.2,4,2,1,7,Regulars
41006,181,10,2361.63,3,3,4,10,Big Spenders
41007,1727,7,555.5,1,1,1,3,Hibernating
41008,30,10,545.38,5,3,1,9,Loyal
41009,224,11,807.84,3,3,1,7,Regulars
41010,119,10,1805.58,4,3,4,11,Loyal
41011,390,10,779.79,2,3,1,6,Regulars
41012,169,9,2261.43,3,2,4,9,Big Spenders
41013,201,10,1393.03,3,3,3,9,Regulars
41014,203,12,1061.62,3,4,2,9,Regulars
41015,211,6,831.22,3,1,1,5,Regulars
41016,249,3,1130.87,2,1,2,5,Hibernating
41017,264,10,2273.0499999999997,2,3,4,9,Regulars
41018,145,11,930.6800000000001,4,3,2,9,Loyal
41019,399,12,2505.05,2,4,4,10,At Risk
41020,479,12,1182.83,1,4,2,7,At Risk
41021,934,6,789.16,1,1,1,3,Hibernating
41022,864,13,1241.83,1,4,3,8,At Risk
41023,23,8,1049.44,5,2,2,9,Regulars
41024,10,11,1105.67,5,3,2,10,Loyal
41025,792,12,3604.32,1,4,5,10,At Risk
41026,406,13,2697.43,2,4,5,11,At Risk
41027,124,8,1185.46,4,2,2,8,Regulars
41028,19,9,2252.18,5,2,4,11,Big Spenders
41029,119,5,2039.59,4,1,4,9,Big Spenders
41030,245,9,1168.7,3,2,2,7,Regulars
41031,742,7,656.7,1,1,1,3,Hibernating
41032,140,8,1279.1599999999999,4,2,3,9,Regulars
41033,29,6,4825.27,5,1,5,11,Big Spenders
41034,645,7,940.0899999999999,1,1,2,4,Hibernating
41035,190,9,850.29,3,2,2,7,Regulars
41036,604,9,2254.95,1,2,4,7,Regulars
41037,389,5,367.03999999999996,2,1,1,4,Hibernating
41038,686,10,738.3199999999999,1,3,1,5,Regulars
41039,124,15,2008.29,4,5,4,13,Champions
41040,230,9,2034.3799999999999,3,2,4,9,Big Spenders
41041,42,9,1654.1599999999999,5,2,3,10,Regulars
41042,300,12,1507.63,2,4,3,9,At Risk
41043,208,8,1207.84,3,2,2,7,Regulars
41044,325,11,1813.8200000000002,2,3,4,9,Regulars
41045,348,10,1008.16,2,3,2,7,Regulars
41046,281,15,1629.99,2,5,3,10,At Risk
41047,248,14,1993.2,2,5,4,11,At Risk
41048,319,16,1545.03,2,5,3,10,At Risk
41049,20,11,921.8,5,3,2,10,Loyal
41050,204,16,2974.94,3,5,5,13,Big Spenders
41051,96,6,279.38,4,1,1,6,Regulars
41052,437,13,2326.83,2,4,4,10,At Risk
41053,297,8,1716.6399999999999,2,2,3,7,Regulars
41054,30,9,1678.59,5,2,3,10,Regulars
41055,76,18,4106.0,4,5,5,14,Champions
41056,61,17,4375.41,5,5,5,15,Champions
41057,186,14,1977.4499999999998,3,5,4,12,Big Spenders
41058,321,11,2758.2599999999998,2,3,5,10,Regulars
41059,352,18,4348.59,2,5,5,12,At Risk
41060,148,13,3551.27,3,4,5,12,Big Spenders
41061,160,10,3356.31,3,3,5,11,Big Spenders
41062,417,7,1599.7400000000002,2,1,3,6,Regulars
41063,134,15,3589.55,4,5,5,14,Champions
41064,38,19,2597.88,5,5,5,15,Champions
41065,610,10,1185.78,1,3,2,6,Regulars
41066,80,5,621.07,4,1,1,6,Regulars
41067,828,7,601.01,1,1,1,3,Hibernating
41068,667,8,888.97,1,2,2,5,Hibernating
41069,303,11,1414.1100000000001,2,3,3,8,Regulars
41070,396,13,4151.55,2,4,5,11,At Risk
41071,725,9,1509.51,1,2,3,6,Regulars
41072,797,8,3654.73,1,2,5,8,Regulars
41073,151,15,2173.59,3,5,4,12,Big Spenders
41074,93,8,1047.04,4,2,2,8,Regulars
41075,457,10,1237.76,2,3,2,7,Regulars
41076,80,10,3564.7099999999996,4,3,5,12,Loyal
41077,103,7,1514.98,4,1,3,8,Regulars
41078,609,6,397.59000000000003,1,1,1,3,Hibernating
41079,349,11,1403.8600000000001,2,3,3,8,Regulars
41080,357,8,1086.45,2,2,2,6,Hibernating
41081,29,17,2727.9300000000003,5,5,5,15,Champions
41082,322,8,931.03,2,2,2,6,Hibernating
41083,92,7,291.28,4,1,1,6,Regulars
41084,678,13,4200.44,1,4,5,10,At Risk
41085,148,8,2100.5699999999997,3,2,4,9,Big Spenders
41086,318,6,1235.93,2,1,2,5,Hibernating
41087,294,8,1379.41,2,2,3,7,Regulars
41088,533,7,875.59,1,1,2,4,Hibernating
41089,279,13,1397.71,2,4,3,9,At Risk
41090,68,13,2012.1100000000001,4,4,4,12,Champions
41091,420,9,1409.61,2,2,3,7,Regulars
41092,13,12,3128.11,5,4,5,14,Champions
41093,1017,8,1284.1200000000001,1,2,3,6,Regulars
41094,296,12,1715.61,2,4,3,9,At Risk
41095,175,14,1664.81,3,5,3,11,Regulars
41096,797,10,1442.1100000000001,1,3,3,7,Regulars
41097,69,7,613.81,4,1,1,6,Regulars
41098,1049,7,460.06,1,1,1,3,Hibernating
41099,84,17,1440.8,4,5,3,12,Loyal
41100,1454,6,562.96,1,1,1,3,Hibernating
41101,185,18,1963.59,3,5,4,12,Big Spenders
41102,451,15,2633.54,2,5,5,12,At Risk
41103,416,12,2700.1099999999997,2,4,5,11,At Risk
41104,591,7,816.4999999999999,1,1,1,3,Hibernating
41105,595,9,536.55,1,2,1,4,Hibernating
41106,398,13,2031.13,2,4,4,10,At Risk
41107,43,12,1687.6299999999999,5,4,3,12,Loyal
41108,139,16,1422.97,4,5,3,12,Loyal
41109,181,9,869.66,3,2,2,7,Regulars
41110,135,9,2489.58,4,2,4,10,Big Spenders
41111,118,14,1713.55,4,5,3,12,Loyal
41112,497,7,2406.6699999999996,1,1,4,6,Regulars
41113,143,11,2658.3199999999997,4,3,5,12,Loyal
41114,44,11,2097.58,5,3,4,12,Loyal
41115,149,8,957.07,3,2,2,7,Regulars
41116,557,9,3644.6400000000003,1,2,5,8,Regulars
41117,215,11,1707.48,3,3,3,9,Regulars
41118,181,15,3828.04,3,5,5,13,Big Spenders
41119,2,10,899.1700000000001,5,3,2,10,Loyal
41120,60,7,904.72,5,1,2,8,Regulars
41121,149,19,2871.67,3,5,5,13,Big Spenders
41122,393,4,438.71999999999997,2,1,1,4,Hibernating
41123,1088,7,1137.44,1,1,2,4,Hibernating
41124,404,8,1502.3899999999999,2,2,3,7,Regulars
41125,27,14,3495.71,5,5,5,15,Champions
41126,27,9,2077.9,5,2,4,11,Big Spenders
41127,6,8,1868.41,5,2,4,11,Big Spenders
41128,79,12,1714.17,4,4,3,11,Loyal
41129,12,10,1498.45,5,3,3,11,Loyal
41130,162,12,1939.6100000000001,3,4,4,11,Big Spenders
41131,158,8,888.06,3,2,2,7,Regulars
41132,272,8,1127.92,2,2,2,6,Hibernating
41133,219,10,387.83,3,3,1,7,Regulars
41134,211,8,614.75,3,2,1,6,Regulars
41135,255,9,1513.8,2,2,3,7,Regulars
41136,201,8,1180.62,3,2,2,7,Regulars
41137,181,7,457.09,3,1,1,5,Regulars
41138,27,11,1195.67,5,3,2,10,Loyal
41139,290,6,834.69,2,1,1,4,Hibernating
41140,578,12,1201.87,1,4,2,7,At Risk
41141,1019,9,780.9499999999999,1,2,1,4,Hibernating
41142,54,17,1792.02,5,5,4,14,Champions
41143,362,8,317.2,2,2,1,5,Hibernating
41144,5,13,2380.02,5,4,4,13,Champions
41145,540,12,1364.21,1,4,3,8,At Risk
41146,342,12,1741.21,2,4,4,10,At Risk
41147,709,8,579.22,1,2,1,4,Hibernating
41148,184,11,581.39,3,3,1,7,Regulars
41149,130,11,1107.2,4,3,2,9,Loyal
41150,65,15,2003.28,5,5,4,14,Champions
41151,336,9,930.67,2,2,2,6,Hibernating
41152,253,13,3252.47,2,4,5,11,At Risk
41153,357,9,3076.89,2,2,5,9,Regulars
41154,210,15,5198.6900000000005,3,5,5,13,Big Spenders
41155,14,9,3105.7699999999995,5,2,5,12,Big Spenders
41156,372,8,885.4100000000001,2,2,2,6,Hibernating
41157,227,16,3731.09,3,5,5,13,Big Spenders
41158,445,9,764.88,2,2,1,5,Hibernating
41159,84,8,465.41999999999996,4,2,1,7,Regulars
41160,127,12,1973.21,4,4,4,12,Champions
41161,77,7,757.49,4,1,1,6,Regulars
41162,47,10,1722.78,5,3,3,11,Loyal
41163,138,15,1883.48,4,5,4,13,Champions
41164,257,10,3066.8,2,3,5,10,Regulars
41165,353,10,1351.3,2,3,3,8,Regulars
41166,93,11,714.79,4,3,1,8,Loyal
41167,358,11,1387.75,2,3,3,8,Regulars
41168,82,10,927.3399999999999,4,3,2,9,Loyal
41169,5,6,605.88,5,1,1,7,Regulars
41170,183,14,4139.61,3,5,5,13,Big Spenders
41171,164,11,1470.46,3,3,3,9,Regulars
41172,335,10,1030.71,2,3,2,7,Regulars
41173,557,13,1404.3600000000001,1,4,3,8,At Risk
41174,63,19,2533.7599999999998,5,5,4,14,Champions
41175,142,8,1290.4,4,2,3,9,Regulars
41176,1048,5,1556.62,1,1,3,5,Regulars
41177,176,12,1858.25,3,4,4,11,Big Spenders
41178,470,12,617.56,1,4,1,6,At Risk
41179,138,10,2224.98,4,3,4,11,Loyal
41180,211,8,1416.6499999999999,3,2,3,8,Regulars
41181,165,12,896.85,3,4,2,9,Regulars
41182,1367,5,424.76,1,1,1,3,Hibernating
41183,126,12,2416.98,4,4,4,12,Champions
41184,24,16,5050.01,5,5,5,15,Champions
41185,124,11,1826.53,4,3,4,11,Loyal
41186,244,12,908.95,3,4,2,9,Regulars
41187,965,5,522.43,1,1,1,3,Hibernating
41188,278,10,4021.15,2,3,5,10,Regulars
41189,72,14,3139.67,4,5,5,14,Champions
41190,568,8,1295.6200000000001,1,2,3,6,Regulars
41191,46,8,1836.82,5,2,4,11,Big Spenders
41192,106,11,857.58,4,3,2,9,Loyal
41193,23,8,3990.5,5,2,5,12,Big Spenders
41194,16,15,1618.81,5,5,3,13,Loyal
41195,482,10,1346.75,1,3,3,7,Regulars
41196,195,5,1686.0099999999998,3,1,3,7,Regulars
41197,116,8,4193.6900000000005,4,2,5,11,Big Spenders
41198,34,14,801.89,5,5,1,11,Loyal
41199,568,14,1181.76,1,5,2,8,At Risk
41200,295,12,1434.02,2,4,3,9,At Risk
41201,372,7,453.65,2,1,1,4,Hibernating
41202,126,15,2125.31,4,5,4,13,Champions
41203,503,8,1371.25,1,2,3,6,Regulars
41204,564,10,2277.14,1,3,4,8,Regulars
41205,182,6,1231.98,3,1,2,6,Regulars
41206,1,24,3929.9,5,5,5,15,Champions
41207,741,11,1408.79,1,3,3,7,Regulars
41208,50,14,1104.66,5,5,2,12,Loyal
41209,402,5,275.96999999999997,2,1,1,4,Hibernating
41210,706,3,324.47,1,1,1,3,Hibernating
41211,230,10,795.18,3,3,1,7,Regulars
41212,341,11,3015.8100000000004,2,3,5,10,Regulars
41213,315,8,1214.41,2,2,2,6,Hibernating
41214,43,14,2011.12,5,5,4,14,Champions
41215,43,8,3586.04,5,2,5,12,Big Spenders
41216,912,9,3408.65,1,2,5,8,Regulars
41217,132,10,2902.14,4,3,5,12,Loyal
41218,555,16,5301.09,1,5,5,11,At Risk
41219,243,12,1111.65,3,4,2,9,Regulars
41220,85,13,1722.96,4,4,3,11,Loyal
41221,348,7,581.6500000000001,2,1,1,4,Hibernating
41222,453,7,1290.08,2,1,3,6,Regulars
41223,189,6,1760.23,3,1,4,8,Big Spenders
41224,224,14,1323.99,3,5,3,11,Regulars
41225,118,16,3720.6400000000003,4,5,5,14,Champions
41226,364,8,1185.71,2,2,2,6,Hibernating
41227,325,8,524.16,2,2,1,5,Hibernating
41228,174,10,1657.94,3,3,3,9,Regulars
41229,238,9,3088.24,3,2,5,10,Big Spenders
41230,167,11,1369.08,3,3,3,9,Regulars
41231,143,12,1429.88,4,4,3,11,Loyal
41232,392,5,1475.49,2,1,3,6,Regulars
41233,89,14,1905.15,4,5,4,13,Champions
41234,1700,4,476.95,1,1,1,3,Hibernating
41235,96,9,1262.99,4,2,3,9,Regulars
41236,76,13,1726.39,4,4,4,12,Champions
41237,262,10,1184.2,2,3,2,7,Regulars
41238,161,6,531.18,3,1,1,5,Regulars
41239,500,9,722.1700000000001,1,2,1,4,Hibernating
41240,311,7,761.39,2,1,1,4,Hibernating
41241,374,8,3365.01,2,2,5,9,Regulars
41242,195,10,562.71,3,3,1,7,Regulars
41243,76,10,1192.96,4,3,2,9,Loyal
41244,175,11,1215.71,3,3,2,8,Regulars
41245,45,19,1998.12,5,5,4,14,Champions
41246,576,7,737.95,1,1,1,3,Hibernating
41247,27,18,4890.629999999999,5,5,5,15,Champions
41248,931,7,2632.07,1,1,5,7,Regulars
41249,436,9,3039.4700000000003,2,2,5,9,Regulars
41250,403,5,856.85,2,1,2,5,Hibernating
41251,127,9,1184.59,4,2,2,8,Regulars
41252,992,5,364.71,1,1,1,3,Hibernating
41253,921,8,1399.06,1,2,3,6,Regulars
41254,54,10,1091.1499999999999,5,3,2,10,Loyal
41255,119,13,2605.36,4,4,5,13,Champions
41256,101,7,474.87,4,1,1,6,Regulars
41257,451,12,1121.8,2,4,2,8,At Risk
41258,33,11,1029.94,5,3,2,10,Loyal
41259,927,4,1989.82,1,1,4,6,Regulars
41260,106,14,1144.9,4,5,2,11,Loyal
41261,901,7,379.85,1,1,1,3,Hibernating
41262,110,17,2442.9,4,5,4,13,Champions
41263,634,8,1356.28,1,2,3,6,Regulars
41264,442,14,2651.0099999999998,2,5,5,12,At Risk
41265,378,8,1171.08,2,2,2,6,Hibernating
41266,414,6,756.8,2,1,1,4,Hibernating
41267,69,6,292.44,4,1,1,6,Regulars
41268,635,8,699.59,1,2,1,4,Hibernating
41269,167,12,1686.13,3,4,3,10,Regulars
41270,362,8,618.98,2,2,1,5,Hibernating
41271,334,24,3717.59,2,5,5,12,At Risk
41272,56,16,1981.5900000000001,5,5,4,14,Champions
41273,177,4,418.95000000000005,3,1,1,5,Regulars
41274,124,14,5136.09,4,5,5,14,Champions
41275,57,12,1654.8,5,4,3,12,Loyal
41276,281,7,916.65,2,1,2,5,Hibernating
41277,235,15,5117.889999999999,3,5,5,13,Big Spenders
41278,31,11,593.59,5,3,1,9,Loyal
41279,578,8,1336.3,1,2,3,6,Regulars
41280,146,6,1592.78,4,1,3,8,Regulars
41281,85,9,1414.62,4,2,3,9,Regulars
41282,119,8,2613.55,4,2,5,11,Big Spenders
41283,542,11,939.91,1,3,2,6,Regulars
41284,828,10,1870.9099999999999,1,3,4,8,Regulars
41285,129,12,2109.44,4,4,4,12,Champions
41286,12,10,1424.71,5,3,3,11,Loyal
41287,513,6,356.84000000000003,1,1,1,3,Hibernating
41288,109,13,1282.27,4,4,3,11,Loyal
41289,1211,8,552.46,1,2,1,4,Hibernating
41290,484,5,605.4100000000001,1,1,1,3,Hibernating
41291,17,7,722.35,5,1,1,7,Regulars
41292,905,10,784.56,1,3,1,5,Regulars
41293,1227,5,1665.52,1,1,3,5,Regulars
41294,137,8,2625.95,4,2,5,11,Big Spenders
41295,38,10,4766.39,5,3,5,13,Loyal
41296,10,12,3764.11,5,4,5,14,Champions
41297,775,14,4624.25,1,5,5,11,At Risk
41298,555,14,1486.7,1,5,3,9,At Risk
41299,494,12,2537.9,1,4,4,9,At Risk
41300,17,13,2443.88,5,4,4,13,Champions
41301,572,6,2379.59,1,1,4,6,Regulars
41302,303,9,928.9000000000001,2,2,2,6,Hibernating
41303,506,9,1163.06,1,2,2,5,Hibernating
41304,296,13,1080.75,2,4,2,8,At Risk
41305,191,12,1225.78,3,4,2,9,Regulars
41306,575,10,1092.6100000000001,1,3,2,6,Regulars
41307,139,18,4390.36,4,5,5,14,Champions
41308,557,11,1704.83,1,3,3,7,Regulars
41309,44,8,1047.22,5,2,2,9,Regulars
41310,561,11,2484.7799999999997,1,3,4,8,Regulars
41311,455,5,532.07,2,1,1,4,Hibernating
41312,657,6,429.3,1,1,1,3,Hibernating
41313,164,6,333.82,3,1,1,5,Regulars
41314,249,9,751.81,2,2,1,5,Hibernating
41315,171,8,2031.42,3,2,4,9,Big Spenders
41316,125,12,2265.97,4,4,4,12,Champions
41317,216,11,998.72,3,3,2,8,Regulars
41318,42,13,1693.4499999999998,5,4,3,12,Loyal
41319,41,14,2885.9900000000002,5,5,5,15,Champions
41320,370,4,1161.75,2,1,2,5,Hibernating
41321,186,11,2673.86,3,3,5,11,Big Spenders
41322,702,10,968.01,1,3,2,6,Regulars
41323,152,11,1215.95,3,3,2,8,Regulars
41324,126,12,1749.37,4,4,4,12,Champions
41325,160,10,1293.98,3,3,3,9,Regulars
41326,639,7,2271.8,1,1,4,6,Regulars
41327,1161,6,755.63,1,1,1,3,Hibernating
41328,195,6,1400.3200000000002,3,1,3,7,Regulars
41329,125,5,1013.51,4,1,2,7,Regulars
41330,652,6,627.31,1,1,1,3,Hibernating
41331,384,5,623.62,2,1,1,4,Hibernating
41332,243,15,2651.66,3,5,5,13,Big Spenders
41333,57,6,411.06,5,1,1,7,Regulars
41334,275,11,6590.75,2,3,5,10,Regulars
41335,146,14,1655.48,4,5,3,12,Loyal
41336,204,14,2004.56,3,5,4,12,Big Spenders
41337,116,12,1703.14,4,4,3,11,Loyal
41338,61,10,1175.48,5,3,2,10,Loyal
41339,406,12,2262.81,2,4,4,10,At Risk
41340,109,10,3144.24,4,3,5,12,Loyal
41341,51,13,2737.8199999999997,5,4,5,14,Champions
41342,72,15,1454.56,4,5,3,12,Loyal
41343,162,14,2154.39,3,5,4,12,Big Spenders
41344,368,9,909.11,2,2,2,6,Hibernating
41345,381,8,1524.48,2,2,3,7,Regulars
41346,144,10,1585.6200000000001,4,3,3,10,Loyal
41347,1293,5,501.44,1,1,1,3,Hibernating
41348,739,14,1778.47,1,5,4,10,At Risk
41349,19,10,2809.14,5,3,5,13,Loyal
41350,125,12,3997.5099999999998,4,4,5,13,Champions
41351,132,10,596.37,4,3,1,8,Loyal
41352,345,7,5631.95,2,1,5,8,Regulars
41353,464,14,1990.79,1,5,4,10,At Risk
41354,35,11,2129.63,5,3,4,12,Loyal
41355,281,10,1052.52,2,3,2,7,Regulars
41356,252,12,2585.9,2,4,5,11,At Risk
41357,36,9,1099.58,5,2,2,9,Regulars
41358,181,13,4968.92,3,4,5,12,Big Spenders
41359,1014,6,595.62,1,1,1,3,Hibernating
41360,32,14,4115.2300000000005,5,5,5,15,Champions
41361,432,9,2890.1499999999996,2,2,5,9,Regulars
41362,132,10,1916.8400000000001,4,3,4,11,Loyal
41363,7,13,2628.23,5,4,5,14,Champions
41364,399,13,861.88,2,4,2,8,At Risk
41365,220,7,895.8,3,1,2,6,Regulars
41366,564,8,2050.24,1,2,4,7,Regulars
41367,858,5,850.6800000000001,1,1,2,4,Hibernating
41368,279,6,948.19,2,1,2,5,Hibernating
41369,288,13,2914.27,2,4,5,11,At Risk
41370,44,10,2329.77,5,3,4,12,Loyal
41371,442,10,1506.03,2,3,3,8,Regulars
41372,495,11,1666.01,1,3,3,7,Regulars
41373,52,6,687.29,5,1,1,7,Regulars
41374,324,7,1082.2800000000002,2,1,2,5,Hibernating
41375,401,6,913.57,2,1,2,5,Hibernating
41376,222,8,1014.8700000000001,3,2,2,7,Regulars
41377,274,15,2269.7799999999997,2,5,4,11,At Risk
41378,425,11,3528.29,2,3,5,10,Regulars
41379,122,13,2163.9,4,4,4,12,Champions
41380,304,11,1106.9,2,3,2,7,Regulars
41381,48,9,2084.42,5,2,4,11,Big Spenders
41382,209,16,1519.56,3,5,3,11,Regulars
41383,364,8,971.1400000000001,2,2,2,6,Hibernating
41384,1504,7,505.44,1,1,1,3,Hibernating
41385,314,8,1761.05,2,2,4,8,Regulars
41386,101,14,2131.44,4,5,4,13,Champions
41387,623,8,880.25,1,2,2,5,Hibernating
41388,100,9,706.24,4,2,1,7,Regulars
41389,47,17,6120.99,5,5,5,15,Champions
41390,440,9,1402.95,2,2,3,7,Regulars
41391,546,4,388.0,1,1,1,3,Hibernating
41392,619,5,666.91,1,1,1,3,Hibernating
41393,463,10,2428.6,1,3,4,8,Regulars
41394,45,9,1525.58,5,2,3,10,Regulars
41395,107,12,1104.6,4,4,2,10,Loyal
41396,46,10,941.64,5,3,2,10,Loyal
41397,63,11,1998.12,5,3,4,12,Loyal
41398,165,10,1712.21,3,3,3,9,Regulars
41399,160,12,2359.7,3,4,4,11,Big Spenders
41400,112,13,3977.29,4,4,5,13,Champions
41401,27,13,846.31,5,4,2,11,Loyal
41402,173,10,744.31,3,3,1,7,Regulars
41403,276,17,1891.04,2,5,4,11,At Risk
41404,920,11,2780.2,1,3,5,9,Regulars
41405,364,12,1002.14,2,4,2,8,At Risk
41406,75,7,740.62,4,1,1,6,Regulars
41407,279,7,1031.46,2,1,2,5,Hibernating
41408,262,16,3146.15,2,5,5,12,At Risk
41409,968,5,716.49,1,1,1,3,Hibernating
41410,332,14,3073.88,2,5,5,12,At Risk
41411,854,3,251.21000000000004,1,1,1,3,Hibernating
41412,8,17,1843.06,5,5,4,14,Champions
41413,152,12,993.95,3,4,2,9,Regulars
41414,103,10,1329.99,4,3,3,10,Loyal
41415,189,9,1247.3700000000001,3,2,3,8,Regulars
41416,114,6,2807.61,4,1,5,10,Big Spenders
41417,358,12,926.05,2,4,2,8,At Risk
41418,853,8,816.53,1,2,1,4,Hibernating
41419,174,11,3097.0299999999997,3,3,5,11,Big Spenders
41420,0,7,917.14,5,1,2,8,Regulars
41421,113,4,1627.3399999999997,4,1,3,8,Regulars
41422,100,8,1474.21,4,2,3,9,Regulars
41423,359,9,568.94,2,2,1,5,Hibernating
41424,6,11,1007.8699999999999,5,3,2,10,Loyal
41425,175,11,3264.41,3,3,5,11,Big Spenders
41426,210,10,1414.8300000000002,3,3,3,9,Regulars
41427,9,8,2286.89,5,2,4,11,Big Spenders
41428,0,9,1800.03,5,2,4,11,Big Spenders
41429,23,17,4149.6,5,5,5,15,Champions
41430,503,12,2835.73,1,4,5,10,At Risk
41431,676,9,1016.4699999999999,1,2,2,5,Hibernating
41432,126,12,2521.58,4,4,4,12,Champions
41433,23,13,1077.67,5,4,2,11,Loyal
41434,422,11,953.16,2,3,2,7,Regulars
41435,561,10,790.2,1,3,1,5,Regulars
41436,643,8,967.08,1,2,2,5,Hibernating
41437,243,8,597.23,3,2,1,6,Regulars
41438,375,11,2202.29,2,3,4,9,Regulars
41439,105,18,1470.5,4,5,3,12,Loyal
41440,539,12,1789.12,1,4,4,9,At Risk
41441,100,4,556.22,4,1,1,6,Regulars
41442,496,7,1802.4999999999998,1,1,4,6,Regulars
41443,899,8,614.63,1,2,1,4,Hibernating
41444,1322,8,718.36,1,2,1,4,Hibernating
41445,99,14,4247.97,4,5,5,14,Champions
41446,356,11,1749.56,2,3,4,9,Regulars
41447,638,15,5280.53,1,5,5,11,At Risk
41448,22,15,1126.45,5,5,2,12,Loyal
41449,658,10,1495.8600000000001,1,3,3,7,Regulars
41450,585,13,3243.67,1,4,5,10,At Risk
41451,318,9,2558.14,2,2,4,8,Regulars
41452,540,8,1899.36,1,2,4,7,Regulars
41453,219,12,3799.4,3,4,5,12,Big Spenders
41454,98,12,3195.43,4,4,5,13,Champions
41455,72,7,1091.64,4,1,2,7,Regulars
41456,1106,9,1624.57,1,2,3,6,Regulars
41457,1362,10,1253.99,1,3,3,7,Regulars
41458,2011,6,668.6,1,1,1,3,Hibernating
41459,26,7,805.41,5,1,1,7,Regulars
41460,119,6,2096.26,4,1,4,9,Big Spenders
41461,316,10,1271.38,2,3,3,8,Regulars
41462,537,8,2340.13,1,2,4,7,Regulars
41463,149,12,2310.35,3,4,4,11,Big Spenders
41464,86,8,1229.73,4,2,2,8,Regulars
41465,31,9,1188.5,5,2,2,9,Regulars
41466,871,7,4216.76,1,1,5,7,Regulars
41467,249,10,729.3199999999999,2,3,1,6,Regulars
41468,0,14,1781.44,5,5,4,14,Champions
41469,74,11,1946.8,4,3,4,11,Loyal
41470,30,12,4877.88,5,4,5,14,Champions
41471,243,9,856.82,3,2,2,7,Regulars
41472,293,11,1855.1,2,3,4,9,Regulars
41473,68,8,2523.14,4,2,4,10,Big Spenders
41474,145,10,1251.6,4,3,3,10,Loyal
41475,321,9,798.3199999999999,2,2,1,5,Hibernating
41476,18,6,621.24,5,1,1,7,Regulars
41477,331,15,3374.24,2,5,5,12,At Risk
41478,561,10,2142.73,1,3,4,8,Regulars
41479,514,11,962.85,1,3,2,6,Regulars
41480,107,19,3630.47,4,5,5,14,Champions
41481,12,6,737.42,5,1,1,7,Regulars
41482,1248,6,849.75,1,1,2,4,Hibernating
41483,48,4,378.77,5,1,1,7,Regulars
41484,1258,3,400.72999999999996,1,1,1,3,Hibernating
41485,15,15,1633.2,5,5,3,13,Loyal
41486,804,10,1707.23,1,3,3,7,Regulars
41487,283,14,3738.98,2,5,5,12,At Risk
41488,265,10,1154.04,2,3,2,7,Regulars
41489,340,18,1566.21,2,5,3,10,At Risk
41490,484,9,1363.94,1,2,3,6,Regulars
41491,1104,9,661.63,1,2,1,4,Hibernating
41492,65,8,832.05,5,2,1,8,Regulars
41493,169,11,1143.76,3,3,2,8,Regulars
41494,307,10,2095.39,2,3,4,9,Regulars
41495,403,9,700.19,2,2,1,5,Hibernating
41496,154,11,1446.33,3,3,3,9,Regulars
41497,9,9,1457.23,5,2,3,10,Regulars
41498,96,8,667.04,4,2,1,7,Regulars
41499,585,9,2472.06,1,2,4,7,Regulars
41500,110,9,1811.8200000000002,4,2,4,10,Big Spenders
41501,24,12,6036.52,5,4,5,14,Champions
41502,164,10,1111.73,3,3,2,8,Regulars
41503,209,6,362.36999999999995,3,1,1,5,Regulars
41504,10,12,1453.31,5,4,3,12,Loyal
41505,375,9,763.6400000000001,2,2,1,5,Hibernating
41506,5,11,1132.02,5,3,2,10,Loyal
41507,90,8,614.44,4,2,1,7,Regulars
41508,110,13,1460.3,4,4,3,11,Loyal
41509,29,14,4232.04,5,5,5,15,Champions
41510,931,10,2339.64,1,3,4,8,Regulars
41511,175,13,4186.62,3,4,5,12,Big Spenders
41512,102,10,1547.62,4,3,3,10,Loyal
41513,90,9,631.34,4,2,1,7,Regulars
41514,230,11,924.0899999999999,3,3,2,8,Regulars
41515,72,9,1550.9,4,2,3,9,Regulars
41516,235,17,2047.57,3,5,4,12,Big Spenders
41517,143,12,1463.48,4,4,3,11,Loyal
41518,911,9,3894.6099999999997,1,2,5,8,Regulars
41519,376,9,2286.41,2,2,4,8,Regulars
41520,65,11,883.23,5,3,2,10,Loyal
41521,577,6,435.98,1,1,1,3,Hibernating
41522,452,13,1812.2,2,4,4,10,At Risk
41523,16,6,476.04,5,1,1,7,Regulars
41524,79,8,769.99,4,2,1,7,Regulars
41525,624,11,2219.98,1,3,4,8,Regulars
41526,470,15,1310.72,1,5,3,9,At Risk
41527,8,16,3459.04,5,5,5,15,Champions
41528,661,10,1266.93,1,3,3,7,Regulars
41529,319,12,2723.48,2,4,5,11,At Risk
41530,39,13,1778.15,5,4,4,13,Champions
41531,193,7,1405.79,3,1,3,7,Regulars
41532,150,9,898.56,3,2,2,7,Regulars
41533,202,9,709.2,3,2,1,6,Regulars
41534,181,16,1581.45,3,5,3,11,Regulars
41535,231,10,1269.02,3,3,3,9,Regulars
41536,360,10,3210.99,2,3,5,10,Regulars
41537,458,9,632.86,2,2,1,5,Hibernating
41538,57,13,3594.84,5,4,5,14,Champions
41539,310,11,1977.0300000000002,2,3,4,9,Regulars
41540,304,7,1302.4499999999998,2,1,3,6,Regulars
41541,104,6,1369.33,4,1,3,8,Regulars
41542,207,9,669.3,3,2,1,6,Regulars
41543,246,14,2879.0499999999997,3,5,5,13,Big Spenders
41544,392,2,201.8,2,1,1,4,Hibernating
41545,324,9,1933.6100000000001,2,2,4,8,Regulars
41546,38,15,1407.96,5,5,3,13,Loyal
41547,172,14,1443.8,3,5,3,11,Regulars
41548,119,11,900.48,4,3,2,9,Loyal
41549,104,11,1226.6399999999999,4,3,2,9,Loyal
41550,277,12,1106.84,2,4,2,8,At Risk
41551,731,7,1739.22,1,1,4,6,Regulars
41552,287,11,2121.15,2,3,4,9,Regulars
41553,217,8,1252.6599999999999,3,2,3,8,Regulars
41554,178,10,1277.0,3,3,3,9,Regulars
41555,143,7,1017.5699999999999,4,1,2,7,Regulars
41556,22,10,859.21,5,3,2,10,Loyal
41557,207,13,2846.01,3,4,5,12,Big Spenders
41558,643,6,710.46,1,1,1,3,Hibernating
41559,33,9,1500.33,5,2,3,10,Regulars
41560,834,7,2539.46,1,1,4,6,Regulars
41561,236,5,1795.9999999999998,3,1,4,8,Big Spenders
41562,243,13,1184.89,3,4,2,9,Regulars
41563,237,11,2409.04,3,3,4,10,Big Spenders
41564,142,8,968.22,4,2,2,8,Regulars
41565,43,8,1473.3500000000001,5,2,3,10,Regulars
41566,54,11,3327.36,5,3,5,13,Loyal
41567,458,7,1093.0,2,1,2,5,Hibernating
41568,180,9,1662.76,3,2,3,8,Regulars
41569,161,14,2563.04,3,5,4,12,Big Spenders
41570,18,12,1937.52,5,4,4,13,Champions
41571,193,15,2992.04,3,5,5,13,Big Spenders
41572,175,14,1354.71,3,5,3,11,Regulars
41573,494,11,2714.58,1,3,5,9,Regulars
41574,251,12,2095.58,2,4,4,10,At Risk
41575,60,12,1571.37,5,4,3,12,Loyal
41576,183,10,2026.6799999999996,3,3,4,10,Big Spenders
41577,10,11,1196.64,5,3,2,10,Loyal
41578,101,16,1874.21,4,5,4,13,Champions
41579,463,9,724.88,1,2,1,4,Hibernating
41580,368,8,2437.83,2,2,4,8,Regulars
41581,57,7,2620.8,5,1,5,11,Big Spenders
41582,632,10,2316.0699999999997,1,3,4,8,Regulars
41583,38,12,1607.79,5,4,3,12,Loyal
41584,121,9,865.37,4,2,2,8,Regulars
41585,533,7,561.3,1,1,1,3,Hibernating
41586,181,13,1429.0,3,4,3,10,Regulars
41587,174,6,429.18,3,1,1,5,Regulars
41588,1041,11,785.1800000000001,1,3,1,5,Regulars
41589,318,11,1518.98,2,3,3,8,Regulars
41590,149,10,974.16,3,3,2,8,Regulars
41591,627,8,5670.46,1,2,5,8,Regulars
41592,632,13,2015.34,1,4,4,9,At Risk
41593,2269,2,70.96,1,1,1,3,Hibernating
41594,170,13,5114.139999999999,3,4,5,12,Big Spenders
41595,589,3,967.5999999999999,1,1,2,4,Hibernating
41596,252,9,1343.8400000000001,2,2,3,7,Regulars
41597,288,9,1535.0,2,2,3,7,Regulars
41598,385,5,175.23,2,1,1,4,Hibernating
41599,73,11,1419.1499999999999,4,3,3,10,Loyal
41600,62,14,3849.15,5,5,5,15,Champions
41601,156,11,3400.9500000000003,3,3,5,11,Big Spenders
41602,43,11,2120.44,5,3,4,12,Loyal
41603,207,11,984.91,3,3,2,8,Regulars
41604,239,6,2669.39,3,1,5,9,Big Spenders
41605,138,6,548.96,4,1,1,6,Regulars
41606,619,6,2348.35,1,1,4,6,Regulars
41607,578,14,2333.32,1,5,4,10,At Risk
41608,195,14,3791.41,3,5,5,13,Big Spenders
41609,73,8,532.31,4,2,1,7,Regulars
41610,96,9,2879.33,4,2,5,11,Big Spenders
41611,6,10,982.99,5,3,2,10,Loyal
41612,41,9,870.96,5,2,2,9,Regulars
41613,157,11,1484.43,3,3,3,9,Regulars
41614,613,10,2622.2999999999997,1,3,5,9,Regulars
41615,115,14,2747.38,4,5,5,14,Champions
41616,123,9,1140.79,4,2,2,8,Regulars
41617,173,7,779.6,3,1,1,5,Regulars
41618,122,14,3795.7,4,5,5,14,Champions
41619,542,8,1939.27,1,2,4,7,Regulars
41620,85,11,1595.22,4,3,3,10,Loyal
41621,407,11,1061.51,2,3,2,7,Regulars
41622,195,7,1187.47,3,1,2,6,Regulars
41623,701,6,3219.42,1,1,5,7,Regulars
41624,529,13,1123.8600000000001,1,4,2,7,At Risk
41625,781,8,1412.26,1,2,3,6,Regulars
41626,108,10,1603.33,4,3,3,10,Loyal
41627,94,7,2505.8,4,1,4,9,Big Spenders
41628,133,7,687.01,4,1,1,6,Regulars
41629,121,14,4289.89,4,5,5,14,Champions
41630,70,13,2603.06,4,4,5,13,Champions
41631,132,14,2357.11,4,5,4,13,Champions
41632,493,8,2018.3700000000001,1,2,4,7,Regulars
41633,4,10,3861.2200000000003,5,3,5,13,Loyal
41634,156,10,2719.79,3,3,5,11,Big Spenders
41635,148,12,1810.7,3,4,4,11,Big Spenders
41636,156,11,2014.6399999999999,3,3,4,10,Big Spenders
41637,742,6,1309.29,1,1,3,5,Regulars
41638,36,21,3763.11,5,5,5,15,Champions
41639,38,5,987.0699999999999,5,1,2,8,Regulars
41640,507,12,2346.8,1,4,4,9,At Risk
41641,443,7,1875.25,2,1,4,7,Regulars
41642,315,15,1870.3,2,5,4,11,At Risk
41643,521,7,562.5500000000001,1,1,1,3,Hibernating
41644,76,12,4614.1,4,4,5,13,Champions
41645,102,12,1658.85,4,4,3,11,Loyal
41646,148,6,1085.55,3,1,2,6,Regulars
41647,904,10,1235.74,1,3,2,6,Regulars
41648,656,8,1046.17,1,2,2,5,Hibernating
41649,31,3,194.88,5,1,1,7,Regulars
41650,100,7,849.76,4,1,2,7,Regulars
41651,160,9,1381.24,3,2,3,8,Regulars
41652,737,9,1058.22,1,2,2,5,Hibernating
41653,69,12,1599.95,4,4,3,11,Loyal
41654,458,11,849.37,2,3,2,7,Regulars
41655,231,10,4342.79,3,3,5,11,Big Spenders
41656,49,18,1472.36,5,5,3,13,Loyal
41657,154,15,2369.92,3,5,4,12,Big Spenders
41658,23,5,214.96,5,1,1,7,Regulars
41659,76,9,595.6600000000001,4,2,1,7,Regulars
41660,400,12,4094.1800000000007,2,4,5,11,At Risk
41661,0,7,2293.59,5,1,4,10,Big Spenders
41662,24,17,2547.92,5,5,4,14,Champions
41663,166,7,1433.1399999999999,3,1,3,7,Regulars
41664,155,8,1773.1100000000001,3,2,4,9,Big Spenders
41665,180,9,2261.09,3,2,4,9,Big Spenders
41666,261,8,831.35,2,2,1,5,Hibernating
41667,15,10,1217.1299999999999,5,3,2,10,Loyal
41668,453,11,2505.78,2,3,4,9,Regulars
41669,53,13,1439.58,5,4,3,12,Loyal
41670,497,5,469.8,1,1,1,3,Hibernating
41671,795,7,936.87,1,1,2,4,Hibernating
41672,326,10,1372.0900000000001,2,3,3,8,Regulars
41673,210,7,578.15,3,1,1,5,Regulars
41674,537,4,372.01,1,1,1,3,Hibernating
41675,351,8,590.61,2,2,1,5,Hibernating
41676,580,10,2371.63,1,3,4,8,Regulars
41677,16,12,2275.02,5,4,4,13,Champions
41678,207,12,3571.87,3,4,5,12,Big Spenders
41679,50,11,980.23,5,3,2,10,Loyal
41680,40,10,790.4000000000001,5,3,1,9,Loyal
41681,615,7,3379.72,1,1,5,7,Regulars
41682,131,14,3087.6,4,5,5,14,Champions
41683,245,8,728.25,3,2,1,6,Regulars
41684,383,8,982.4100000000001,2,2,2,6,Hibernating
41685,330,9,836.27,2,2,1,5,Hibernating
41686,442,9,1626.3700000000001,2,2,3,7,Regulars
41687,617,11,2189.2,1,3,4,8,Regulars
41688,160,11,857.5699999999999,3,3,2,8,Regulars
41689,1601,6,459.28,1,1,1,3,Hibernating
41690,25,11,2598.57,5,3,5,13,Loyal
41691,1310,9,1373.47,1,2,3,6,Regulars
41692,720,7,2209.9300000000003,1,1,4,6,Regulars
41693,588,3,244.73,1,1,1,3,Hibernating
41694,135,14,1259.2,4,5,3,12,Loyal
41695,40,9,876.91,5,2,2,9,Regulars
41696,45,13,1500.93,5,4,3,12,Loyal
41697,509,15,2506.8900000000003,1,5,4,10,At Risk
41698,117,9,1041.7,4,2,2,8,Regulars
41699,42,9,1299.56,5,2,3,10,Regulars
41700,136,9,908.68,4,2,2,8,Regulars
41701,440,14,3525.36,2,5,5,12,At Risk
41702,43,8,741.34,5,2,1,8,Regulars
41703,465,7,620.72,1,1,1,3,Hibernating
41704,21,12,2142.58,5,4,4,13,Champions
41705,187,12,768.48,3,4,1,8,Regulars
41706,160,11,5184.23,3,3,5,11,Big Spenders
41707,250,11,1695.7,2,3,3,8,Regulars
41708,133,16,2469.34,4,5,4,13,Champions
41709,235,17,2236.16,3,5,4,12,Big Spenders
41710,419,6,750.28,2,1,1,4,Hibernating
41711,88,12,1792.14,4,4,4,12,Champions
41712,238,17,2852.04,3,5,5,13,Big Spenders
41713,286,7,845.88,2,1,2,5,Hibernating
41714,40,13,3066.78,5,4,5,14,Champions
41715,109,16,4888.24,4,5,5,14,Champions
41716,76,19,2378.39,4,5,4,13,Champions
41717,74,10,1174.59,4,3,2,9,Loyal
41718,333,13,3744.68,2,4,5,11,At Risk
41719,42,13,1301.22,5,4,3,12,Loyal
41720,104,17,2409.29,4,5,4,13,Champions
41721,630,10,1201.05,1,3,2,6,Regulars
41722,1050,9,897.71,1,2,2,5,Hibernating
41723,28,17,2497.99,5,5,4,14,Champions
41724,174,6,960.71,3,1,2,6,Regulars
41725,8,10,958.89,5,3,2,10,Loyal
41726,734,7,633.3299999999999,1,1,1,3,Hibernating
41727,235,6,2036.48,3,1,4,8,Big Spenders
41728,123,10,1531.37,4,3,3,10,Loyal
41729,1078,7,350.78,1,1,1,3,Hibernating
41730,181,12,3576.85,3,4,5,12,Big Spenders
41731,43,15,1363.04,5,5,3,13,Loyal
41732,297,10,1510.69,2,3,3,8,Regulars
41733,460,13,4180.51,1,4,5,10,At Risk
41734,551,5,343.40999999999997,1,1,1,3,Hibernating
41735,262,10,1057.09,2,3,2,7,Regulars
41736,127,5,729.52,4,1,1,6,Regulars
41737,60,7,472.18,5,1,1,7,Regulars
41738,137,2,101.53,4,1,1,6,Regulars
41739,89,16,2783.23,4,5,5,14,Champions
41740,99,7,590.57,4,1,1,6,Regulars
41741,272,10,1096.9099999999999,2,3,2,7,Regulars
41742,267,7,575.99,2,1,1,4,Hibernating
41743,427,12,2927.9900000000002,2,4,5,11,At Risk
41744,1111,12,1216.54,1,4,2,7,At Risk
41745,386,9,1462.31,2,2,3,7,Regulars
41746,12,12,1050.93,5,4,2,11,Loyal
41747,342,14,3207.88,2,5,5,12,At Risk
41748,453,9,4027.3500000000004,2,2,5,9,Regulars
41749,83,9,1993.6200000000001,4,2,4,10,Big Spenders
41750,85,14,2570.52,4,5,4,13,Champions
41751,161,11,2424.1,3,3,4,10,Big Spenders
41752,523,10,1069.0900000000001,1,3,2,6,Regulars
41753,9,16,1643.8200000000002,5,5,3,13,Loyal
41754,719,3,195.66000000000003,1,1,1,3,Hibernating
41755,15,13,2157.98,5,4,4,13,Champions
41756,318,10,3388.23,2,3,5,10,Regulars
41757,38,14,3593.4199999999996,5,5,5,15,Champions
41758,460,5,538.4200000000001,1,1,1,3,Hibernating
41759,428,8,1151.34,2,2,2,6,Hibernating
41760,151,12,1012.73,3,4,2,9,Regulars
41761,629,10,3903.8099999999995,1,3,5,9,Regulars
41762,110,8,2822.54,4,2,5,11,Big Spenders
41763,448,12,2774.69,2,4,5,11,At Risk
41764,590,11,838.66,1,3,1,5,Regulars
41765,46,16,2274.15,5,5,4,14,Champions
41766,723,11,1779.49,1,3,4,8,Regulars
41767,40,7,2495.52,5,1,4,10,Big Spenders
41768,1483,4,387.11,1,1,1,3,Hibernating
41769,197,15,1403.29,3,5,3,11,Regulars
41770,384,10,1633.27,2,3,3,8,Regulars
41771,213,12,1716.63,3,4,3,10,Regulars
41772,4,10,1525.1299999999999,5,3,3,11,Loyal
41773,29,9,2312.17,5,2,4,11,Big Spenders
41774,430,9,1208.47,2,2,2,6,Hibernating
41775,471,11,1373.6499999999999,1,3,3,7,Regulars
41776,383,9,1920.1,2,2,4,8,Regulars
41777,208,9,900.68,3,2,2,7,Regulars
41778,126,11,846.73,4,3,2,9,Loyal
41779,133,16,1158.77,4,5,2,11,Loyal
41780,163,12,1458.8,3,4,3,10,Regulars
41781,7,13,1187.37,5,4,2,11,Loyal
41782,101,14,1864.42,4,5,4,13,Champions
41783,959,4,206.3,1,1,1,3,Hibernating
41784,96,12,1547.48,4,4,3,11,Loyal
41785,813,5,1416.4100000000003,1,1,3,5,Regulars
41786,263,8,3039.85,2,2,5,9,Regulars
41787,446,14,2045.74,2,5,4,11,At Risk
41788,204,8,1003.04,3,2,2,7,Regulars
41789,214,10,1391.6100000000001,3,3,3,9,Regulars
41790,70,11,1118.9099999999999,4,3,2,9,Loyal
41791,352,11,1120.47,2,3,2,7,Regulars
41792,502,5,233.27999999999997,1,1,1,3,Hibernating
41793,167,7,1089.42,3,1,2,6,Regulars
41794,55,12,2668.8700000000003,5,4,5,14,Champions
41795,196,8,1137.31,3,2,2,7,Regulars
41796,278,11,1468.79,2,3,3,8,Regulars
41797,92,9,1452.17,4,2,3,9,Regulars
41798,108,7,393.47,4,1,1,6,Regulars
41799,237,5,890.1500000000001,3,1,2,6,Regulars
41800,220,10,1838.06,3,3,4,10,Big Spenders
41801,257,13,1384.66,2,4,3,9,At Risk
41802,168,11,1692.13,3,3,3,9,Regulars
41803,102,7,2660.92,4,1,5,10,Big Spenders
41804,1181,3,2136.28,1,1,4,6,Regulars
41805,351,15,2353.62,2,5,4,11,At Risk
41806,20,13,5113.5599999999995,5,4,5,14,Champions
41807,20,14,1966.4199999999998,5,5,4,14,Champions
41808,514,11,2180.13,1,3,4,8,Regulars
41809,494,8,959.34,1,2,2,5,Hibernating
41810,59,11,1740.24,5,3,4,12,Loyal
41811,100,12,1059.6499999999999,4,4,2,10,Loyal
41812,382,9,2832.9799999999996,2,2,5,9,Regulars
41813,166,11,1459.7,3,3,3,9,Regulars
41814,53,16,3900.5600000000004,5,5,5,15,Champions
41815,400,8,3183.03,2,2,5,9,Regulars
41816,567,12,1384.82,1,4,3,8,At Risk
41817,24,12,3477.9700000000003,5,4,5,14,Champions
41818,504,7,695.6800000000001,1,1,1,3,Hibernating
41819,68,9,1993.3100000000002,4,2,4,10,Big Spenders
41820,175,14,2582.81,3,5,5,13,Big Spenders
41821,134,11,1234.9299999999998,4,3,2,9,Loyal
41822,665,5,2092.2799999999997,1,1,4,6,Regulars
41823,50,15,2127.8599999999997,5,5,4,14,Champions
41824,750,6,717.73,1,1,1,3,Hibernating
41825,111,17,2635.17,4,5,5,14,Champions
41826,8,14,1234.45,5,5,2,12,Loyal
41827,315,14,3111.3,2,5,5,12,At Risk
41828,424,7,602.82,2,1,1,4,Hibernating
41829,1189,11,1048.12,1,3,2,6,Regulars
41830,1097,5,244.49,1,1,1,3,Hibernating
41831,1681,4,330.14,1,1,1,3,Hibernating
41832,489,7,1300.07,1,1,3,5,Regulars
41833,37,13,6001.08,5,4,5,14,Champions
41834,1039,7,555.14,1,1,1,3,Hibernating
41835,876,10,1534.37,1,3,3,7,Regulars
41836,1162,10,882.66,1,3,2,6,Regulars
41837,21,12,7137.67,5,4,5,14,Champions
41838,31,15,947.38,5,5,2,12,Loyal
41839,320,8,880.9,2,2,2,6,Hibernating
41840,358,7,1601.46,2,1,3,6,Regulars
41841,802,7,1561.6799999999998,1,1,3,5,Regulars
41842,6,14,2029.13,5,5,4,14,Champions
41843,163,14,2640.17,3,5,5,13,Big Spenders
41844,115,10,999.49,4,3,2,9,Loyal
41845,156,12,780.79,3,4,1,8,Regulars
41846,54,15,1576.65,5,5,3,13,Loyal
41847,195,10,2479.49,3,3,4,10,Big Spenders
41848,35,6,2113.33,5,1,4,10,Big Spenders
41849,1183,7,1083.43,1,1,2,4,Hibernating
41850,704,10,865.79,1,3,2,6,Regulars
41851,6,9,1125.8300000000002,5,2,2,9,Regulars
41852,1580,3,734.8399999999999,1,1,1,3,Hibernating
41853,587,9,2076.0099999999998,1,2,4,7,Regulars
41854,206,11,2742.23,3,3,5,11,Big Spenders
41855,126,9,1033.44,4,2,2,8,Regulars
41856,104,10,1321.14,4,3,3,10,Loyal
41857,87,12,1465.2,4,4,3,11,Loyal
41858,569,9,826.04,1,2,1,4,Hibernating
41859,15,10,3193.92,5,3,5,13,Loyal
41860,92,8,1917.02,4,2,4,10,Big Spenders
41861,219,6,523.1600000000001,3,1,1,5,Regulars
41862,693,3,652.2099999999999,1,1,1,3,Hibernating
41863,278,12,1948.73,2,4,4,10,At Risk
41864,238,7,875.92,3,1,2,6,Regulars
41865,189,11,4459.52,3,3,5,11,Big Spenders
41866,139,9,560.03,4,2,1,7,Regulars
41867,123,5,722.1800000000001,4,1,1,6,Regulars
41868,413,11,2409.15,2,3,4,9,Regulars
41869,275,10,2188.54,2,3,4,9,Regulars
41870,533,6,445.34,1,1,1,3,Hibernating
41871,128,12,1116.53,4,4,2,10,Loyal
41872,236,10,2039.69,3,3,4,10,Big Spenders
41873,531,12,1785.61,1,4,4,9,At Risk
41874,90,8,1396.9,4,2,3,9,Regulars
41875,76,9,700.8,4,2,1,7,Regulars
41876,44,6,326.13,5,1,1,7,Regulars
41877,1436,8,1621.5900000000001,1,2,3,6,Regulars
41878,17,11,1000.55,5,3,2,10,Loyal
41879,1209,4,405.64,1,1,1,3,Hibernating
41880,739,9,2510.32,1,2,4,7,Regulars
41881,45,6,871.15,5,1,2,8,Regulars
41882,225,12,3919.4799999999996,3,4,5,12,Big Spenders
41883,899,7,883.2,1,1,2,4,Hibernating
41884,940,6,1003.97,1,1,2,4,Hibernating
41885,558,17,1366.47,1,5,3,9,At Risk
41886,300,10,5984.5599999999995,2,3,5,10,Regulars
41887,481,11,2199.7200000000003,1,3,4,8,Regulars
41888,92,10,1990.18,4,3,4,11,Loyal
41889,146,15,1516.98,4,5,3,12,Loyal
41890,345,9,766.77,2,2,1,5,Hibernating
41891,65,11,1266.92,5,3,3,11,Loyal
41892,259,9,3019.4800000000005,2,2,5,9,Regulars
41893,217,11,4274.05,3,3,5,11,Big Spenders
41894,609,4,523.35,1,1,1,3,Hibernating
41895,237,8,707.28,3,2,1,6,Regulars
41896,148,9,1463.0500000000002,3,2,3,8,Regulars
41897,344,7,2130.12,2,1,4,7,Regulars
41898,50,8,1250.16,5,2,3,10,Regulars
41899,510,8,897.88,1,2,2,5,Hibernating
41900,161,9,806.12,3,2,1,6,Regulars
41901,418,16,1959.8,2,5,4,11,At Risk
41902,88,12,2886.64,4,4,5,13,Champions
41903,137,8,1227.2600000000002,4,2,2,8,Regulars
41904,216,9,1027.51,3,2,2,7,Regulars
41905,175,13,2282.2799999999997,3,4,4,11,Big Spenders
41906,108,9,3278.7999999999997,4,2,5,11,Big Spenders
41907,10,7,550.52,5,1,1,7,Regulars
41908,175,11,2647.66,3,3,5,11,Big Spenders
41909,141,7,449.41,4,1,1,6,Regulars
41910,762,5,773.75,1,1,1,3,Hibernating
41911,522,6,943.37,1,1,2,4,Hibernating
41912,281,14,2276.35,2,5,4,11,At Risk
41913,930,13,1645.55,1,4,3,8,At Risk
41914,368,11,1231.28,2,3,2,7,Regulars
41915,216,11,747.4799999999999,3,3,1,7,Regulars
41916,439,10,1424.25,2,3,3,8,Regulars
41917,90,17,3288.8599999999997,4,5,5,14,Champions
41918,160,6,1179.79,3,1,2,6,Regulars
41919,22,11,1974.91,5,3,4,12,Loyal
41920,608,6,845.37,1,1,2,4,Hibernating
41921,134,11,1646.44,4,3,3,10,Loyal
41922,76,16,2856.48,4,5,5,14,Champions
41923,77,13,1861.09,4,4,4,12,Champions
41924,222,14,1268.78,3,5,3,11,Regulars
41925,49,7,672.54,5,1,1,7,Regulars
41926,309,6,458.47999999999996,2,1,1,4,Hibernating
41927,128,15,3733.3300000000004,4,5,5,14,Champions
41928,100,12,3978.46,4,4,5,13,Champions
41929,41,11,1951.2,5,3,4,12,Loyal
41930,26,9,711.42,5,2,1,8,Regulars
41931,14,7,1198.5700000000002,5,1,2,8,Regulars
41932,346,11,3038.0099999999998,2,3,5,10,Regulars
41933,170,13,4013.09,3,4,5,12,Big Spenders
41934,107,12,1879.27,4,4,4,12,Champions
41935,237,11,997.99,3,3,2,8,Regulars
41936,177,12,2034.9499999999998,3,4,4,11,Big Spenders
41937,919,6,1135.8,1,1,2,4,Hibernating
41938,245,15,2659.49,3,5,5,13,Big Spenders
41939,715,8,1552.27,1,2,3,6,Regulars
41940,49,12,969.71,5,4,2,11,Loyal
41941,679,4,225.39,1,1,1,3,Hibernating
41942,497,8,1078.83,1,2,2,5,Hibernating
41943,143,9,741.98,4,2,1,7,Regulars
41944,119,9,1659.54,4,2,3,9,Regulars
41945,48,11,4373.62,5,3,5,13,Loyal
41946,280,7,2327.5600000000004,2,1,4,7,Regulars
41947,74,8,523.72,4,2,1,7,Regulars
41948,424,14,3069.08,2,5,5,12,At Risk
41949,145,9,1044.62,4,2,2,8,Regulars
41950,687,6,516.3299999999999,1,1,1,3,Hibernating
41951,277,13,2056.02,2,4,4,10,At Risk
41952,292,14,1522.92,2,5,3,10,At Risk
41953,213,8,1361.0800000000002,3,2,3,8,Regulars
41954,389,14,2442.75,2,5,4,11,At Risk
41955,39,14,4291.59,5,5,5,15,Champions
41956,39,9,925.8,5,2,2,9,Regulars
41957,771,14,1832.75,1,5,4,10,At Risk
41958,194,13,1224.35,3,4,2,9,Regulars
41959,54,14,1882.19,5,5,4,14,Champions
41960,377,9,843.8199999999999,2,2,1,5,Hibernating
41961,193,15,3213.35,3,5,5,13,Big Spenders
41962,71,11,2993.88,4,3,5,12,Loyal
41963,416,7,569.26,2,1,1,4,Hibernating
41964,24,10,2654.17,5,3,5,13,Loyal
41965,145,12,2582.07,4,4,5,13,Champions
41966,64,10,1720.99,5,3,3,11,Loyal
41967,305,12,1446.52,2,4,3,9,At Risk
41968,104,9,1407.82,4,2,3,9,Regulars
41969,60,9,667.3,5,2,1,8,Regulars
41970,206,9,2530.4900000000002,3,2,4,9,Big Spenders
41971,335,4,531.87,2,1,1,4,Hibernating
41972,201,11,1031.46,3,3,2,8,Regulars
41973,109,14,2839.55,4,5,5,14,Champions
41974,261,9,1353.7900000000002,2,2,3,7,Regulars
41975,0,14,2265.26,5,5,4,14,Champions
41976,563,4,389.67,1,1,1,3,Hibernating
41977,266,11,2586.7,2,3,5,10,Regulars
41978,429,10,1406.74,2,3,3,8,Regulars
41979,196,10,736.38,3,3,1,7,Regulars
41980,88,11,1624.8,4,3,3,10,Loyal
41981,195,14,968.6,3,5,2,10,Regulars
41982,150,14,2530.98,3,5,4,12,Big Spenders
41983,139,11,1230.64,4,3,2,9,Loyal
41984,173,16,2126.25,3,5,4,12,Big Spenders
41985,220,11,1276.3,3,3,3,9,Regulars
41986,341,13,1504.73,2,4,3,9,At Risk
41987,154,16,1920.29,3,5,4,12,Big Spenders
41988,291,9,4247.41,2,2,5,9,Regulars
41989,149,9,2520.4700000000003,3,2,4,9,Big Spenders
41990,104,13,1302.01,4,4,3,11,Loyal
41991,56,12,2910.54,5,4,5,14,Champions
41992,145,7,1042.33,4,1,2,7,Regulars
41993,134,9,1730.3100000000002,4,2,4,10,Big Spenders
41994,1298,6,438.65,1,1,1,3,Hibernating
41995,112,10,1252.4,4,3,3,10,Loyal
41996,193,12,2661.83,3,4,5,12,Big Spenders
41997,422,6,822.54,2,1,1,4,Hibernating
41998,33,8,826.35,5,2,1,8,Regulars
41999,129,10,2257.83,4,3,4,11,Loyal
42000,111,13,1397.6599999999999,4,4,3,11,Loyal
42001,259,17,7530.5,2,5,5,12,At Risk
42002,558,16,2190.9,1,5,4,10,At Risk
42003,79,17,1982.46,4,5,4,13,Champions
42004,357,12,1453.8799999999999,2,4,3,9,At Risk
42005,143,11,3646.41,4,3,5,12,Loyal
42006,471,11,1429.45,1,3,3,7,Regulars
42007,51,14,1235.6399999999999,5,5,2,12,Loyal
42008,96,6,586.0699999999999,4,1,1,6,Regulars
42009,523,8,666.11,1,2,1,4,Hibernating
42010,458,12,1819.9,2,4,4,10,At Risk
42011,251,11,1328.1299999999999,2,3,3,8,Regulars
42012,321,9,601.38,2,2,1,5,Hibernating
42013,363,8,519.15,2,2,1,5,Hibernating
42014,194,14,881.4499999999999,3,5,2,10,Regulars
42015,545,11,4646.54,1,3,5,9,Regulars
42016,273,11,3402.6400000000003,2,3,5,10,Regulars
42017,214,11,826.35,3,3,1,7,Regulars
42018,488,7,940.17,1,1,2,4,Hibernating
42019,192,11,2093.09,3,3,4,10,Big Spenders
42020,265,10,1054.71,2,3,2,7,Regulars
42021,186,6,2103.49,3,1,4,8,Big Spenders
42022,251,16,1602.07,2,5,3,10,At Risk
42023,170,8,450.5,3,2,1,6,Regulars
42024,68,13,1187.11,4,4,2,10,Loyal
42025,566,8,2329.27,1,2,4,7,Regulars
42026,33,7,1369.1399999999999,5,1,3,9,Regulars
42027,180,17,2887.7,3,5,5,13,Big Spenders
42028,20,16,3308.0499999999997,5,5,5,15,Champions
42029,221,16,1003.69,3,5,2,10,Regulars
42030,762,5,864.26,1,1,2,4,Hibernating
42031,344,10,1779.43,2,3,4,9,Regulars
42032,963,10,1291.58,1,3,3,7,Regulars
42033,48,13,1973.77,5,4,4,13,Champions
42034,288,10,1700.92,2,3,3,8,Regulars
42035,448,10,2442.8999999999996,2,3,4,9,Regulars
42036,97,11,1279.77,4,3,3,10,Loyal
42037,131,13,3806.34,4,4,5,13,Champions
42038,333,11,2037.42,2,3,4,9,Regulars
42039,518,13,1285.29,1,4,3,8,At Risk
42040,495,11,1473.19,1,3,3,7,Regulars
42041,412,7,1174.73,2,1,2,5,Hibernating
42042,239,14,1781.43,3,5,4,12,Big Spenders
42043,192,7,554.96,3,1,1,5,Regulars
42044,174,8,722.4,3,2,1,6,Regulars
42045,128,12,4547.03,4,4,5,13,Champions
42046,776,11,1672.71,1,3,3,7,Regulars
42047,273,13,3098.84,2,4,5,11,At Risk
42048,999,7,934.1700000000001,1,1,2,4,Hibernating
42049,238,10,1918.66,3,3,4,10,Big Spenders
42050,37,14,2086.04,5,5,4,14,Champions
42051,1056,6,506.30999999999995,1,1,1,3,Hibernating
42052,22,7,748.97,5,1,1,7,Regulars
42053,930,7,1048.77,1,1,2,4,Hibernating
42054,790,6,602.77,1,1,1,3,Hibernating
42055,101,11,1605.31,4,3,3,10,Loyal
42056,44,5,924.02,5,1,2,8,Regulars
42057,215,13,2411.2799999999997,3,4,4,11,Big Spenders
42058,610,7,1272.21,1,1,3,5,Regulars
42059,632,8,1330.51,1,2,3,6,Regulars
42060,243,10,1520.82,3,3,3,9,Regulars
42061,127,8,2572.5699999999997,4,2,4,10,Big Spenders
42062,437,10,983.89,2,3,2,7,Regulars
42063,444,9,1008.2,2,2,2,6,Hibernating
42064,348,12,3096.41,2,4,5,11,At Risk
42065,59,10,1828.69,5,3,4,12,Loyal
42066,139,5,408.03000000000003,4,1,1,6,Regulars
42067,7,7,1517.3400000000001,5,1,3,9,Regulars
42068,138,13,1509.51,4,4,3,11,Loyal
42069,252,14,4469.33,2,5,5,12,At Risk
42070,110,12,2745.97,4,4,5,13,Champions
42071,55,14,2452.4500000000003,5,5,4,14,Champions
42072,385,9,770.24,2,2,1,5,Hibernating
42073,171,14,5676.64,3,5,5,13,Big Spenders
42074,407,11,1528.53,2,3,3,8,Regulars
42075,55,7,2331.24,5,1,4,10,Big Spenders
42076,523,7,1036.62,1,1,2,4,Hibernating
42077,222,14,1769.3799999999999,3,5,4,12,Big Spenders
42078,559,11,2792.02,1,3,5,9,Regulars
42079,285,14,2885.5099999999998,2,5,5,12,At Risk
42080,55,8,578.06,5,2,1,8,Regulars
42081,156,11,922.9499999999999,3,3,2,8,Regulars
42082,64,12,1393.66,5,4,3,12,Loyal
42083,58,13,819.36,5,4,1,10,Loyal
42084,168,12,1843.06,3,4,4,11,Big Spenders
42085,69,14,1062.1299999999999,4,5,2,11,Loyal
42086,166,8,699.95,3,2,1,6,Regulars
42087,118,18,2752.9500000000003,4,5,5,14,Champions
42088,205,8,562.01,3,2,1,6,Regulars
42089,339,13,2272.66,2,4,4,10,At Risk
42090,39,6,629.06,5,1,1,7,Regulars
42091,322,15,2966.4300000000003,2,5,5,12,At Risk
42092,9,11,952.73,5,3,2,10,Loyal
42093,191,8,572.74,3,2,1,6,Regulars
42094,467,9,1149.79,1,2,2,5,Hibernating
42095,48,17,3396.02,5,5,5,15,Champions
42096,295,9,748.52,2,2,1,5,Hibernating
42097,35,5,471.94000000000005,5,1,1,7,Regulars
42098,282,9,947.87,2,2,2,6,Hibernating
42099,905,4,1544.75,1,1,3,5,Regulars
42100,744,7,294.53999999999996,1,1,1,3,Hibernating
42101,139,8,935.84,4,2,2,8,Regulars
42102,205,9,2343.95,3,2,4,9,Big Spenders
42103,195,10,1079.14,3,3,2,8,Regulars
42104,234,12,2586.02,3,4,5,12,Big Spenders
42105,45,13,2673.06,5,4,5,14,Champions
42106,202,11,2600.58,3,3,5,11,Big Spenders
42107,391,13,2251.77,2,4,4,10,At Risk
42108,514,8,1073.47,1,2,2,5,Hibernating
42109,925,7,482.58000000000004,1,1,1,3,Hibernating
42110,346,10,1366.06,2,3,3,8,Regulars
42111,207,11,1261.44,3,3,3,9,Regulars
42112,899,13,2881.8399999999997,1,4,5,10,At Risk
42113,482,9,1445.1000000000001,1,2,3,6,Regulars
42114,150,12,2073.57,3,4,4,11,Big Spenders
42115,12,16,2250.3999999999996,5,5,4,14,Champions
42116,663,12,1206.31,1,4,2,7,At Risk
42117,821,7,1156.48,1,1,2,4,Hibernating
42118,172,17,1155.94,3,5,2,10,Regulars
42119,1463,10,976.97,1,3,2,6,Regulars
42120,55,8,3052.56,5,2,5,12,Big Spenders
42121,251,9,988.9900000000001,2,2,2,6,Hibernating
42122,40,15,4381.17,5,5,5,15,Champions
42123,940,6,594.84,1,1,1,3,Hibernating
42124,65,14,2329.38,5,5,4,14,Champions
42125,263,11,1557.6499999999999,2,3,3,8,Regulars
42126,109,12,4114.75,4,4,5,13,Champions
42127,135,7,454.34999999999997,4,1,1,6,Regulars
42128,166,14,1522.5500000000002,3,5,3,11,Regulars
42129,631,14,1175.17,1,5,2,8,At Risk
42130,28,15,3568.54,5,5,5,15,Champions
42131,44,6,3316.9300000000003,5,1,5,11,Big Spenders
42132,53,10,620.55,5,3,1,9,Loyal
42133,30,9,1648.35,5,2,3,10,Regulars
42134,107,12,1664.22,4,4,3,11,Loyal
42135,27,7,606.3199999999999,5,1,1,7,Regulars
42136,239,14,2916.0,3,5,5,13,Big Spenders
42137,1089,10,681.48,1,3,1,5,Regulars
42138,114,8,756.57,4,2,1,7,Regulars
42139,82,16,1894.69,4,5,4,13,Champions
42140,231,9,677.92,3,2,1,6,Regulars
42141,365,8,997.3100000000001,2,2,2,6,Hibernating
42142,54,13,1443.07,5,4,3,12,Loyal
42143,38,10,2577.48,5,3,5,13,Loyal
42144,92,8,862.87,4,2,2,8,Regulars
42145,502,8,2035.12,1,2,4,7,Regulars
42146,278,12,2638.26,2,4,5,11,At Risk
42147,294,11,2972.74,2,3,5,10,Regulars
42148,330,15,2203.88,2,5,4,11,At Risk
42149,388,13,4774.049999999999,2,4,5,11,At Risk
42150,169,11,1953.1000000000001,3,3,4,10,Big Spenders
42151,65,19,2765.15,5,5,5,15,Champions
42152,122,11,1076.47,4,3,2,9,Loyal
42153,365,19,2463.91,2,5,4,11,At Risk
42154,118,10,4199.27,4,3,5,12,Loyal
42155,131,12,1730.18,4,4,4,12,Champions
42156,298,6,539.6999999999999,2,1,1,4,Hibernating
42157,564,6,1655.21,1,1,3,5,Regulars
42158,601,9,1391.74,1,2,3,6,Regulars
42159,145,10,2281.6899999999996,4,3,4,11,Loyal
42160,100,7,1171.94,4,1,2,7,Regulars
42161,45,10,1462.5,5,3,3,11,Loyal
42162,118,11,806.81,4,3,1,8,Loyal
42163,199,8,903.29,3,2,2,7,Regulars
42164,38,9,970.69,5,2,2,9,Regulars
42165,1166,5,555.09,1,1,1,3,Hibernating
42166,173,12,2907.27,3,4,5,12,Big Spenders
42167,322,8,631.87,2,2,1,5,Hibernating
42168,234,12,3226.19,3,4,5,12,Big Spenders
42169,128,10,1223.85,4,3,2,9,Loyal
42170,407,14,1478.27,2,5,3,10,At Risk
42171,789,6,1859.51,1,1,4,6,Regulars
42172,71,9,893.05,4,2,2,8,Regulars
42173,896,13,2437.5099999999998,1,4,4,9,At Risk
42174,251,13,2346.23,2,4,4,10,At Risk
42175,512,9,1984.54,1,2,4,7,Regulars
42176,245,5,1503.83,3,1,3,7,Regulars
42177,260,11,1538.3500000000001,2,3,3,8,Regulars
42178,90,11,1256.29,4,3,3,10,Loyal
42179,192,17,2754.0,3,5,5,13,Big Spenders
42180,213,17,4752.48,3,5,5,13,Big Spenders
42181,405,10,1347.4299999999998,2,3,3,8,Regulars
42182,442,11,5248.43,2,3,5,10,Regulars
42183,1252,6,2126.19,1,1,4,6,Regulars
42184,16,17,3127.4500000000003,5,5,5,15,Champions
42185,148,15,2228.4700000000003,3,5,4,12,Big Spenders
42186,39,6,1077.14,5,1,2,8,Regulars
42187,119,9,2783.07,4,2,5,11,Big Spenders
42188,455,8,1036.96,2,2,2,6,Hibernating
42189,353,9,2260.98,2,2,4,8,Regulars
42190,531,10,818.13,1,3,1,5,Regulars
42191,144,13,1488.76,4,4,3,11,Loyal
42192,45,14,1305.05,5,5,3,13,Loyal
42193,17,8,740.83,5,2,1,8,Regulars
42194,545,14,1688.6200000000001,1,5,3,9,At Risk
42195,111,11,2184.63,4,3,4,11,Loyal
42196,1076,8,4940.96,1,2,5,8,Regulars
42197,589,13,2259.54,1,4,4,9,At Risk
42198,192,13,2663.23,3,4,5,12,Big Spenders
42199,3,9,895.5,5,2,2,9,Regulars
42200,324,7,769.78,2,1,1,4,Hibernating
42201,110,11,3042.44,4,3,5,12,Loyal
42202,329,9,808.76,2,2,1,5,Hibernating
42203,937,10,976.89,1,3,2,6,Regulars
42204,196,1,115.14,3,1,1,5,Regulars
42205,84,10,2699.8399999999997,4,3,5,12,Loyal
42206,96,11,1095.65,4,3,2,9,Loyal
42207,713,10,887.29,1,3,2,6,Regulars
42208,18,7,1204.08,5,1,2,8,Regulars
42209,282,14,1465.8700000000001,2,5,3,10,At Risk
42210,165,9,2824.5,3,2,5,10,Big Spenders
42211,673,9,1012.16,1,2,2,5,Hibernating
42212,555,8,2895.37,1,2,5,8,Regulars
42213,12,9,718.04,5,2,1,8,Regulars
42214,130,12,2758.21,4,4,5,13,Champions
42215,1284,5,346.46,1,1,1,3,Hibernating
42216,45,8,1957.3400000000001,5,2,4,11,Big Spenders
42217,71,9,4580.11,4,2,5,11,Big Spenders
42218,351,9,2519.57,2,2,4,8,Regulars
42219,536,10,1256.06,1,3,3,7,Regulars
42220,91,7,1341.3000000000002,4,1,3,8,Regulars
42221,296,14,1230.1599999999999,2,5,2,9,At Risk
42222,29,11,990.95,5,3,2,10,Loyal
42223,16,8,943.34,5,2,2,9,Regulars
42224,206,11,1636.32,3,3,3,9,Regulars
42225,156,11,1330.0800000000002,3,3,3,9,Regulars
42226,245,15,1669.01,3,5,3,11,Regulars
42227,1046,11,530.94,1,3,1,5,Regulars
42228,230,14,2451.96,3,5,4,12,Big Spenders
42229,274,10,3404.39,2,3,5,10,Regulars
42230,369,10,913.24,2,3,2,7,Regulars
42231,384,9,1048.94,2,2,2,6,Hibernating
42232,214,10,864.1600000000001,3,3,2,8,Regulars
42233,77,13,1832.55,4,4,4,12,Champions
42234,679,9,704.0899999999999,1,2,1,4,Hibernating
42235,42,11,1489.02,5,3,3,11,Loyal
42236,50,10,423.82,5,3,1,9,Loyal
42237,315,8,1312.23,2,2,3,7,Regulars
42238,487,6,475.44000000000005,1,1,1,3,Hibernating
42239,60,13,1983.83,5,4,4,13,Champions
42240,607,9,650.45,1,2,1,4,Hibernating
42241,39,12,1611.59,5,4,3,12,Loyal
42242,235,12,2940.3,3,4,5,12,Big Spenders
42243,448,10,3316.03,2,3,5,10,Regulars
42244,165,11,1641.26,3,3,3,9,Regulars
42245,644,10,3363.43,1,3,5,9,Regulars
42246,116,7,1146.57,4,1,2,7,Regulars
42247,379,11,1225.21,2,3,2,7,Regulars
42248,109,13,6558.200000000001,4,4,5,13,Champions
42249,209,11,1250.41,3,3,3,9,Regulars
42250,302,6,1359.14,2,1,3,6,Regulars
42251,189,14,1242.65,3,5,3,11,Regulars
42252,95,12,1228.53,4,4,2,10,Loyal
42253,45,11,1213.8,5,3,2,10,Loyal
42254,1001,9,897.79,1,2,2,5,Hibernating
42255,361,10,1395.77,2,3,3,8,Regulars
42256,596,12,2498.81,1,4,4,9,At Risk
42257,369,12,1869.78,2,4,4,10,At Risk
42258,2,17,3678.56,5,5,5,15,Champions
42259,78,10,1481.84,4,3,3,10,Loyal
42260,577,4,689.9499999999999,1,1,1,3,Hibernating
42261,4,13,787.04,5,4,1,10,Loyal
42262,392,9,3233.99,2,2,5,9,Regulars
42263,362,10,1577.94,2,3,3,8,Regulars
42264,59,8,758.88,5,2,1,8,Regulars
42265,1318,5,648.04,1,1,1,3,Hibernating
42266,350,7,1225.8200000000002,2,1,2,5,Hibernating
42267,124,12,1903.1499999999999,4,4,4,12,Champions
42268,32,9,2176.11,5,2,4,11,Big Spenders
42269,308,11,2014.23,2,3,4,9,Regulars
42270,58,14,1625.94,5,5,3,13,Loyal
42271,179,9,698.82,3,2,1,6,Regulars
42272,824,7,1189.09,1,1,2,4,Hibernating
42273,147,13,1307.54,4,4,3,11,Loyal
42274,311,8,748.1700000000001,2,2,1,5,Hibernating
42275,174,10,1345.3999999999999,3,3,3,9,Regulars
42276,131,9,1080.87,4,2,2,8,Regulars
42277,109,10,2492.6800000000003,4,3,4,11,Loyal
42278,35,10,1378.06,5,3,3,11,Loyal
42279,46,12,1120.19,5,4,2,11,Loyal
42280,683,6,376.12,1,1,1,3,Hibernating
42281,561,9,1418.51,1,2,3,6,Regulars
42282,215,10,1456.12,3,3,3,9,Regulars
42283,281,10,1016.64,2,3,2,7,Regulars
42284,499,7,1035.3,1,1,2,4,Hibernating
42285,398,7,3132.62,2,1,5,8,Regulars
42286,124,10,2549.95,4,3,4,11,Loyal
42287,68,11,1958.3000000000002,4,3,4,11,Loyal
42288,1617,8,1930.8600000000001,1,2,4,7,Regulars
42289,262,10,1448.89,2,3,3,8,Regulars
42290,213,8,1642.71,3,2,3,8,Regulars
42291,4,11,1332.82,5,3,3,11,Loyal
42292,30,7,209.7,5,1,1,7,Regulars
42293,172,10,1816.8700000000001,3,3,4,10,Big Spenders
42294,23,12,1899.8799999999999,5,4,4,13,Champions
42295,302,9,1859.27,2,2,4,8,Regulars
42296,57,15,3462.6600000000003,5,5,5,15,Champions
42297,119,7,2095.86,4,1,4,9,Big Spenders
42298,189,10,1059.19,3,3,2,8,Regulars
42299,149,12,1755.4599999999998,3,4,4,11,Big Spenders
42300,305,8,870.0899999999999,2,2,2,6,Hibernating
42301,90,10,1092.52,4,3,2,9,Loyal
42302,395,7,442.39,2,1,1,4,Hibernating
42303,380,14,2356.1,2,5,4,11,At Risk
42304,1337,7,526.06,1,1,1,3,Hibernating
42305,181,11,1420.03,3,3,3,9,Regulars
42306,409,10,1101.51,2,3,2,7,Regulars
42307,302,10,3968.72,2,3,5,10,Regulars
42308,477,10,1478.16,1,3,3,7,Regulars
42309,214,8,1136.9,3,2,2,7,Regulars
42310,111,14,979.37,4,5,2,11,Loyal
42311,84,18,2759.63,4,5,5,14,Champions
42312,772,12,2106.71,1,4,4,9,At Risk
42313,27,12,4077.61,5,4,5,14,Champions
42314,301,6,2064.86,2,1,4,7,Regulars
42315,21,10,617.89,5,3,1,9,Loyal
42316,7,14,3404.63,5,5,5,15,Champions
42317,203,14,961.85,3,5,2,10,Regulars
42318,195,10,2261.7200000000003,3,3,4,10,Big Spenders
42319,399,13,1587.84,2,4,3,9,At Risk
42320,504,10,968.34,1,3,2,6,Regulars
42321,149,9,771.69,3,2,1,6,Regulars
42322,384,10,1334.75,2,3,3,8,Regulars
42323,829,7,2072.59,1,1,4,6,Regulars
42324,283,12,5604.09,2,4,5,11,At Risk
42325,407,10,412.53,2,3,1,6,Regulars
42326,371,6,1676.6000000000001,2,1,3,6,Regulars
42327,523,10,1242.52,1,3,3,7,Regulars
42328,156,14,1344.3799999999999,3,5,3,11,Regulars
42329,55,15,1838.13,5,5,4,14,Champions
42330,142,14,2373.15,4,5,4,13,Champions
42331,542,14,4587.46,1,5,5,11,At Risk
42332,564,5,335.86,1,1,1,3,Hibernating
42333,403,12,1981.39,2,4,4,10,At Risk
42334,95,7,704.23,4,1,1,6,Regulars
42335,38,12,2023.03,5,4,4,13,Champions
42336,60,8,1066.74,5,2,2,9,Regulars
42337,161,15,1204.42,3,5,2,10,Regulars
42338,513,10,1062.41,1,3,2,6,Regulars
42339,94,11,956.83,4,3,2,9,Loyal
42340,131,16,4176.67,4,5,5,14,Champions
42341,66,13,957.48,4,4,2,10,Loyal
42342,83,13,1850.23,4,4,4,12,Champions
42343,869,10,1562.55,1,3,3,7,Regulars
42344,441,6,543.54,2,1,1,4,Hibernating
42345,314,10,638.58,2,3,1,6,Regulars
42346,1640,5,912.84,1,1,2,4,Hibernating
42347,41,8,1051.92,5,2,2,9,Regulars
42348,94,6,494.4,4,1,1,6,Regulars
42349,171,17,2594.24,3,5,5,13,Big Spenders
42350,112,8,1455.58,4,2,3,9,Regulars
42351,14,10,1332.08,5,3,3,11,Loyal
42352,96,12,2944.76,4,4,5,13,Champions
42353,62,10,5087.16,5,3,5,13,Loyal
42354,347,9,671.9499999999999,2,2,1,5,Hibernating
42355,155,6,559.25,3,1,1,5,Regulars
42356,520,12,1465.96,1,4,3,8,At Risk
42357,98,11,8226.77,4,3,5,12,Loyal
42358,797,6,583.34,1,1,1,3,Hibernating
42359,314,7,1099.03,2,1,2,5,Hibernating
42360,135,14,2672.17,4,5,5,14,Champions
42361,124,11,1933.97,4,3,4,11,Loyal
42362,96,10,2426.83,4,3,4,11,Loyal
42363,139,9,3235.0200000000004,4,2,5,11,Big Spenders
42364,487,19,3052.07,1,5,5,11,At Risk
42365,113,11,1105.18,4,3,2,9,Loyal
42366,1018,6,884.34,1,1,2,4,Hibernating
42367,33,11,967.26,5,3,2,10,Loyal
42368,60,8,968.41,5,2,2,9,Regulars
42369,102,9,2190.1,4,2,4,10,Big Spenders
42370,437,12,4558.1,2,4,5,11,At Risk
42371,266,10,1027.48,2,3,2,7,Regulars
42372,22,16,1397.92,5,5,3,13,Loyal
42373,96,11,1598.67,4,3,3,10,Loyal
42374,174,8,1214.68,3,2,2,7,Regulars
42375,130,11,2047.24,4,3,4,11,Loyal
42376,9,11,719.51,5,3,1,9,Loyal
42377,395,8,1262.71,2,2,3,7,Regulars
42378,110,8,3526.8799999999997,4,2,5,11,Big Spenders
42379,107,8,908.9200000000001,4,2,2,8,Regulars
42380,164,6,957.6499999999999,3,1,2,6,Regulars
42381,176,8,1194.3,3,2,2,7,Regulars
42382,238,8,1840.59,3,2,4,9,Big Spenders
42383,258,10,1372.8500000000001,2,3,3,8,Regulars
42384,30,6,5102.21,5,1,5,11,Big Spenders
42385,193,10,1079.43,3,3,2,8,Regulars
42386,103,14,1638.79,4,5,3,12,Loyal
42387,61,14,2290.7200000000003,5,5,4,14,Champions
42388,167,5,758.95,3,1,1,5,Regulars
42389,114,9,810.21,4,2,1,7,Regulars
42390,201,8,2228.95,3,2,4,9,Big Spenders
42391,430,13,1181.52,2,4,2,8,At Risk
42392,10,10,1465.3000000000002,5,3,3,11,Loyal
42393,275,7,1927.4299999999998,2,1,4,7,Regulars
42394,0,9,972.52,5,2,2,9,Regulars
42395,149,11,2766.04,3,3,5,11,Big Spenders
42396,170,9,988.3399999999999,3,2,2,7,Regulars
42397,585,7,757.57,1,1,1,3,Hibernating
42398,32,12,1074.1399999999999,5,4,2,11,Loyal
42399,373,8,848.27,2,2,2,6,Hibernating
42400,327,6,281.12,2,1,1,4,Hibernating
42401,400,11,1200.78,2,3,2,7,Regulars
42402,174,11,2625.29,3,3,5,11,Big Spenders
42403,154,7,604.19,3,1,1,5,Regulars
42404,75,14,1312.23,4,5,3,12,Loyal
42405,109,11,981.1700000000001,4,3,2,9,Loyal
42406,180,12,860.45,3,4,2,9,Regulars
42407,50,11,859.53,5,3,2,10,Loyal
42408,988,4,1855.8100000000002,1,1,4,6,Regulars
42409,221,10,2054.01,3,3,4,10,Big Spenders
42410,48,10,1808.52,5,3,4,12,Loyal
42411,83,13,1501.47,4,4,3,11,Loyal
42412,176,9,1095.67,3,2,2,7,Regulars
42413,125,12,5838.89,4,4,5,13,Champions
42414,350,13,4825.639999999999,2,4,5,11,At Risk
42415,11,11,5739.85,5,3,5,13,Loyal
42416,893,10,981.38,1,3,2,6,Regulars
42417,620,6,1135.03,1,1,2,4,Hibernating
42418,85,14,2668.7200000000003,4,5,5,14,Champions
42419,531,15,3632.1200000000003,1,5,5,11,At Risk
42420,400,13,1489.3899999999999,2,4,3,9,At Risk
42421,751,6,439.71000000000004,1,1,1,3,Hibernating
42422,681,7,2730.3700000000003,1,1,5,7,Regulars
42423,834,12,3114.4700000000003,1,4,5,10,At Risk
42424,696,9,650.71,1,2,1,4,Hibernating
42425,614,11,1110.31,1,3,2,6,Regulars
42426,33,8,1283.3799999999999,5,2,3,10,Regulars
42427,302,13,2763.64,2,4,5,11,At Risk
42428,270,10,629.94,2,3,1,6,Regulars
42429,517,5,735.31,1,1,1,3,Hibernating
42430,29,13,883.3,5,4,2,11,Loyal
42431,65,7,539.86,5,1,1,7,Regulars
42432,91,9,1686.2599999999998,4,2,3,9,Regulars
42433,214,9,1783.37,3,2,4,9,Big Spenders
42434,222,10,1808.1000000000001,3,3,4,10,Big Spenders
42435,421,12,2365.23,2,4,4,10,At Risk
42436,47,7,1130.1200000000001,5,1,2,8,Regulars
42437,109,14,1315.42,4,5,3,12,Loyal
42438,781,5,494.40000000000003,1,1,1,3,Hibernating
42439,124,12,1484.42,4,4,3,11,Loyal
42440,146,11,1374.54,4,3,3,10,Loyal
42441,126,14,1485.6799999999998,4,5,3,12,Loyal
42442,483,13,592.5,1,4,1,6,At Risk
42443,253,14,1154.2,2,5,2,9,At Risk
42444,114,9,480.96999999999997,4,2,1,7,Regulars
42445,148,10,1122.67,3,3,2,8,Regulars
42446,740,13,1402.3200000000002,1,4,3,8,At Risk
42447,276,10,909.9,2,3,2,7,Regulars
42448,1143,5,1208.84,1,1,2,4,Hibernating
42449,132,17,4709.09,4,5,5,14,Champions
42450,93,10,3584.34,4,3,5,12,Loyal
42451,32,10,754.4,5,3,1,9,Loyal
42452,1256,5,383.68,1,1,1,3,Hibernating
42453,258,8,2250.35,2,2,4,8,Regulars
42454,100,12,2334.68,4,4,4,12,Champions
42455,245,10,783.75,3,3,1,7,Regulars
42456,300,11,1544.31,2,3,3,8,Regulars
42457,149,7,728.13,3,1,1,5,Regulars
42458,47,12,1013.29,5,4,2,11,Loyal
42459,251,8,794.46,2,2,1,5,Hibernating
42460,208,13,3395.04,3,4,5,12,Big Spenders
42461,22,6,780.73,5,1,1,7,Regulars
42462,638,8,2615.89,1,2,5,8,Regulars
42463,50,10,1067.96,5,3,2,10,Loyal
42464,348,6,888.2700000000001,2,1,2,5,Hibernating
42465,101,9,1373.02,4,2,3,9,Regulars
42466,414,9,1114.06,2,2,2,6,Hibernating
42467,372,10,2938.27,2,3,5,10,Regulars
42468,45,7,888.0600000000001,5,1,2,8,Regulars
42469,285,7,626.84,2,1,1,4,Hibernating
42470,132,20,1647.09,4,5,3,12,Loyal
42471,195,9,989.0699999999999,3,2,2,7,Regulars
42472,26,14,4787.47,5,5,5,15,Champions
42473,113,11,1344.1399999999999,4,3,3,10,Loyal
42474,233,13,1796.24,3,4,4,11,Big Spenders
42475,226,16,1170.46,3,5,2,10,Regulars
42476,919,12,1017.79,1,4,2,7,At Risk
42477,535,11,1836.5299999999997,1,3,4,8,Regulars
42478,713,6,2132.96,1,1,4,6,Regulars
42479,35,9,872.04,5,2,2,9,Regulars
42480,654,12,2696.69,1,4,5,10,At Risk
42481,149,16,4667.07,3,5,5,13,Big Spenders
42482,4,7,891.1099999999999,5,1,2,8,Regulars
42483,55,11,965.01,5,3,2,10,Loyal
42484,314,11,1509.0900000000001,2,3,3,8,Regulars
42485,219,7,555.93,3,1,1,5,Regulars
42486,196,6,2999.1,3,1,5,9,Big Spenders
42487,35,13,1321.5,5,4,3,12,Loyal
42488,186,7,773.49,3,1,1,5,Regulars
42489,614,10,2775.73,1,3,5,9,Regulars
42490,94,15,1094.6200000000001,4,5,2,11,Loyal
42491,135,11,961.3299999999999,4,3,2,9,Loyal
42492,60,7,1612.8600000000001,5,1,3,9,Regulars
42493,216,8,1302.18,3,2,3,8,Regulars
42494,334,11,1071.75,2,3,2,7,Regulars
42495,113,10,1158.17,4,3,2,9,Loyal
42496,22,11,1415.8,5,3,3,11,Loyal
42497,126,5,577.33,4,1,1,6,Regulars
42498,349,9,1038.19,2,2,2,6,Hibernating
42499,151,10,589.19,3,3,1,7,Regulars
42500,145,15,3422.76,4,5,5,14,Champions
42501,122,7,502.36,4,1,1,6,Regulars
42502,137,13,1141.57,4,4,2,10,Loyal
42503,380,10,1692.01,2,3,3,8,Regulars
42504,659,12,1521.9399999999998,1,4,3,8,At Risk
42505,746,9,1120.53,1,2,2,5,Hibernating
42506,12,11,990.27,5,3,2,10,Loyal
42507,62,11,3537.3,5,3,5,13,Loyal
42508,180,9,868.71,3,2,2,7,Regulars
42509,126,12,2568.67,4,4,4,12,Champions
42510,205,10,1057.59,3,3,2,8,Regulars
42511,242,12,1333.44,3,4,3,10,Regulars
42512,261,8,852.49,2,2,2,6,Hibernating
42513,361,10,3468.25,2,3,5,10,Regulars
42514,167,11,1101.1,3,3,2,8,Regulars
42515,1260,5,2012.03,1,1,4,6,Regulars
42516,52,9,2202.7799999999997,5,2,4,11,Big Spenders
42517,174,9,419.9,3,2,1,6,Regulars
42518,422,9,3653.23,2,2,5,9,Regulars
42519,299,14,880.72,2,5,2,9,At Risk
42520,238,14,3199.24,3,5,5,13,Big Spenders
42521,152,7,1119.55,3,1,2,6,Regulars
42522,329,13,1654.04,2,4,3,9,At Risk
42523,30,11,3283.7999999999997,5,3,5,13,Loyal
42524,310,5,1047.42,2,1,2,5,Hibernating
42525,19,10,1527.96,5,3,3,11,Loyal
42526,571,13,2141.12,1,4,4,9,At Risk
42527,1388,6,197.52999999999997,1,1,1,3,Hibernating
42528,201,13,3582.86,3,4,5,12,Big Spenders
42529,338,7,377.84000000000003,2,1,1,4,Hibernating
42530,221,9,1394.3600000000001,3,2,3,8,Regulars
42531,490,5,576.45,1,1,1,3,Hibernating
42532,500,6,603.36,1,1,1,3,Hibernating
42533,399,8,2003.1499999999999,2,2,4,8,Regulars
42534,167,8,933.43,3,2,2,7,Regulars
42535,287,9,1324.05,2,2,3,7,Regulars
42536,67,7,838.52,4,1,1,6,Regulars
42537,66,13,2898.9100000000003,4,4,5,13,Champions
42538,261,14,2650.98,2,5,5,12,At Risk
42539,104,9,792.5400000000001,4,2,1,7,Regulars
42540,286,12,5482.59,2,4,5,11,At Risk
42541,15,15,1294.7,5,5,3,13,Loyal
42542,725,11,764.8,1,3,1,5,Regulars
42543,148,8,2636.74,3,2,5,10,Big Spenders
42544,532,7,693.84,1,1,1,3,Hibernating
42545,67,9,745.47,4,2,1,7,Regulars
42546,166,10,699.04,3,3,1,7,Regulars
42547,348,12,1908.7,2,4,4,10,At Risk
42548,28,8,782.21,5,2,1,8,Regulars
42549,37,13,4154.93,5,4,5,14,Champions
42550,957,9,856.49,1,2,2,5,Hibernating
42551,301,7,3402.4399999999996,2,1,5,8,Regulars
42552,347,11,883.38,2,3,2,7,Regulars
42553,151,11,2879.29,3,3,5,11,Big Spenders
42554,232,9,1662.25,3,2,3,8,Regulars
42555,72,11,1214.99,4,3,2,9,Loyal
42556,149,8,1280.79,3,2,3,8,Regulars
42557,194,7,641.59,3,1,1,5,Regulars
42558,13,5,985.0899999999999,5,1,2,8,Regulars
42559,76,15,1930.69,4,5,4,13,Champions
42560,382,12,3747.3,2,4,5,11,At Risk
42561,168,12,813.52,3,4,1,8,Regulars
42562,261,13,1695.27,2,4,3,9,At Risk
42563,644,8,1579.63,1,2,3,6,Regulars
42564,126,9,578.11,4,2,1,7,Regulars
42565,130,7,713.58,4,1,1,6,Regulars
42566,92,19,7353.58,4,5,5,14,Champions
42567,390,13,3895.79,2,4,5,11,At Risk
42568,624,3,401.59000000000003,1,1,1,3,Hibernating
42569,1097,6,1093.44,1,1,2,4,Hibernating
42570,184,5,392.44,3,1,1,5,Regulars
42571,713,7,607.39,1,1,1,3,Hibernating
42572,187,11,2935.32,3,3,5,11,Big Spenders
42573,27,3,2187.46,5,1,4,10,Big Spenders
42574,127,12,1385.51,4,4,3,11,Loyal
42575,344,11,2955.84,2,3,5,10,Regulars
42576,16,12,2198.0,5,4,4,13,Champions
42577,6,13,1465.2199999999998,5,4,3,12,Loyal
42578,0,11,2011.3899999999999,5,3,4,12,Loyal
42579,104,9,856.8299999999999,4,2,2,8,Regulars
42580,159,9,1206.61,3,2,2,7,Regulars
42581,203,16,2218.7400000000002,3,5,4,12,Big Spenders
42582,431,13,4421.91,2,4,5,11,At Risk
42583,26,16,4045.69,5,5,5,15,Champions
42584,1036,8,3161.85,1,2,5,8,Regulars
42585,25,11,6639.05,5,3,5,13,Loyal
42586,40,12,937.3,5,4,2,11,Loyal
42587,432,9,1000.94,2,2,2,6,Hibernating
42588,62,16,4072.5699999999997,5,5,5,15,Champions
42589,222,9,1039.66,3,2,2,7,Regulars
42590,220,8,957.8,3,2,2,7,Regulars
42591,52,15,3668.77,5,5,5,15,Champions
42592,31,11,3595.18,5,3,5,13,Loyal
42593,13,9,2724.58,5,2,5,12,Big Spenders
42594,496,8,699.64,1,2,1,4,Hibernating
42595,17,9,1980.8500000000001,5,2,4,11,Big Spenders
42596,229,17,2800.14,3,5,5,13,Big Spenders
42597,199,15,2830.85,3,5,5,13,Big Spenders
42598,196,10,1330.84,3,3,3,9,Regulars
42599,352,8,2236.65,2,2,4,8,Regulars
42600,563,9,1021.5500000000001,1,2,2,5,Hibernating
42601,120,11,3206.55,4,3,5,12,Loyal
42602,127,14,1211.27,4,5,2,11,Loyal
42603,108,13,1945.46,4,4,4,12,Champions
42604,206,6,683.69,3,1,1,5,Regulars
42605,453,10,4837.81,2,3,5,10,Regulars
42606,141,10,1323.53,4,3,3,10,Loyal
42607,160,8,2302.9300000000003,3,2,4,9,Big Spenders
42608,12,19,2815.23,5,5,5,15,Champions
42609,608,13,1649.67,1,4,3,8,At Risk
42610,149,4,536.02,3,1,1,5,Regulars
42611,120,12,2905.98,4,4,5,13,Champions
42612,237,11,1114.49,3,3,2,8,Regulars
42613,123,15,3228.23,4,5,5,14,Champions
42614,176,9,887.7,3,2,2,7,Regulars
42615,238,8,741.0699999999999,3,2,1,6,Regulars
42616,163,10,959.03,3,3,2,8,Regulars
42617,153,14,4919.63,3,5,5,13,Big Spenders
42618,141,22,2563.76,4,5,4,13,Champions
42619,386,7,818.97,2,1,1,4,Hibernating
42620,44,8,1281.91,5,2,3,10,Regulars
42621,2,13,3148.87,5,4,5,14,Champions
42622,387,12,985.5400000000001,2,4,2,8,At Risk
42623,114,6,447.62,4,1,1,6,Regulars
42624,524,8,576.04,1,2,1,4,Hibernating
42625,362,13,1342.3,2,4,3,9,At Risk
42626,15,9,1862.07,5,2,4,11,Big Spenders
42627,19,9,905.51,5,2,2,9,Regulars
42628,115,8,1397.4199999999998,4,2,3,9,Regulars
42629,242,9,1964.74,3,2,4,9,Big Spenders
42630,283,16,1452.0800000000002,2,5,3,10,At Risk
42631,492,11,1191.53,1,3,2,6,Regulars
42632,130,11,1757.45,4,3,4,11,Loyal
42633,53,7,1514.3899999999999,5,1,3,9,Regulars
42634,143,10,517.3,4,3,1,8,Loyal
42635,253,9,1065.96,2,2,2,6,Hibernating
42636,536,6,632.23,1,1,1,3,Hibernating
42637,177,10,586.04,3,3,1,7,Regulars
42638,274,10,2103.43,2,3,4,9,Regulars
42639,63,15,3559.2799999999997,5,5,5,15,Champions
42640,264,12,924.36,2,4,2,8,At Risk
42641,175,10,1412.15,3,3,3,9,Regulars
42642,370,18,1302.81,2,5,3,10,At Risk
42643,419,6,2062.2,2,1,4,7,Regulars
42644,320,12,1662.94,2,4,3,9,At Risk
42645,348,3,232.16999999999996,2,1,1,4,Hibernating
42646,39,11,3574.7200000000003,5,3,5,13,Loyal
42647,92,8,1915.66,4,2,4,10,Big Spenders
42648,419,8,759.37,2,2,1,5,Hibernating
42649,49,9,1559.1599999999999,5,2,3,10,Regulars
42650,990,13,3040.58,1,4,5,10,At Risk
42651,107,14,3252.7,4,5,5,14,Champions
42652,117,4,1560.32,4,1,3,8,Regulars
42653,37,8,3051.47,5,2,5,12,Big Spenders
42654,351,9,1249.84,2,2,3,7,Regulars
42655,251,12,2985.49,2,4,5,11,At Risk
42656,782,10,1904.69,1,3,4,8,Regulars
42657,57,11,1519.27,5,3,3,11,Loyal
42658,376,10,1060.99,2,3,2,7,Regulars
42659,843,8,782.4399999999999,1,2,1,4,Hibernating
42660,1470,6,297.92,1,1,1,3,Hibernating
42661,291,6,658.5799999999999,2,1,1,4,Hibernating
42662,105,11,2734.5,4,3,5,12,Loyal
42663,345,11,580.62,2,3,1,6,Regulars
42664,262,13,1267.74,2,4,3,9,At Risk
42665,21,14,2105.83,5,5,4,14,Champions
42666,88,8,1461.03,4,2,3,9,Regulars
42667,428,7,1339.8,2,1,3,6,Regulars
42668,70,7,1009.55,4,1,2,7,Regulars
42669,160,9,2569.3899999999994,3,2,4,9,Big Spenders
42670,46,10,1886.33,5,3,4,12,Loyal
42671,428,4,287.82,2,1,1,4,Hibernating
42672,23,11,1901.81,5,3,4,12,Loyal
42673,556,10,3511.4000000000005,1,3,5,9,Regulars
42674,584,11,1298.29,1,3,3,7,Regulars
42675,86,9,1770.86,4,2,4,10,Big Spenders
42676,285,6,502.3,2,1,1,4,Hibernating
42677,446,7,1692.3100000000002,2,1,3,6,Regulars
42678,14,12,1618.29,5,4,3,12,Loyal
42679,934,12,1733.09,1,4,4,9,At Risk
42680,162,12,1386.97,3,4,3,10,Regulars
42681,104,6,1178.42,4,1,2,7,Regulars
42682,0,11,1468.72,5,3,3,11,Loyal
42683,551,8,711.03,1,2,1,4,Hibernating
42684,332,8,1595.1,2,2,3,7,Regulars
42685,31,11,1100.05,5,3,2,10,Loyal
42686,158,14,3421.83,3,5,5,13,Big Spenders
42687,150,16,3039.6699999999996,3,5,5,13,Big Spenders
42688,218,10,3906.52,3,3,5,11,Big Spenders
42689,34,13,1364.63,5,4,3,12,Loyal
42690,555,9,1034.6299999999999,1,2,2,5,Hibernating
42691,16,10,721.02,5,3,1,9,Loyal
42692,450,11,3272.49,2,3,5,10,Regulars
42693,440,8,660.89,2,2,1,5,Hibernating
42694,408,10,1682.12,2,3,3,8,Regulars
42695,197,17,3170.15,3,5,5,13,Big Spenders
42696,227,12,2676.05,3,4,5,12,Big Spenders
42697,183,8,806.0799999999999,3,2,1,6,Regulars
42698,763,8,658.59,1,2,1,4,Hibernating
42699,68,8,1138.9,4,2,2,8,Regulars
42700,495,11,2205.5,1,3,4,8,Regulars
42701,262,14,1462.95,2,5,3,10,At Risk
42702,273,10,924.29,2,3,2,7,Regulars
42703,176,14,2854.39,3,5,5,13,Big Spenders
42704,437,8,551.66,2,2,1,5,Hibernating
42705,621,14,3478.2200000000003,1,5,5,11,At Risk
42706,189,14,1648.83,3,5,3,11,Regulars
42707,365,10,3607.3599999999997,2,3,5,10,Regulars
42708,114,11,1014.0,4,3,2,9,Loyal
42709,248,12,1241.49,2,4,3,9,At Risk
42710,124,10,2434.0299999999997,4,3,4,11,Loyal
42711,168,16,1905.6100000000001,3,5,4,12,Big Spenders
42712,280,10,1925.22,2,3,4,9,Regulars
42713,48,8,1335.67,5,2,3,10,Regulars
42714,310,9,4001.6,2,2,5,9,Regulars
42715,78,9,2383.76,4,2,4,10,Big Spenders
42716,44,11,1722.96,5,3,3,11,Loyal
42717,218,11,2852.28,3,3,5,11,Big Spenders
42718,43,11,2468.8399999999997,5,3,4,12,Loyal
42719,114,11,1374.34,4,3,3,10,Loyal
42720,868,11,4184.860000000001,1,3,5,9,Regulars
42721,232,5,577.47,3,1,1,5,Regulars
42722,160,15,4812.9,3,5,5,13,Big Spenders
42723,396,11,1622.27,2,3,3,8,Regulars
42724,494,13,3281.21,1,4,5,10,At Risk
42725,75,10,908.1899999999999,4,3,2,9,Loyal
42726,525,6,2044.82,1,1,4,6,Regulars
42727,521,5,795.61,1,1,1,3,Hibernating
42728,225,15,3149.5,3,5,5,13,Big Spenders
42729,544,10,3491.21,1,3,5,9,Regulars
42730,292,15,1858.3,2,5,4,11,At Risk
42731,286,12,1572.55,2,4,3,9,At Risk
42732,169,8,1406.65,3,2,3,8,Regulars
42733,208,13,1681.3799999999999,3,4,3,10,Regulars
42734,554,5,452.06,1,1,1,3,Hibernating
42735,470,7,845.26,1,1,2,4,Hibernating
42736,274,8,2446.2200000000003,2,2,4,8,Regulars
42737,400,10,3155.0800000000004,2,3,5,10,Regulars
42738,15,17,4335.37,5,5,5,15,Champions
42739,464,8,1375.97,1,2,3,6,Regulars
42740,95,9,2811.42,4,2,5,11,Big Spenders
42741,303,14,1724.0,2,5,3,10,At Risk
42742,302,10,1421.4,2,3,3,8,Regulars
42743,7,10,1615.72,5,3,3,11,Loyal
42744,50,16,6646.45,5,5,5,15,Champions
42745,121,9,675.6800000000001,4,2,1,7,Regulars
42746,30,6,664.27,5,1,1,7,Regulars
42747,640,4,228.8,1,1,1,3,Hibernating
42748,382,9,1026.8,2,2,2,6,Hibernating
42749,531,10,2751.53,1,3,5,9,Regulars
42750,389,8,2031.3600000000001,2,2,4,8,Regulars
42751,534,10,896.38,1,3,2,6,Regulars
42752,126,6,2010.45,4,1,4,9,Big Spenders
42753,0,11,877.99,5,3,2,10,Loyal
42754,167,14,1618.1100000000001,3,5,3,11,Regulars
42755,97,13,2678.06,4,4,5,13,Champions
42756,59,8,2626.15,5,2,5,12,Big Spenders
42757,191,8,786.59,3,2,1,6,Regulars
42758,228,7,2407.3799999999997,3,1,4,8,Big Spenders
42759,362,14,1429.8899999999999,2,5,3,10,At Risk
42760,88,8,490.56,4,2,1,7,Regulars
42761,203,7,1729.18,3,1,4,8,Big Spenders
42762,263,10,2246.86,2,3,4,9,Regulars
42763,139,14,964.41,4,5,2,11,Loyal
42764,124,9,1128.96,4,2,2,8,Regulars
42765,370,15,2668.88,2,5,5,12,At Risk
42766,142,12,1187.8799999999999,4,4,2,10,Loyal
42767,135,9,1468.11,4,2,3,9,Regulars
42768,240,10,3404.91,3,3,5,11,Big Spenders
42769,157,14,3089.45,3,5,5,13,Big Spenders
42770,350,5,571.85,2,1,1,4,Hibernating
42771,638,10,1968.42,1,3,4,8,Regulars
42772,464,9,1725.47,1,2,4,7,Regulars
42773,341,11,2975.22,2,3,5,10,Regulars
42774,132,14,3861.96,4,5,5,14,Champions
42775,322,10,1432.38,2,3,3,8,Regulars
42776,22,14,2350.34,5,5,4,14,Champions
42777,1529,4,263.35,1,1,1,3,Hibernating
42778,134,10,3637.41,4,3,5,12,Loyal
42779,39,13,863.9,5,4,2,11,Loyal
42780,129,7,1923.92,4,1,4,9,Big Spenders
42781,395,11,893.45,2,3,2,7,Regulars
42782,84,15,2546.44,4,5,4,13,Champions
42783,162,8,745.14,3,2,1,6,Regulars
42784,969,7,1887.69,1,1,4,6,Regulars
42785,191,9,2254.77,3,2,4,9,Big Spenders
42786,181,10,2147.35,3,3,4,10,Big Spenders
42787,284,8,968.9499999999999,2,2,2,6,Hibernating
42788,2,18,2503.61,5,5,4,14,Champions
42789,272,12,1168.15,2,4,2,8,At Risk
42790,375,12,1226.46,2,4,2,8,At Risk
42791,667,10,1827.01,1,3,4,8,Regulars
42792,176,11,2506.04,3,3,4,10,Big Spenders
42793,33,9,2712.19,5,2,5,12,Big Spenders
42794,39,11,1082.12,5,3,2,10,Loyal
42795,45,13,1927.15,5,4,4,13,Champions
42796,295,9,759.7900000000001,2,2,1,5,Hibernating
42797,111,13,2135.23,4,4,4,12,Champions
42798,23,10,914.19,5,3,2,10,Loyal
42799,215,7,604.6400000000001,3,1,1,5,Regulars
42800,150,16,4877.4400000000005,3,5,5,13,Big Spenders
42801,883,10,1514.34,1,3,3,7,Regulars
42802,602,11,2595.97,1,3,5,9,Regulars
42803,82,8,1549.49,4,2,3,9,Regulars
42804,21,10,1140.54,5,3,2,10,Loyal
42805,208,8,864.42,3,2,2,7,Regulars
42806,284,10,1606.51,2,3,3,8,Regulars
42807,174,5,748.62,3,1,1,5,Regulars
42808,97,11,1217.6100000000001,4,3,2,9,Loyal
42809,511,12,1530.6599999999999,1,4,3,8,At Risk
42810,713,10,860.7099999999999,1,3,2,6,Regulars
42811,134,8,1505.66,4,2,3,9,Regulars
42812,28,9,2395.98,5,2,4,11,Big Spenders
42813,130,13,2165.62,4,4,4,12,Champions
42814,227,12,1244.77,3,4,3,10,Regulars
42815,94,9,620.8199999999999,4,2,1,7,Regulars
42816,208,10,4247.679999999999,3,3,5,11,Big Spenders
42817,215,7,1238.23,3,1,2,6,Regulars
42818,421,9,2724.37,2,2,5,9,Regulars
42819,285,11,1025.43,2,3,2,7,Regulars
42820,186,13,1733.5500000000002,3,4,4,11,Big Spenders
42821,1612,1,919.3,1,1,2,4,Hibernating
42822,612,14,1808.03,1,5,4,10,At Risk
42823,580,7,1172.23,1,1,2,4,Hibernating
42824,177,13,1597.48,3,4,3,10,Regulars
42825,160,10,1873.1299999999999,3,3,4,10,Big Spenders
42826,472,15,6730.469999999999,1,5,5,11,At Risk
42827,151,11,1415.69,3,3,3,9,Regulars
42828,530,11,1307.6399999999999,1,3,3,7,Regulars
42829,542,9,1147.7600000000002,1,2,2,5,Hibernating
42830,101,12,1049.38,4,4,2,10,Loyal
42831,530,10,1608.4,1,3,3,7,Regulars
42832,917,11,1094.4499999999998,1,3,2,6,Regulars
42833,777,8,4361.34,1,2,5,8,Regulars
42834,146,11,2221.7599999999998,4,3,4,11,Loyal
42835,43,12,1130.52,5,4,2,11,Loyal
42836,373,14,2369.25,2,5,4,11,At Risk
42837,1039,3,164.33999999999997,1,1,1,3,Hibernating
42838,638,13,1185.19,1,4,2,7,At Risk
42839,1065,12,3585.95,1,4,5,10,At Risk
42840,124,15,3915.19,4,5,5,14,Champions
42841,127,9,743.9,4,2,1,7,Regulars
42842,768,7,1178.02,1,1,2,4,Hibernating
42843,130,13,4256.51,4,4,5,13,Champions
42844,18,9,1126.28,5,2,2,9,Regulars
42845,2,15,1958.97,5,5,4,14,Champions
42846,492,10,1847.2,1,3,4,8,Regulars
42847,29,9,1201.05,5,2,2,9,Regulars
42848,1529,8,1644.42,1,2,3,6,Regulars
42849,529,10,4130.38,1,3,5,9,Regulars
42850,56,11,1191.26,5,3,2,10,Loyal
42851,286,12,830.16,2,4,1,7,At Risk
42852,8,13,2873.24,5,4,5,14,Champions
42853,720,9,1253.8899999999999,1,2,3,6,Regulars
42854,54,12,3128.61,5,4,5,14,Champions
42855,366,10,3031.5299999999997,2,3,5,10,Regulars
42856,242,11,726.0899999999999,3,3,1,7,Regulars
42857,32,9,3925.0200000000004,5,2,5,12,Big Spenders
42858,291,11,1373.28,2,3,3,8,Regulars
42859,45,10,833.17,5,3,1,9,Loyal
42860,528,11,2683.71,1,3,5,9,Regulars
42861,78,8,2248.42,4,2,4,10,Big Spenders
42862,549,13,3247.63,1,4,5,10,At Risk
42863,529,12,1069.8899999999999,1,4,2,7,At Risk
42864,244,7,854.88,3,1,2,6,Regulars
42865,166,11,2159.6400000000003,3,3,4,10,Big Spenders
42866,709,13,2147.13,1,4,4,9,At Risk
42867,263,5,460.66,2,1,1,4,Hibernating
42868,69,11,2334.39,4,3,4,11,Loyal
42869,419,7,797.76,2,1,1,4,Hibernating
42870,618,10,3178.8199999999997,1,3,5,9,Regulars
42871,43,9,467.37,5,2,1,8,Regulars
42872,124,12,1860.66,4,4,4,12,Champions
42873,489,8,1000.53,1,2,2,5,Hibernating
42874,836,9,725.5500000000001,1,2,1,4,Hibernating
42875,308,7,1145.0700000000002,2,1,2,5,Hibernating
42876,882,16,1496.69,1,5,3,9,At Risk
42877,19,6,1764.4400000000003,5,1,4,10,Big Spenders
42878,197,13,2277.1099999999997,3,4,4,11,Big Spenders
42879,223,11,1860.6399999999999,3,3,4,10,Big Spenders
42880,105,9,1164.75,4,2,2,8,Regulars
42881,259,10,3493.5,2,3,5,10,Regulars
42882,139,14,1149.51,4,5,2,11,Loyal
42883,277,8,665.3199999999999,2,2,1,5,Hibernating
42884,244,15,2470.06,3,5,4,12,Big Spenders
42885,1002,13,1398.73,1,4,3,8,At Risk
42886,21,12,2966.33,5,4,5,14,Champions
42887,21,10,918.6999999999999,5,3,2,10,Loyal
42888,303,12,1651.8300000000002,2,4,3,9,At Risk
42889,1224,4,600.05,1,1,1,3,Hibernating
42890,818,6,958.39,1,1,2,4,Hibernating
42891,206,15,2347.45,3,5,4,12,Big Spenders
42892,418,13,3481.58,2,4,5,11,At Risk
42893,678,9,695.55,1,2,1,4,Hibernating
42894,244,11,910.31,3,3,2,8,Regulars
42895,335,12,4003.93,2,4,5,11,At Risk
42896,259,12,3232.44,2,4,5,11,At Risk
42897,254,9,1292.65,2,2,3,7,Regulars
42898,41,10,1239.82,5,3,2,10,Loyal
42899,204,9,1020.35,3,2,2,7,Regulars
42900,111,15,2705.15,4,5,5,14,Champions
42901,199,8,2838.48,3,2,5,10,Big Spenders
42902,691,7,922.65,1,1,2,4,Hibernating
42903,377,7,765.97,2,1,1,4,Hibernating
42904,335,9,825.67,2,2,1,5,Hibernating
42905,795,7,663.8100000000001,1,1,1,3,Hibernating
42906,871,6,408.80999999999995,1,1,1,3,Hibernating
42907,651,7,684.17,1,1,1,3,Hibernating
42908,372,15,1604.87,2,5,3,10,At Risk
42909,327,16,2147.86,2,5,4,11,At Risk
42910,42,12,1758.29,5,4,4,13,Champions
42911,73,15,1018.82,4,5,2,11,Loyal
42912,91,11,2221.42,4,3,4,11,Loyal
42913,12,10,1223.8600000000001,5,3,2,10,Loyal
42914,424,11,1569.55,2,3,3,8,Regulars
42915,20,7,1526.72,5,1,3,9,Regulars
42916,108,13,790.72,4,4,1,9,Loyal
42917,277,12,3781.45,2,4,5,11,At Risk
42918,56,8,986.8100000000001,5,2,2,9,Regulars
42919,517,14,2581.26,1,5,5,11,At Risk
42920,14,9,3093.17,5,2,5,12,Big Spenders
42921,274,11,3007.1499999999996,2,3,5,10,Regulars
42922,142,7,429.64,4,1,1,6,Regulars
42923,256,14,1927.38,2,5,4,11,At Risk
42924,160,10,1357.87,3,3,3,9,Regulars
42925,625,14,1242.47,1,5,3,9,At Risk
42926,29,6,2276.04,5,1,4,10,Big Spenders
42927,148,9,2277.62,3,2,4,9,Big Spenders
42928,59,17,4012.9799999999996,5,5,5,15,Champions
42929,81,11,1973.34,4,3,4,11,Loyal
42930,76,17,6794.2,4,5,5,14,Champions
42931,1431,7,1375.29,1,1,3,5,Regulars
42932,858,7,998.8700000000001,1,1,2,4,Hibernating
42933,79,13,1039.8799999999999,4,4,2,10,Loyal
42934,470,12,1749.93,1,4,4,9,At Risk
42935,57,10,2818.81,5,3,5,13,Loyal
42936,185,12,1618.54,3,4,3,10,Regulars
42937,126,9,966.99,4,2,2,8,Regulars
42938,169,8,540.85,3,2,1,6,Regulars
42939,145,9,821.24,4,2,1,7,Regulars
42940,65,9,1384.0,5,2,3,10,Regulars
42941,66,10,1901.45,4,3,4,11,Loyal
42942,205,15,1676.47,3,5,3,11,Regulars
42943,656,10,1390.83,1,3,3,7,Regulars
42944,398,4,184.29999999999998,2,1,1,4,Hibernating
42945,663,10,2662.17,1,3,5,9,Regulars
42946,253,11,2090.2,2,3,4,9,Regulars
42947,2,10,2729.1800000000003,5,3,5,13,Loyal
42948,74,15,3016.6099999999997,4,5,5,14,Champions
42949,79,6,1868.64,4,1,4,9,Big Spenders
42950,336,9,1065.97,2,2,2,6,Hibernating
42951,106,10,1352.72,4,3,3,10,Loyal
42952,241,7,856.63,3,1,2,6,Regulars
42953,174,9,2029.5,3,2,4,9,Big Spenders
42954,770,8,2940.3799999999997,1,2,5,8,Regulars
42955,1157,6,327.74,1,1,1,3,Hibernating
42956,388,9,501.75,2,2,1,5,Hibernating
42957,521,10,896.22,1,3,2,6,Regulars
42958,307,5,757.73,2,1,1,4,Hibernating
42959,305,5,601.95,2,1,1,4,Hibernating
42960,138,15,2216.44,4,5,4,13,Champions
42961,571,14,941.87,1,5,2,8,At Risk
42962,41,10,1688.32,5,3,3,11,Loyal
42963,283,16,1949.19,2,5,4,11,At Risk
42964,300,8,1153.5,2,2,2,6,Hibernating
42965,108,13,2164.87,4,4,4,12,Champions
42966,37,11,1264.32,5,3,3,11,Loyal
42967,138,10,3066.24,4,3,5,12,Loyal
42968,225,12,1807.76,3,4,4,11,Big Spenders
42969,73,10,3631.97,4,3,5,12,Loyal
42970,669,5,638.1,1,1,1,3,Hibernating
42971,390,11,2056.19,2,3,4,9,Regulars
42972,13,10,845.0,5,3,2,10,Loyal
42973,206,9,1346.6799999999998,3,2,3,8,Regulars
42974,267,15,2046.1699999999998,2,5,4,11,At Risk
42975,1228,4,306.32,1,1,1,3,Hibernating
42976,27,10,1163.1799999999998,5,3,2,10,Loyal
42977,1206,7,924.18,1,1,2,4,Hibernating
42978,127,8,574.75,4,2,1,7,Regulars
42979,105,10,2927.45,4,3,5,12,Loyal
42980,95,13,3373.53,4,4,5,13,Champions
42981,57,10,1222.34,5,3,2,10,Loyal
42982,284,16,2820.0299999999997,2,5,5,12,At Risk
42983,172,16,4318.61,3,5,5,13,Big Spenders
42984,502,10,1784.19,1,3,4,8,Regulars
42985,60,9,2360.47,5,2,4,11,Big Spenders
42986,323,9,1500.78,2,2,3,7,Regulars
42987,42,12,1525.18,5,4,3,12,Loyal
42988,49,17,1227.81,5,5,2,12,Loyal
42989,23,17,1256.73,5,5,3,13,Loyal
42990,36,10,1162.65,5,3,2,10,Loyal
42991,87,13,1505.01,4,4,3,11,Loyal
42992,17,10,1600.95,5,3,3,11,Loyal
42993,54,9,2491.37,5,2,4,11,Big Spenders
42994,279,10,1527.44,2,3,3,8,Regulars
42995,207,8,3904.54,3,2,5,10,Big Spenders
42996,236,14,3698.4800000000005,3,5,5,13,Big Spenders
42997,131,9,883.61,4,2,2,8,Regulars
42998,480,9,1095.81,1,2,2,5,Hibernating
42999,23,12,1192.47,5,4,2,11,Loyal
43000,184,17,2175.87,3,5,4,12,Big Spenders
43001,1182,8,2052.7599999999998,1,2,4,7,Regulars
43002,24,12,1622.7,5,4,3,12,Loyal
43003,99,11,1594.58,4,3,3,10,Loyal
43004,2,11,1218.05,5,3,2,10,Loyal
43005,1236,4,453.4,1,1,1,3,Hibernating
43006,72,9,1149.6599999999999,4,2,2,8,Regulars
43007,384,7,1596.36,2,1,3,6,Regulars
43008,47,8,3118.21,5,2,5,12,Big Spenders
43009,201,16,4046.81,3,5,5,13,Big Spenders
43010,25,5,753.5899999999999,5,1,1,7,Regulars
43011,388,8,559.09,2,2,1,5,Hibernating
43012,290,11,3589.5499999999997,2,3,5,10,Regulars
43013,715,7,717.07,1,1,1,3,Hibernating
43014,208,13,4727.139999999999,3,4,5,12,Big Spenders
43015,459,10,2829.4900000000002,2,3,5,10,Regulars
43016,97,11,3758.2000000000003,4,3,5,12,Loyal
43017,201,9,1481.6100000000001,3,2,3,8,Regulars
43018,175,8,1433.74,3,2,3,8,Regulars
43019,273,13,1286.84,2,4,3,9,At Risk
43020,566,11,907.98,1,3,2,6,Regulars
43021,120,14,2947.58,4,5,5,14,Champions
43022,140,10,1817.3799999999999,4,3,4,11,Loyal
43023,160,12,1727.4299999999998,3,4,4,11,Big Spenders
43024,147,14,2120.29,4,5,4,13,Champions
43025,865,7,1091.06,1,1,2,4,Hibernating
43026,351,11,2911.36,2,3,5,10,Regulars
43027,51,9,567.14,5,2,1,8,Regulars
43028,271,14,3237.27,2,5,5,12,At Risk
43029,298,7,487.66,2,1,1,4,Hibernating
43030,35,13,1582.86,5,4,3,12,Loyal
43031,178,7,667.5500000000001,3,1,1,5,Regulars
43032,31,11,1203.01,5,3,2,10,Loyal
43033,143,7,1426.6599999999999,4,1,3,8,Regulars
43034,1143,7,995.0,1,1,2,4,Hibernating
43035,440,9,3044.71,2,2,5,9,Regulars
43036,80,16,2066.83,4,5,4,13,Champions
43037,56,14,7858.98,5,5,5,15,Champions
43038,142,7,868.45,4,1,2,7,Regulars
43039,261,5,227.94,2,1,1,4,Hibernating
43040,234,13,1333.0900000000001,3,4,3,10,Regulars
43041,199,14,2380.13,3,5,4,12,Big Spenders
43042,735,15,2855.61,1,5,5,11,At Risk
43043,28,11,1852.6999999999998,5,3,4,12,Loyal
43044,154,7,946.35,3,1,2,6,Regulars
43045,63,10,1501.25,5,3,3,11,Loyal
43046,559,17,1492.81,1,5,3,9,At Risk
43047,263,11,968.6,2,3,2,7,Regulars
43048,174,19,2466.76,3,5,4,12,Big Spenders
43049,410,8,1041.52,2,2,2,6,Hibernating
43050,418,13,1692.4,2,4,3,9,At Risk
43051,7,14,1664.79,5,5,3,13,Loyal
43052,1430,3,589.97,1,1,1,3,Hibernating
43053,795,9,2451.42,1,2,4,7,Regulars
43054,357,11,2185.9,2,3,4,9,Regulars
43055,745,8,731.79,1,2,1,4,Hibernating
43056,1079,11,1279.6599999999999,1,3,3,7,Regulars
43057,12,9,1794.3300000000002,5,2,4,11,Big Spenders
43058,156,6,592.2,3,1,1,5,Regulars
43059,171,14,3841.9999999999995,3,5,5,13,Big Spenders
43060,85,20,2476.74,4,5,4,13,Champions
43061,62,15,1403.67,5,5,3,13,Loyal
43062,42,6,589.91,5,1,1,7,Regulars
43063,221,13,1696.24,3,4,3,10,Regulars
43064,185,10,1372.2,3,3,3,9,Regulars
43065,904,4,270.38,1,1,1,3,Hibernating
43066,213,11,1089.52,3,3,2,8,Regulars
43067,280,6,538.24,2,1,1,4,Hibernating
43068,545,12,1083.67,1,4,2,7,At Risk
43069,97,16,3391.36,4,5,5,14,Champions
43070,574,7,602.7099999999999,1,1,1,3,Hibernating
43071,593,9,787.79,1,2,1,4,Hibernating
43072,204,16,1583.73,3,5,3,11,Regulars
43073,49,16,3228.7900000000004,5,5,5,15,Champions
43074,333,10,2868.29,2,3,5,10,Regulars
43075,168,12,3255.4300000000003,3,4,5,12,Big Spenders
43076,166,14,1987.85,3,5,4,12,Big Spenders
43077,5,16,1971.24,5,5,4,14,Champions
43078,90,10,1070.66,4,3,2,9,Loyal
43079,320,15,1966.31,2,5,4,11,At Risk
43080,35,11,3566.2299999999996,5,3,5,13,Loyal
43081,499,13,1343.6999999999998,1,4,3,8,At Risk
43082,333,9,862.5,2,2,2,6,Hibernating
43083,320,10,2797.37,2,3,5,10,Regulars
43084,39,12,943.6899999999999,5,4,2,11,Loyal
43085,281,5,295.05,2,1,1,4,Hibernating
43086,351,11,1655.51,2,3,3,8,Regulars
43087,18,10,1637.01,5,3,3,11,Loyal
43088,142,6,457.5,4,1,1,6,Regulars
43089,1200,6,529.6899999999999,1,1,1,3,Hibernating
43090,428,11,1047.22,2,3,2,7,Regulars
43091,588,7,860.65,1,1,2,4,Hibernating
43092,185,11,1851.03,3,3,4,10,Big Spenders
43093,362,13,969.98,2,4,2,8,At Risk
43094,238,12,5530.25,3,4,5,12,Big Spenders
43095,157,6,656.14,3,1,1,5,Regulars
43096,209,6,455.04,3,1,1,5,Regulars
43097,259,9,2855.95,2,2,5,9,Regulars
43098,281,11,3958.55,2,3,5,10,Regulars
43099,170,10,1466.17,3,3,3,9,Regulars
43100,891,11,835.72,1,3,1,5,Regulars
43101,72,9,817.01,4,2,1,7,Regulars
43102,961,6,1741.1100000000001,1,1,4,6,Regulars
43103,179,9,1412.1399999999999,3,2,3,8,Regulars
43104,222,11,3161.3999999999996,3,3,5,11,Big Spenders
43105,90,6,1470.06,4,1,3,8,Regulars
43106,26,21,8840.67,5,5,5,15,Champions
43107,878,11,2038.12,1,3,4,8,Regulars
43108,166,12,1430.71,3,4,3,10,Regulars
43109,95,12,3031.19,4,4,5,13,Champions
43110,48,13,2704.3,5,4,5,14,Champions
43111,266,8,2165.58,2,2,4,8,Regulars
43112,44,16,2108.61,5,5,4,14,Champions
43113,645,12,1183.9,1,4,2,7,At Risk
43114,962,5,314.41999999999996,1,1,1,3,Hibernating
43115,94,14,5090.71,4,5,5,14,Champions
43116,501,8,1013.78,1,2,2,5,Hibernating
43117,464,11,2522.7400000000002,1,3,4,8,Regulars
43118,54,12,2079.74,5,4,4,13,Champions
43119,35,13,2177.42,5,4,4,13,Champions
43120,562,11,2424.08,1,3,4,8,Regulars
43121,154,14,2422.5499999999997,3,5,4,12,Big Spenders
43122,10,13,2378.27,5,4,4,13,Champions
43123,295,8,510.31,2,2,1,5,Hibernating
43124,266,14,2038.88,2,5,4,11,At Risk
43125,80,10,1392.6999999999998,4,3,3,10,Loyal
43126,196,13,2051.07,3,4,4,11,Big Spenders
43127,573,14,3072.06,1,5,5,11,At Risk
43128,38,11,1872.88,5,3,4,12,Loyal
43129,215,8,733.98,3,2,1,6,Regulars
43130,101,6,735.74,4,1,1,6,Regulars
43131,42,8,971.3299999999999,5,2,2,9,Regulars
43132,621,12,3170.04,1,4,5,10,At Risk
43133,632,8,624.49,1,2,1,4,Hibernating
43134,298,7,1199.2,2,1,2,5,Hibernating
43135,11,7,899.5900000000001,5,1,2,8,Regulars
43136,2,8,2004.65,5,2,4,11,Big Spenders
43137,96,15,943.25,4,5,2,11,Loyal
43138,139,11,3392.8,4,3,5,12,Loyal
43139,760,7,563.77,1,1,1,3,Hibernating
43140,187,7,1322.8600000000001,3,1,3,7,Regulars
43141,108,7,620.85,4,1,1,6,Regulars
43142,16,6,608.1899999999999,5,1,1,7,Regulars
43143,1383,11,3405.71,1,3,5,9,Regulars
43144,360,10,3388.11,2,3,5,10,Regulars
43145,293,9,1032.72,2,2,2,6,Hibernating
43146,556,7,2943.83,1,1,5,7,Regulars
43147,144,9,2131.43,4,2,4,10,Big Spenders
43148,737,13,1146.54,1,4,2,7,At Risk
43149,12,17,1311.88,5,5,3,13,Loyal
43150,541,7,923.0699999999999,1,1,2,4,Hibernating
43151,388,11,897.03,2,3,2,7,Regulars
43152,162,6,1813.8599999999997,3,1,4,8,Big Spenders
43153,139,10,3497.2700000000004,4,3,5,12,Loyal
43154,394,12,3971.1000000000004,2,4,5,11,At Risk
43155,801,10,1216.67,1,3,2,6,Regulars
43156,125,9,2463.06,4,2,4,10,Big Spenders
43157,264,8,4345.26,2,2,5,9,Regulars
43158,870,5,3328.39,1,1,5,7,Regulars
43159,43,10,1468.41,5,3,3,11,Loyal
43160,290,8,1609.06,2,2,3,7,Regulars
43161,236,9,939.24,3,2,2,7,Regulars
43162,232,9,1230.2,3,2,2,7,Regulars
43163,76,8,1031.38,4,2,2,8,Regulars
43164,326,10,895.65,2,3,2,7,Regulars
43165,47,11,960.79,5,3,2,10,Loyal
43166,54,12,1975.06,5,4,4,13,Champions
43167,374,12,2506.81,2,4,4,10,At Risk
43168,128,10,5364.25,4,3,5,12,Loyal
43169,162,9,867.19,3,2,2,7,Regulars
43170,176,4,268.21000000000004,3,1,1,5,Regulars
43171,161,9,2053.7,3,2,4,9,Big Spenders
43172,149,9,2080.46,3,2,4,9,Big Spenders
43173,248,11,3786.36,2,3,5,10,Regulars
43174,74,10,1061.0500000000002,4,3,2,9,Loyal
43175,27,11,1890.48,5,3,4,12,Loyal
43176,469,9,5625.91,1,2,5,8,Regulars
43177,549,11,1050.68,1,3,2,6,Regulars
43178,113,16,1398.22,4,5,3,12,Loyal
43179,364,8,835.3399999999999,2,2,1,5,Hibernating
43180,482,11,1403.75,1,3,3,7,Regulars
43181,56,15,3479.5499999999997,5,5,5,15,Champions
43182,1008,10,795.0600000000001,1,3,1,5,Regulars
43183,247,14,1139.52,3,5,2,10,Regulars
43184,159,7,924.16,3,1,2,6,Regulars
43185,187,8,2400.0499999999997,3,2,4,9,Big Spenders
43186,8,10,848.5,5,3,2,10,Loyal
43187,325,5,311.83,2,1,1,4,Hibernating
43188,53,13,2707.8700000000003,5,4,5,14,Champions
43189,14,3,162.12999999999997,5,1,1,7,Regulars
43190,97,5,321.47,4,1,1,6,Regulars
43191,399,10,1049.1799999999998,2,3,2,7,Regulars
43192,37,8,1003.05,5,2,2,9,Regulars
43193,593,14,2179.57,1,5,4,10,At Risk
43194,172,12,2160.25,3,4,4,11,Big Spenders
43195,192,12,1853.03,3,4,4,11,Big Spenders
43196,424,11,1629.97,2,3,3,8,Regulars
43197,265,13,1610.48,2,4,3,9,At Risk
43198,104,14,2954.95,4,5,5,14,Champions
43199,332,10,1585.87,2,3,3,8,Regulars
43200,264,12,1877.46,2,4,4,10,At Risk
43201,212,8,765.2,3,2,1,6,Regulars
43202,22,11,1635.13,5,3,3,11,Loyal
43203,138,6,422.78,4,1,1,6,Regulars
43204,893,5,617.56,1,1,1,3,Hibernating
43205,480,8,1701.53,1,2,3,6,Regulars
43206,127,14,936.1,4,5,2,11,Loyal
43207,127,11,1263.6000000000001,4,3,3,10,Loyal
43208,633,9,2086.5299999999997,1,2,4,7,Regulars
43209,545,9,1707.8,1,2,3,6,Regulars
43210,215,13,2166.8,3,4,4,11,Big Spenders
43211,154,10,605.95,3,3,1,7,Regulars
43212,266,12,4613.22,2,4,5,11,At Risk
43213,430,6,947.0200000000001,2,1,2,5,Hibernating
43214,56,4,1937.48,5,1,4,10,Big Spenders
43215,580,10,1851.0,1,3,4,8,Regulars
43216,87,11,1250.26,4,3,3,10,Loyal
43217,144,10,1621.03,4,3,3,10,Loyal
43218,50,10,721.06,5,3,1,9,Loyal
43219,166,7,468.97,3,1,1,5,Regulars
43220,239,8,1831.0400000000002,3,2,4,9,Big Spenders
43221,203,13,1723.4199999999998,3,4,3,10,Regulars
43222,238,7,1521.7900000000002,3,1,3,7,Regulars
43223,141,15,1594.2499999999998,4,5,3,12,Loyal
43224,1105,6,997.79,1,1,2,4,Hibernating
43225,262,11,870.12,2,3,2,7,Regulars
43226,567,9,2275.04,1,2,4,7,Regulars
43227,945,8,1128.98,1,2,2,5,Hibernating
43228,6,15,3936.5300000000007,5,5,5,15,Champions
43229,188,13,2347.54,3,4,4,11,Big Spenders
43230,349,10,3346.16,2,3,5,10,Regulars
43231,626,7,576.99,1,1,1,3,Hibernating
43232,22,11,3811.08,5,3,5,13,Loyal
43233,144,13,2426.7,4,4,4,12,Champions
43234,236,10,4232.86,3,3,5,11,Big Spenders
43235,114,9,2430.98,4,2,4,10,Big Spenders
43236,145,5,1262.5600000000002,4,1,3,8,Regulars
43237,1222,5,1097.17,1,1,2,4,Hibernating
43238,237,18,4521.360000000001,3,5,5,13,Big Spenders
43239,145,8,908.39,4,2,2,8,Regulars
43240,606,12,1291.4,1,4,3,8,At Risk
43241,366,8,1193.5,2,2,2,6,Hibernating
43242,73,8,1356.88,4,2,3,9,Regulars
43243,1025,12,1395.09,1,4,3,8,At Risk
43244,94,14,943.57,4,5,2,11,Loyal
43245,31,5,268.07,5,1,1,7,Regulars
43246,602,11,1526.8600000000001,1,3,3,7,Regulars
43247,289,11,1715.51,2,3,3,8,Regulars
43248,857,11,935.73,1,3,2,6,Regulars
43249,499,9,2358.39,1,2,4,7,Regulars
43250,105,6,756.68,4,1,1,6,Regulars
43251,21,9,939.46,5,2,2,9,Regulars
43252,82,15,3103.3199999999997,4,5,5,14,Champions
43253,65,13,1742.8400000000001,5,4,4,13,Champions
43254,173,12,1377.9299999999998,3,4,3,10,Regulars
43255,283,6,505.85,2,1,1,4,Hibernating
43256,177,7,322.42,3,1,1,5,Regulars
43257,416,11,4777.09,2,3,5,10,Regulars
43258,1742,5,1046.8,1,1,2,4,Hibernating
43259,75,14,2030.55,4,5,4,13,Champions
43260,29,10,1786.06,5,3,4,12,Loyal
43261,122,5,833.17,4,1,1,6,Regulars
43262,37,14,3088.77,5,5,5,15,Champions
43263,265,8,1561.87,2,2,3,7,Regulars
43264,172,10,3835.5600000000004,3,3,5,11,Big Spenders
43265,184,17,2367.23,3,5,4,12,Big Spenders
43266,275,10,1568.61,2,3,3,8,Regulars
43267,405,10,2070.57,2,3,4,9,Regulars
43268,125,9,1795.1999999999998,4,2,4,10,Big Spenders
43269,17,12,2426.64,5,4,4,13,Champions
43270,77,10,1962.3700000000001,4,3,4,11,Loyal
43271,142,12,3879.87,4,4,5,13,Champions
43272,849,9,1464.96,1,2,3,6,Regulars
43273,205,12,2789.8300000000004,3,4,5,12,Big Spenders
43274,237,10,981.95,3,3,2,8,Regulars
43275,474,11,3079.55,1,3,5,9,Regulars
43276,45,13,1137.16,5,4,2,11,Loyal
43277,291,11,2071.7799999999997,2,3,4,9,Regulars
43278,508,4,655.4499999999999,1,1,1,3,Hibernating
43279,106,15,1524.16,4,5,3,12,Loyal
43280,13,7,828.26,5,1,1,7,Regulars
43281,16,12,2229.94,5,4,4,13,Champions
43282,1004,7,477.32,1,1,1,3,Hibernating
43283,345,12,1502.5,2,4,3,9,At Risk
43284,368,8,534.49,2,2,1,5,Hibernating
43285,61,13,1671.16,5,4,3,12,Loyal
43286,9,10,865.15,5,3,2,10,Loyal
43287,636,9,2082.42,1,2,4,7,Regulars
43288,431,11,1931.45,2,3,4,9,Regulars
43289,126,8,1045.75,4,2,2,8,Regulars
43290,160,6,623.56,3,1,1,5,Regulars
43291,313,12,2231.79,2,4,4,10,At Risk
43292,45,9,1590.7,5,2,3,10,Regulars
43293,318,9,2329.09,2,2,4,8,Regulars
43294,76,7,1471.33,4,1,3,8,Regulars
43295,189,7,1928.81,3,1,4,8,Big Spenders
43296,163,12,1520.73,3,4,3,10,Regulars
43297,747,11,2426.1499999999996,1,3,4,8,Regulars
43298,3,7,3406.1800000000003,5,1,5,11,Big Spenders
43299,497,10,1035.8,1,3,2,6,Regulars
43300,99,11,1063.15,4,3,2,9,Loyal
43301,235,11,1690.72,3,3,3,9,Regulars
43302,43,10,772.86,5,3,1,9,Loyal
43303,623,8,1993.61,1,2,4,7,Regulars
43304,90,11,895.65,4,3,2,9,Loyal
43305,314,12,1342.32,2,4,3,9,At Risk
43306,153,9,1203.64,3,2,2,7,Regulars
43307,125,10,1064.19,4,3,2,9,Loyal
43308,210,8,658.6600000000001,3,2,1,6,Regulars
43309,161,11,1666.96,3,3,3,9,Regulars
43310,95,10,2431.33,4,3,4,11,Loyal
43311,148,8,711.06,3,2,1,6,Regulars
43312,242,15,1911.1,3,5,4,12,Big Spenders
43313,110,11,1868.14,4,3,4,11,Loyal
43314,191,14,1378.12,3,5,3,11,Regulars
43315,104,8,464.76,4,2,1,7,Regulars
43316,300,11,1163.9099999999999,2,3,2,7,Regulars
43317,272,14,2159.22,2,5,4,11,At Risk
43318,65,17,2148.45,5,5,4,14,Champions
43319,65,6,318.02000000000004,5,1,1,7,Regulars
43320,343,5,598.23,2,1,1,4,Hibernating
43321,127,10,743.1,4,3,1,8,Loyal
43322,203,8,1005.1499999999999,3,2,2,7,Regulars
43323,113,12,3342.16,4,4,5,13,Champions
43324,453,4,372.1,2,1,1,4,Hibernating
43325,96,11,2237.07,4,3,4,11,Loyal
43326,0,12,2158.7,5,4,4,13,Champions
43327,117,13,1737.45,4,4,4,12,Champions
43328,245,3,909.3400000000001,3,1,2,6,Regulars
43329,78,10,7214.360000000001,4,3,5,12,Loyal
43330,448,7,1298.9499999999998,2,1,3,6,Regulars
43331,165,11,2840.88,3,3,5,11,Big Spenders
43332,140,10,1101.62,4,3,2,9,Loyal
43333,44,10,1352.0900000000001,5,3,3,11,Loyal
43334,101,9,1508.6,4,2,3,9,Regulars
43335,202,12,2350.96,3,4,4,11,Big Spenders
43336,99,6,2046.9700000000003,4,1,4,9,Big Spenders
43337,161,13,1108.47,3,4,2,9,Regulars
43338,531,4,282.79,1,1,1,3,Hibernating
43339,488,10,1141.31,1,3,2,6,Regulars
43340,143,10,1372.95,4,3,3,10,Loyal
43341,89,17,2560.1,4,5,4,13,Champions
43342,466,8,805.8499999999999,1,2,1,4,Hibernating
43343,156,11,1511.54,3,3,3,9,Regulars
43344,187,10,5229.039999999999,3,3,5,11,Big Spenders
43345,74,11,3129.08,4,3,5,12,Loyal
43346,83,6,712.39,4,1,1,6,Regulars
43347,407,15,2545.4700000000003,2,5,4,11,At Risk
43348,190,14,2488.08,3,5,4,12,Big Spenders
43349,88,7,843.8399999999999,4,1,1,6,Regulars
43350,140,7,998.61,4,1,2,7,Regulars
43351,10,12,1772.04,5,4,4,13,Champions
43352,85,14,4290.969999999999,4,5,5,14,Champions
43353,860,5,568.45,1,1,1,3,Hibernating
43354,9,13,1345.45,5,4,3,12,Loyal
43355,313,7,755.0999999999999,2,1,1,4,Hibernating
43356,574,13,3076.62,1,4,5,10,At Risk
43357,167,12,3552.48,3,4,5,12,Big Spenders
43358,141,11,1344.8700000000001,4,3,3,10,Loyal
43359,11,16,2522.56,5,5,4,14,Champions
43360,483,11,1236.91,1,3,2,6,Regulars
43361,399,14,2260.88,2,5,4,11,At Risk
43362,90,13,1117.26,4,4,2,10,Loyal
43363,268,8,862.6600000000001,2,2,2,6,Hibernating
43364,32,10,2182.6000000000004,5,3,4,12,Loyal
43365,178,11,1926.28,3,3,4,10,Big Spenders
43366,272,13,2530.42,2,4,4,10,At Risk
43367,11,7,1433.4699999999998,5,1,3,9,Regulars
43368,54,9,1909.93,5,2,4,11,Big Spenders
43369,275,11,2086.66,2,3,4,9,Regulars
43370,315,12,2126.49,2,4,4,10,At Risk
43371,138,8,2833.2,4,2,5,11,Big Spenders
43372,146,12,856.03,4,4,2,10,Loyal
43373,303,13,1398.97,2,4,3,9,At Risk
43374,111,8,763.9,4,2,1,7,Regulars
43375,21,10,610.48,5,3,1,9,Loyal
43376,33,7,1475.54,5,1,3,9,Regulars
43377,356,5,1159.77,2,1,2,5,Hibernating
43378,26,9,1110.68,5,2,2,9,Regulars
43379,184,5,602.37,3,1,1,5,Regulars
43380,127,15,1870.58,4,5,4,13,Champions
43381,730,12,2359.37,1,4,4,9,At Risk
43382,110,13,2762.0699999999997,4,4,5,13,Champions
43383,90,13,1267.37,4,4,3,11,Loyal
43384,78,11,1126.61,4,3,2,9,Loyal
43385,237,16,1490.0300000000002,3,5,3,11,Regulars
43386,138,13,1484.29,4,4,3,11,Loyal
43387,52,12,946.9200000000001,5,4,2,11,Loyal
43388,144,13,2118.0600000000004,4,4,4,12,Champions
43389,120,11,4390.69,4,3,5,12,Loyal
43390,172,10,848.28,3,3,2,8,Regulars
43391,206,11,917.91,3,3,2,8,Regulars
43392,2,15,1621.94,5,5,3,13,Loyal
43393,35,14,3452.1000000000004,5,5,5,15,Champions
43394,168,10,1121.13,3,3,2,8,Regulars
43395,132,9,1280.79,4,2,3,9,Regulars
43396,467,8,796.32,1,2,1,4,Hibernating
43397,171,14,2399.64,3,5,4,12,Big Spenders
43398,234,13,5297.41,3,4,5,12,Big Spenders
43399,572,7,1330.83,1,1,3,5,Regulars
43400,1460,2,125.9,1,1,1,3,Hibernating
43401,1737,4,496.36,1,1,1,3,Hibernating
43402,304,10,2725.9300000000003,2,3,5,10,Regulars
43403,563,10,2882.79,1,3,5,9,Regulars
43404,31,11,1115.14,5,3,2,10,Loyal
43405,80,10,2145.9300000000003,4,3,4,11,Loyal
43406,146,12,3541.02,4,4,5,13,Champions
43407,121,16,2981.2599999999998,4,5,5,14,Champions
43408,1210,3,154.81,1,1,1,3,Hibernating
43409,431,8,1777.8500000000001,2,2,4,8,Regulars
43410,65,11,1582.01,5,3,3,11,Loyal
43411,147,9,1539.48,4,2,3,9,Regulars
43412,305,12,1051.95,2,4,2,8,At Risk
43413,354,12,1475.94,2,4,3,9,At Risk
43414,273,6,1582.15,2,1,3,6,Regulars
43415,128,13,1757.43,4,4,4,12,Champions
43416,186,6,2655.5800000000004,3,1,5,9,Big Spenders
43417,149,10,1035.06,3,3,2,8,Regulars
43418,440,14,4961.43,2,5,5,12,At Risk
43419,138,8,691.85,4,2,1,7,Regulars
43420,347,11,1681.87,2,3,3,8,Regulars
43421,46,13,3160.54,5,4,5,14,Champions
43422,209,9,1364.11,3,2,3,8,Regulars
43423,114,18,4126.4800000000005,4,5,5,14,Champions
43424,665,11,1431.8,1,3,3,7,Regulars
43425,30,13,1272.8000000000002,5,4,3,12,Loyal
43426,548,7,744.55,1,1,1,3,Hibernating
43427,537,11,1721.44,1,3,3,7,Regulars
43428,159,10,2084.62,3,3,4,10,Big Spenders
43429,392,8,787.84,2,2,1,5,Hibernating
43430,354,10,830.19,2,3,1,6,Regulars
43431,261,7,529.75,2,1,1,4,Hibernating
43432,45,10,2622.99,5,3,5,13,Loyal
43433,42,16,2428.71,5,5,4,14,Champions
43434,45,10,2733.9599999999996,5,3,5,13,Loyal
43435,162,9,583.73,3,2,1,6,Regulars
43436,22,16,4002.9900000000002,5,5,5,15,Champions
43437,59,9,731.49,5,2,1,8,Regulars
43438,111,8,567.7199999999999,4,2,1,7,Regulars
43439,42,9,967.58,5,2,2,9,Regulars
43440,368,17,2712.5,2,5,5,12,At Risk
43441,38,10,3061.9900000000002,5,3,5,13,Loyal
43442,1260,6,339.92,1,1,1,3,Hibernating
43443,6,6,663.64,5,1,1,7,Regulars
43444,497,15,1638.21,1,5,3,9,At Risk
43445,172,12,919.94,3,4,2,9,Regulars
43446,127,7,421.86,4,1,1,6,Regulars
43447,610,7,1272.1499999999999,1,1,3,5,Regulars
43448,1665,4,237.39999999999998,1,1,1,3,Hibernating
43449,296,11,1488.5,2,3,3,8,Regulars
43450,72,8,1003.0699999999999,4,2,2,8,Regulars
43451,95,10,3752.21,4,3,5,12,Loyal
43452,18,10,1707.6100000000001,5,3,3,11,Loyal
43453,649,14,2486.21,1,5,4,10,At Risk
43454,314,3,182.03,2,1,1,4,Hibernating
43455,496,9,1144.85,1,2,2,5,Hibernating
43456,10,17,2110.12,5,5,4,14,Champions
43457,628,9,1245.33,1,2,3,6,Regulars
43458,145,15,2749.7,4,5,5,14,Champions
43459,52,12,1565.48,5,4,3,12,Loyal
43460,68,5,3783.54,4,1,5,10,Big Spenders
43461,205,13,3295.4100000000003,3,4,5,12,Big Spenders
43462,185,13,4637.43,3,4,5,12,Big Spenders
43463,520,11,1481.3899999999999,1,3,3,7,Regulars
43464,5,11,1396.8799999999999,5,3,3,11,Loyal
43465,17,14,5806.610000000001,5,5,5,15,Champions
43466,118,8,2452.53,4,2,4,10,Big Spenders
43467,332,11,4186.5,2,3,5,10,Regulars
43468,231,6,1151.58,3,1,2,6,Regulars
43469,442,7,491.74,2,1,1,4,Hibernating
43470,0,12,2714.56,5,4,5,14,Champions
43471,39,9,1966.2800000000002,5,2,4,11,Big Spenders
43472,54,8,1726.37,5,2,4,11,Big Spenders
43473,9,11,1151.49,5,3,2,10,Loyal
43474,441,5,1592.1499999999999,2,1,3,6,Regulars
43475,378,7,1403.87,2,1,3,6,Regulars
43476,87,7,3567.21,4,1,5,10,Big Spenders
43477,29,10,1292.56,5,3,3,11,Loyal
43478,354,12,1132.8400000000001,2,4,2,8,At Risk
43479,404,8,1672.07,2,2,3,7,Regulars
43480,100,12,1152.6799999999998,4,4,2,10,Loyal
43481,223,11,1037.28,3,3,2,8,Regulars
43482,17,10,1497.8899999999999,5,3,3,11,Loyal
43483,805,8,1019.23,1,2,2,5,Hibernating
43484,165,11,2072.71,3,3,4,10,Big Spenders
43485,720,8,548.0699999999999,1,2,1,4,Hibernating
43486,0,13,1181.93,5,4,2,11,Loyal
43487,259,12,1935.99,2,4,4,10,At Risk
43488,407,11,1475.56,2,3,3,8,Regulars
43489,917,7,1216.19,1,1,2,4,Hibernating
43490,573,12,1384.63,1,4,3,8,At Risk
43491,151,12,1920.93,3,4,4,11,Big Spenders
43492,5,7,2928.8,5,1,5,11,Big Spenders
43493,8,16,5016.93,5,5,5,15,Champions
43494,339,7,1969.95,2,1,4,7,Regulars
43495,124,10,1892.25,4,3,4,11,Loyal
43496,791,10,2372.91,1,3,4,8,Regulars
43497,174,9,729.22,3,2,1,6,Regulars
43498,497,9,797.9100000000001,1,2,1,4,Hibernating
43499,88,11,1041.7199999999998,4,3,2,9,Loyal
43500,111,12,1730.96,4,4,4,12,Champions
43501,310,10,3944.3699999999994,2,3,5,10,Regulars
43502,154,11,704.21,3,3,1,7,Regulars
43503,541,12,1200.21,1,4,2,7,At Risk
43504,662,12,1697.03,1,4,3,8,At Risk
43505,65,6,2030.7499999999998,5,1,4,10,Big Spenders
43506,97,7,1867.01,4,1,4,9,Big Spenders
43507,361,11,2801.44,2,3,5,10,Regulars
43508,71,22,3293.4300000000003,4,5,5,14,Champions
43509,186,10,1113.23,3,3,2,8,Regulars
43510,582,9,1475.86,1,2,3,6,Regulars
43511,187,19,5639.76,3,5,5,13,Big Spenders
43512,78,10,1739.48,4,3,4,11,Loyal
43513,46,21,3626.12,5,5,5,15,Champions
43514,321,16,2156.58,2,5,4,11,At Risk
43515,203,13,2303.06,3,4,4,11,Big Spenders
43516,166,12,2011.16,3,4,4,11,Big Spenders
43517,125,11,1662.6699999999998,4,3,3,10,Loyal
43518,181,12,1340.97,3,4,3,10,Regulars
43519,383,12,2018.6100000000001,2,4,4,10,At Risk
43520,201,9,1753.36,3,2,4,9,Big Spenders
43521,899,11,1333.97,1,3,3,7,Regulars
43522,1714,5,320.72,1,1,1,3,Hibernating
43523,281,15,4627.69,2,5,5,12,At Risk
43524,772,4,382.65999999999997,1,1,1,3,Hibernating
43525,1291,10,3046.2200000000003,1,3,5,9,Regulars
43526,430,8,850.81,2,2,2,6,Hibernating
43527,19,9,904.43,5,2,2,9,Regulars
43528,182,8,442.9,3,2,1,6,Regulars
43529,40,10,3024.8399999999997,5,3,5,13,Loyal
43530,227,10,1706.83,3,3,3,9,Regulars
43531,177,11,1636.88,3,3,3,9,Regulars
43532,191,7,452.15,3,1,1,5,Regulars
43533,620,13,1195.68,1,4,2,7,At Risk
43534,92,9,1971.58,4,2,4,10,Big Spenders
43535,4,11,2129.7400000000002,5,3,4,12,Loyal
43536,372,13,2434.93,2,4,4,10,At Risk
43537,406,7,871.85,2,1,2,5,Hibernating
43538,243,14,3852.43,3,5,5,13,Big Spenders
43539,169,14,1465.8999999999999,3,5,3,11,Regulars
43540,0,13,1624.38,5,4,3,12,Loyal
43541,9,17,3539.2000000000003,5,5,5,15,Champions
43542,441,14,3324.56,2,5,5,12,At Risk
43543,13,15,2469.34,5,5,4,14,Champions
43544,448,10,1036.22,2,3,2,7,Regulars
43545,166,10,1181.3899999999999,3,3,2,8,Regulars
43546,658,8,3315.3799999999997,1,2,5,8,Regulars
43547,530,7,1025.38,1,1,2,4,Hibernating
43548,317,13,2420.76,2,4,4,10,At Risk
43549,160,12,1937.44,3,4,4,11,Big Spenders
43550,968,10,859.76,1,3,2,6,Regulars
43551,77,12,971.02,4,4,2,10,Loyal
43552,64,13,1233.12,5,4,2,11,Loyal
43553,552,13,2258.84,1,4,4,9,At Risk
43554,75,8,851.15,4,2,2,8,Regulars
43555,327,13,4437.08,2,4,5,11,At Risk
43556,205,8,603.38,3,2,1,6,Regulars
43557,199,10,4378.6900000000005,3,3,5,11,Big Spenders
43558,578,8,1228.6100000000001,1,2,2,5,Hibernating
43559,54,8,2456.36,5,2,4,11,Big Spenders
43560,156,12,2126.49,3,4,4,11,Big Spenders
43561,83,7,752.7,4,1,1,6,Regulars
43562,2,15,1490.67,5,5,3,13,Loyal
43563,754,6,637.5699999999999,1,1,1,3,Hibernating
43564,172,16,1739.23,3,5,4,12,Big Spenders
43565,379,13,1868.28,2,4,4,10,At Risk
43566,57,8,352.93,5,2,1,8,Regulars
43567,109,12,1042.14,4,4,2,10,Loyal
43568,383,7,1043.47,2,1,2,5,Hibernating
43569,175,11,2636.79,3,3,5,11,Big Spenders
43570,165,5,1167.63,3,1,2,6,Regulars
43571,169,4,427.78999999999996,3,1,1,5,Regulars
43572,803,8,3022.0600000000004,1,2,5,8,Regulars
43573,249,10,2656.9300000000003,2,3,5,10,Regulars
43574,45,7,3767.5199999999995,5,1,5,11,Big Spenders
43575,602,10,1485.12,1,3,3,7,Regulars
43576,485,8,600.43,1,2,1,4,Hibernating
43577,14,15,896.76,5,5,2,12,Loyal
43578,64,4,703.52,5,1,1,7,Regulars
43579,220,9,2078.37,3,2,4,9,Big Spenders
43580,412,15,1005.59,2,5,2,9,At Risk
43581,37,12,3572.7599999999998,5,4,5,14,Champions
43582,531,5,322.53,1,1,1,3,Hibernating
43583,284,7,820.84,2,1,1,4,Hibernating
43584,22,10,1601.36,5,3,3,11,Loyal
43585,492,4,925.5699999999999,1,1,2,4,Hibernating
43586,565,11,949.12,1,3,2,6,Regulars
43587,145,8,2389.0299999999997,4,2,4,10,Big Spenders
43588,92,13,2198.37,4,4,4,12,Champions
43589,82,7,385.14,4,1,1,6,Regulars
43590,351,13,6035.44,2,4,5,11,At Risk
43591,239,10,1514.3000000000002,3,3,3,9,Regulars
43592,161,7,602.96,3,1,1,5,Regulars
43593,249,11,1658.79,2,3,3,8,Regulars
43594,758,9,1491.51,1,2,3,6,Regulars
43595,1060,9,895.0699999999999,1,2,2,5,Hibernating
43596,225,9,1505.06,3,2,3,8,Regulars
43597,245,4,697.7600000000001,3,1,1,5,Regulars
43598,15,14,1525.84,5,5,3,13,Loyal
43599,38,19,1680.75,5,5,3,13,Loyal
43600,171,10,1597.89,3,3,3,9,Regulars
43601,386,11,1123.49,2,3,2,7,Regulars
43602,156,13,3778.56,3,4,5,12,Big Spenders
43603,408,12,1300.57,2,4,3,9,At Risk
43604,92,4,266.86,4,1,1,6,Regulars
43605,327,4,228.92000000000002,2,1,1,4,Hibernating
43606,287,10,837.27,2,3,1,6,Regulars
43607,53,7,468.63,5,1,1,7,Regulars
43608,34,4,495.34000000000003,5,1,1,7,Regulars
43609,329,8,755.52,2,2,1,5,Hibernating
43610,297,11,1271.3100000000002,2,3,3,8,Regulars
43611,67,9,1180.57,4,2,2,8,Regulars
43612,161,13,1387.94,3,4,3,10,Regulars
43613,224,10,959.04,3,3,2,8,Regulars
43614,61,15,4229.01,5,5,5,15,Champions
43615,94,11,860.1899999999999,4,3,2,9,Loyal
43616,446,7,929.32,2,1,2,5,Hibernating
43617,166,12,1842.2200000000003,3,4,4,11,Big Spenders
43618,166,17,3349.2099999999996,3,5,5,13,Big Spenders
43619,181,10,1221.05,3,3,2,8,Regulars
43620,215,10,1161.56,3,3,2,8,Regulars
43621,430,8,1064.1,2,2,2,6,Hibernating
43622,176,12,2590.87,3,4,5,12,Big Spenders
43623,305,13,1922.68,2,4,4,10,At Risk
43624,514,7,650.9200000000001,1,1,1,3,Hibernating
43625,498,13,2180.7599999999998,1,4,4,9,At Risk
43626,147,7,1206.12,4,1,2,7,Regulars
43627,248,12,1613.52,2,4,3,9,At Risk
43628,539,8,686.17,1,2,1,4,Hibernating
43629,31,12,1341.08,5,4,3,12,Loyal
43630,247,11,849.88,3,3,2,8,Regulars
43631,548,9,846.03,1,2,2,5,Hibernating
43632,931,6,1090.62,1,1,2,4,Hibernating
43633,234,10,2053.14,3,3,4,10,Big Spenders
43634,0,10,2125.5,5,3,4,12,Loyal
43635,449,11,756.9300000000001,2,3,1,6,Regulars
43636,224,9,3003.4700000000003,3,2,5,10,Big Spenders
43637,65,9,737.3199999999999,5,2,1,8,Regulars
43638,54,12,1892.07,5,4,4,13,Champions
43639,57,12,2076.81,5,4,4,13,Champions
43640,414,11,1152.97,2,3,2,7,Regulars
43641,213,8,1635.4,3,2,3,8,Regulars
43642,394,8,505.23,2,2,1,5,Hibernating
43643,121,8,1437.53,4,2,3,9,Regulars
43644,42,12,2029.55,5,4,4,13,Champions
43645,750,5,1787.22,1,1,4,6,Regulars
43646,251,12,4644.05,2,4,5,11,At Risk
43647,179,13,2754.05,3,4,5,12,Big Spenders
43648,369,10,1626.03,2,3,3,8,Regulars
43649,193,6,413.15,3,1,1,5,Regulars
43650,164,11,4120.35,3,3,5,11,Big Spenders
43651,207,11,2300.77,3,3,4,10,Big Spenders
43652,473,12,2679.75,1,4,5,10,At Risk
43653,204,8,645.53,3,2,1,6,Regulars
43654,0,14,3271.3100000000004,5,5,5,15,Champions
43655,253,5,371.14,2,1,1,4,Hibernating
43656,130,10,1366.95,4,3,3,10,Loyal
43657,6,10,749.05,5,3,1,9,Loyal
43658,738,11,1500.9099999999999,1,3,3,7,Regulars
43659,1189,14,1692.1399999999999,1,5,3,9,At Risk
43660,405,4,602.43,2,1,1,4,Hibernating
43661,825,5,603.58,1,1,1,3,Hibernating
43662,91,8,466.82,4,2,1,7,Regulars
43663,870,9,1291.8799999999999,1,2,3,6,Regulars
43664,101,7,326.88,4,1,1,6,Regulars
43665,121,6,1382.46,4,1,3,8,Regulars
43666,9,8,1092.9,5,2,2,9,Regulars
43667,90,18,1761.04,4,5,4,13,Champions
43668,15,8,1923.3600000000001,5,2,4,11,Big Spenders
43669,30,17,2466.82,5,5,4,14,Champions
43670,356,8,945.53,2,2,2,6,Hibernating
43671,105,12,1191.22,4,4,2,10,Loyal
43672,428,6,486.76,2,1,1,4,Hibernating
43673,6,14,2673.13,5,5,5,15,Champions
43674,176,6,1008.6100000000001,3,1,2,6,Regulars
43675,148,11,2094.49,3,3,4,10,Big Spenders
43676,21,11,3078.7899999999995,5,3,5,13,Loyal
43677,30,8,2017.7199999999998,5,2,4,11,Big Spenders
43678,124,15,4202.56,4,5,5,14,Champions
43679,33,14,1992.37,5,5,4,14,Champions
43680,401,7,871.26,2,1,2,5,Hibernating
43681,388,11,1766.99,2,3,4,9,Regulars
43682,292,17,2001.49,2,5,4,11,At Risk
43683,1754,2,463.15999999999997,1,1,1,3,Hibernating
43684,150,12,2615.63,3,4,5,12,Big Spenders
43685,231,9,1662.3799999999999,3,2,3,8,Regulars
43686,36,10,1427.23,5,3,3,11,Loyal
43687,404,10,861.42,2,3,2,7,Regulars
43688,52,9,1915.3000000000002,5,2,4,11,Big Spenders
43689,887,5,1037.25,1,1,2,4,Hibernating
43690,104,8,848.24,4,2,2,8,Regulars
43691,209,15,1488.03,3,5,3,11,Regulars
43692,124,7,1773.73,4,1,4,9,Big Spenders
43693,702,4,1717.99,1,1,3,5,Regulars
43694,914,7,1017.53,1,1,2,4,Hibernating
43695,300,11,1890.56,2,3,4,9,Regulars
43696,341,6,536.8900000000001,2,1,1,4,Hibernating
43697,194,14,912.73,3,5,2,10,Regulars
43698,102,13,1722.48,4,4,3,11,Loyal
43699,372,9,1334.95,2,2,3,7,Regulars
43700,203,10,1699.1499999999999,3,3,3,9,Regulars
43701,7,11,1311.35,5,3,3,11,Loyal
43702,966,4,153.73000000000002,1,1,1,3,Hibernating
43703,5,9,1636.24,5,2,3,10,Regulars
43704,32,14,3286.7,5,5,5,15,Champions
43705,111,18,1805.44,4,5,4,13,Champions
43706,314,9,985.0,2,2,2,6,Hibernating
43707,99,7,1058.24,4,1,2,7,Regulars
43708,7,11,2336.66,5,3,4,12,Loyal
43709,141,14,2190.87,4,5,4,13,Champions
43710,366,4,1986.7200000000003,2,1,4,7,Regulars
43711,372,11,1357.38,2,3,3,8,Regulars
43712,60,16,1469.8,5,5,3,13,Loyal
43713,52,8,1385.33,5,2,3,10,Regulars
43714,160,8,1913.3400000000001,3,2,4,9,Big Spenders
43715,135,11,3578.58,4,3,5,12,Loyal
43716,149,15,1565.9399999999998,3,5,3,11,Regulars
43717,16,11,2869.07,5,3,5,13,Loyal
43718,34,10,1091.79,5,3,2,10,Loyal
43719,121,10,1386.65,4,3,3,10,Loyal
43720,362,10,2562.36,2,3,4,9,Regulars
43721,193,11,1528.84,3,3,3,9,Regulars
43722,499,13,3288.73,1,4,5,10,At Risk
43723,330,13,2055.12,2,4,4,10,At Risk
43724,252,9,657.41,2,2,1,5,Hibernating
43725,157,7,622.0500000000001,3,1,1,5,Regulars
43726,197,13,1530.62,3,4,3,10,Regulars
43727,127,8,810.6,4,2,1,7,Regulars
43728,52,12,2227.84,5,4,4,13,Champions
43729,2,9,1297.67,5,2,3,10,Regulars
43730,161,9,806.99,3,2,1,6,Regulars
43731,274,12,2862.04,2,4,5,11,At Risk
43732,169,12,1885.28,3,4,4,11,Big Spenders
43733,45,8,1087.46,5,2,2,9,Regulars
43734,427,11,1445.48,2,3,3,8,Regulars
43735,26,17,1875.75,5,5,4,14,Champions
43736,159,10,2191.63,3,3,4,10,Big Spenders
43737,345,7,2410.0199999999995,2,1,4,7,Regulars
43738,530,14,1339.92,1,5,3,9,At Risk
43739,173,11,1054.34,3,3,2,8,Regulars
43740,1404,7,2635.55,1,1,5,7,Regulars
43741,318,7,1050.56,2,1,2,5,Hibernating
43742,633,8,4754.91,1,2,5,8,Regulars
43743,360,15,1197.73,2,5,2,9,At Risk
43744,317,6,803.52,2,1,1,4,Hibernating
43745,426,10,924.66,2,3,2,7,Regulars
43746,515,8,657.23,1,2,1,4,Hibernating
43747,568,8,1181.52,1,2,2,5,Hibernating
43748,98,9,1123.4,4,2,2,8,Regulars
43749,109,6,353.57,4,1,1,6,Regulars
43750,75,8,980.17,4,2,2,8,Regulars
43751,71,8,1541.28,4,2,3,9,Regulars
43752,166,7,1564.3999999999999,3,1,3,7,Regulars
43753,160,11,3490.6400000000003,3,3,5,11,Big Spenders
43754,213,10,2620.58,3,3,5,11,Big Spenders
43755,548,6,581.61,1,1,1,3,Hibernating
43756,98,14,1390.81,4,5,3,12,Loyal
43757,577,7,1801.37,1,1,4,6,Regulars
43758,193,11,2732.4300000000003,3,3,5,11,Big Spenders
43759,146,16,2179.15,4,5,4,13,Champions
43760,35,11,1121.86,5,3,2,10,Loyal
43761,156,12,1150.8,3,4,2,9,Regulars
43762,588,9,1438.94,1,2,3,6,Regulars
43763,1574,7,405.2,1,1,1,3,Hibernating
43764,855,12,1144.95,1,4,2,7,At Risk
43765,223,10,580.39,3,3,1,7,Regulars
43766,14,6,1185.8100000000002,5,1,2,8,Regulars
43767,260,12,4237.41,2,4,5,11,At Risk
43768,357,8,1499.93,2,2,3,7,Regulars
43769,21,9,1725.76,5,2,4,11,Big Spenders
43770,25,11,4168.36,5,3,5,13,Loyal
43771,41,9,1516.53,5,2,3,10,Regulars
43772,430,16,3053.0,2,5,5,12,At Risk
43773,666,6,2752.2799999999997,1,1,5,7,Regulars
43774,142,11,3626.7,4,3,5,12,Loyal
43775,693,10,1098.96,1,3,2,6,Regulars
43776,200,9,2505.1600000000003,3,2,4,9,Big Spenders
43777,184,13,3017.89,3,4,5,12,Big Spenders
43778,171,10,822.81,3,3,1,7,Regulars
43779,154,4,1083.32,3,1,2,6,Regulars
43780,237,11,1555.27,3,3,3,9,Regulars
43781,286,12,1293.21,2,4,3,9,At Risk
43782,281,5,477.40000000000003,2,1,1,4,Hibernating
43783,717,7,576.08,1,1,1,3,Hibernating
43784,48,10,2850.34,5,3,5,13,Loyal
43785,384,11,1095.91,2,3,2,7,Regulars
43786,192,14,2764.3199999999997,3,5,5,13,Big Spenders
43787,85,20,4556.74,4,5,5,14,Champions
43788,278,4,2560.68,2,1,4,7,Regulars
43789,51,10,1097.89,5,3,2,10,Loyal
43790,90,12,1283.19,4,4,3,11,Loyal
43791,739,5,355.53999999999996,1,1,1,3,Hibernating
43792,797,7,2540.0299999999997,1,1,4,6,Regulars
43793,293,9,2381.53,2,2,4,8,Regulars
43794,363,15,1454.03,2,5,3,10,At Risk
43795,191,10,1875.41,3,3,4,10,Big Spenders
43796,275,8,1771.74,2,2,4,8,Regulars
43797,437,9,1373.8,2,2,3,7,Regulars
43798,210,12,4601.07,3,4,5,12,Big Spenders
43799,422,5,2113.48,2,1,4,7,Regulars
43800,110,8,1425.4999999999998,4,2,3,9,Regulars
43801,938,8,1204.3,1,2,2,5,Hibernating
43802,208,17,2512.49,3,5,4,12,Big Spenders
43803,349,8,1413.94,2,2,3,7,Regulars
43804,157,7,2019.61,3,1,4,8,Big Spenders
43805,77,8,1020.8499999999999,4,2,2,8,Regulars
43806,378,14,4718.219999999999,2,5,5,12,At Risk
43807,140,12,1407.82,4,4,3,11,Loyal
43808,15,10,921.06,5,3,2,10,Loyal
43809,1243,7,921.17,1,1,2,4,Hibernating
43810,410,12,2341.66,2,4,4,10,At Risk
43811,118,11,2058.88,4,3,4,11,Loyal
43812,165,14,5721.56,3,5,5,13,Big Spenders
43813,10,12,2422.34,5,4,4,13,Champions
43814,1373,7,1002.3800000000001,1,1,2,4,Hibernating
43815,564,9,2637.35,1,2,5,8,Regulars
43816,190,9,1643.84,3,2,3,8,Regulars
43817,413,8,1730.7199999999998,2,2,4,8,Regulars
43818,12,15,2521.12,5,5,4,14,Champions
43819,227,14,1860.8100000000002,3,5,4,12,Big Spenders
43820,281,9,2864.5499999999997,2,2,5,9,Regulars
43821,798,2,108.45,1,1,1,3,Hibernating
43822,256,6,962.12,2,1,2,5,Hibernating
43823,872,7,2638.26,1,1,5,7,Regulars
43824,119,8,1744.4899999999998,4,2,4,10,Big Spenders
43825,662,9,2057.0299999999997,1,2,4,7,Regulars
43826,134,11,988.56,4,3,2,9,Loyal
43827,6,14,2463.2,5,5,4,14,Champions
43828,973,6,1447.54,1,1,3,5,Regulars
43829,414,5,1615.1599999999999,2,1,3,6,Regulars
43830,136,9,972.98,4,2,2,8,Regulars
43831,431,16,1832.98,2,5,4,11,At Risk
43832,138,10,837.56,4,3,1,8,Loyal
43833,277,11,787.39,2,3,1,6,Regulars
43834,591,8,603.77,1,2,1,4,Hibernating
43835,53,13,5622.839999999999,5,4,5,14,Champions
43836,74,11,1771.28,4,3,4,11,Loyal
43837,130,6,985.7199999999999,4,1,2,7,Regulars
43838,295,12,1403.58,2,4,3,9,At Risk
43839,52,7,1504.53,5,1,3,9,Regulars
43840,514,7,893.06,1,1,2,4,Hibernating
43841,806,7,241.68,1,1,1,3,Hibernating
43842,1619,7,1154.45,1,1,2,4,Hibernating
43843,1580,6,721.28,1,1,1,3,Hibernating
43844,931,8,1369.08,1,2,3,6,Regulars
43845,5,12,1286.83,5,4,3,12,Loyal
43846,127,11,1879.92,4,3,4,11,Loyal
43847,5,12,1158.61,5,4,2,11,Loyal
43848,81,13,2072.43,4,4,4,12,Champions
43849,465,12,5235.070000000001,1,4,5,10,At Risk
43850,460,7,891.04,1,1,2,4,Hibernating
43851,858,8,1556.76,1,2,3,6,Regulars
43852,210,9,1347.6100000000001,3,2,3,8,Regulars
43853,371,14,2390.98,2,5,4,11,At Risk
43854,58,8,2346.9100000000003,5,2,4,11,Big Spenders
43855,77,13,1757.19,4,4,4,12,Champions
43856,101,15,1884.33,4,5,4,13,Champions
43857,15,10,1793.19,5,3,4,12,Loyal
43858,99,4,1153.65,4,1,2,7,Regulars
43859,33,7,641.93,5,1,1,7,Regulars
43860,225,5,275.04,3,1,1,5,Regulars
43861,225,12,2098.46,3,4,4,11,Big Spenders
43862,8,11,4087.94,5,3,5,13,Loyal
43863,2,10,2187.48,5,3,4,12,Loyal
43864,165,7,1198.48,3,1,2,6,Regulars
43865,162,15,1280.51,3,5,3,11,Regulars
43866,46,11,2024.75,5,3,4,12,Loyal
43867,521,7,504.02000000000004,1,1,1,3,Hibernating
43868,154,11,2355.74,3,3,4,10,Big Spenders
43869,364,19,3423.3900000000003,2,5,5,12,At Risk
43870,119,10,1539.0500000000002,4,3,3,10,Loyal
43871,116,5,990.54,4,1,2,7,Regulars
43872,376,5,406.24,2,1,1,4,Hibernating
43873,602,8,800.65,1,2,1,4,Hibernating
43874,189,14,1408.78,3,5,3,11,Regulars
43875,517,10,1041.46,1,3,2,6,Regulars
43876,5,15,4469.08,5,5,5,15,Champions
43877,342,13,1409.26,2,4,3,9,At Risk
43878,38,15,1947.54,5,5,4,14,Champions
43879,75,8,2028.1000000000001,4,2,4,10,Big Spenders
43880,77,9,4968.95,4,2,5,11,Big Spenders
43881,485,17,2200.58,1,5,4,10,At Risk
43882,210,15,1304.0200000000002,3,5,3,11,Regulars
43883,17,6,1075.26,5,1,2,8,Regulars
43884,234,9,1124.52,3,2,2,7,Regulars
43885,660,10,995.91,1,3,2,6,Regulars
43886,261,7,4052.75,2,1,5,8,Regulars
43887,111,15,3910.6,4,5,5,14,Champions
43888,6,14,1658.5700000000002,5,5,3,13,Loyal
43889,328,10,1892.02,2,3,4,9,Regulars
43890,211,12,1110.07,3,4,2,9,Regulars
43891,289,9,2224.42,2,2,4,8,Regulars
43892,497,11,1342.29,1,3,3,7,Regulars
43893,550,9,985.24,1,2,2,5,Hibernating
43894,196,12,1283.79,3,4,3,10,Regulars
43895,644,7,2829.33,1,1,5,7,Regulars
43896,140,11,1433.68,4,3,3,10,Loyal
43897,53,10,1689.04,5,3,3,11,Loyal
43898,906,4,392.40999999999997,1,1,1,3,Hibernating
43899,552,8,1669.3600000000001,1,2,3,6,Regulars
43900,907,6,640.11,1,1,1,3,Hibernating
43901,99,11,2152.33,4,3,4,11,Loyal
43902,156,11,1648.67,3,3,3,9,Regulars
43903,9,8,1089.19,5,2,2,9,Regulars
43904,226,9,1005.46,3,2,2,7,Regulars
43905,438,10,2818.19,2,3,5,10,Regulars
43906,142,10,2808.66,4,3,5,12,Loyal
43907,167,14,1618.6499999999999,3,5,3,11,Regulars
43908,44,15,4012.02,5,5,5,15,Champions
43909,497,8,573.78,1,2,1,4,Hibernating
43910,226,9,747.63,3,2,1,6,Regulars
43911,583,9,777.21,1,2,1,4,Hibernating
43912,119,11,1658.38,4,3,3,10,Loyal
43913,690,9,2597.09,1,2,5,8,Regulars
43914,44,8,1297.13,5,2,3,10,Regulars
43915,254,9,2348.94,2,2,4,8,Regulars
43916,258,14,2868.84,2,5,5,12,At Risk
43917,474,8,463.72,1,2,1,4,Hibernating
43918,523,7,937.4799999999999,1,1,2,4,Hibernating
43919,561,13,6582.76,1,4,5,10,At Risk
43920,57,16,3132.97,5,5,5,15,Champions
43921,578,12,1652.51,1,4,3,8,At Risk
43922,99,11,1008.51,4,3,2,9,Loyal
43923,138,9,1123.34,4,2,2,8,Regulars
43924,98,11,2477.43,4,3,4,11,Loyal
43925,285,14,1963.3899999999999,2,5,4,11,At Risk
43926,400,10,2229.68,2,3,4,9,Regulars
43927,48,15,2367.37,5,5,4,14,Champions
43928,50,10,1563.85,5,3,3,11,Loyal
43929,259,9,3323.77,2,2,5,9,Regulars
43930,563,12,3569.1400000000003,1,4,5,10,At Risk
43931,65,16,1163.0800000000002,5,5,2,12,Loyal
43932,289,8,1044.29,2,2,2,6,Hibernating
43933,213,12,1805.1000000000001,3,4,4,11,Big Spenders
43934,27,6,839.96,5,1,1,7,Regulars
43935,625,14,1978.39,1,5,4,10,At Risk
43936,177,15,2102.7200000000003,3,5,4,12,Big Spenders
43937,557,12,1322.32,1,4,3,8,At Risk
43938,326,12,1405.06,2,4,3,9,At Risk
43939,385,10,1309.8600000000001,2,3,3,8,Regulars
43940,221,11,1820.0,3,3,4,10,Big Spenders
43941,160,16,1158.19,3,5,2,10,Regulars
43942,260,9,958.74,2,2,2,6,Hibernating
43943,183,12,4348.820000000001,3,4,5,12,Big Spenders
43944,681,6,1779.83,1,1,4,6,Regulars
43945,245,14,1188.9099999999999,3,5,2,10,Regulars
43946,137,13,1416.44,4,4,3,11,Loyal
43947,300,11,2676.3700000000003,2,3,5,10,Regulars
43948,103,16,2584.56,4,5,5,14,Champions
43949,42,9,3092.7999999999997,5,2,5,12,Big Spenders
43950,288,9,882.25,2,2,2,6,Hibernating
43951,31,6,1334.83,5,1,3,9,Regulars
43952,250,13,1209.98,2,4,2,8,At Risk
43953,3,12,1901.61,5,4,4,13,Champions
43954,197,18,4241.14,3,5,5,13,Big Spenders
43955,84,16,5079.87,4,5,5,14,Champions
43956,114,8,570.5600000000001,4,2,1,7,Regulars
43957,8,11,794.24,5,3,1,9,Loyal
43958,448,12,2941.05,2,4,5,11,At Risk
43959,307,10,1969.45,2,3,4,9,Regulars
43960,197,15,3557.9300000000003,3,5,5,13,Big Spenders
43961,160,12,1871.72,3,4,4,11,Big Spenders
43962,238,13,1105.82,3,4,2,9,Regulars
43963,7,17,4070.6800000000003,5,5,5,15,Champions
43964,658,9,733.6999999999999,1,2,1,4,Hibernating
43965,185,9,2231.92,3,2,4,9,Big Spenders
43966,103,10,723.5,4,3,1,8,Loyal
43967,759,9,2838.87,1,2,5,8,Regulars
43968,85,11,1464.99,4,3,3,10,Loyal
43969,66,9,3178.1099999999997,4,2,5,11,Big Spenders
43970,734,6,1007.22,1,1,2,4,Hibernating
43971,194,17,2097.61,3,5,4,12,Big Spenders
43972,649,9,2493.8199999999997,1,2,4,7,Regulars
43973,75,12,3741.9500000000003,4,4,5,13,Champions
43974,0,15,1649.2,5,5,3,13,Loyal
43975,16,10,4547.57,5,3,5,13,Loyal
43976,6,10,1396.37,5,3,3,11,Loyal
43977,39,9,1645.05,5,2,3,10,Regulars
43978,84,12,2167.16,4,4,4,12,Champions
43979,107,14,1039.57,4,5,2,11,Loyal
43980,101,7,1703.9199999999998,4,1,3,8,Regulars
43981,125,9,1053.19,4,2,2,8,Regulars
43982,1073,9,1285.1699999999998,1,2,3,6,Regulars
43983,106,11,2627.32,4,3,5,12,Loyal
43984,243,7,796.0,3,1,1,5,Regulars
43985,107,8,934.8399999999999,4,2,2,8,Regulars
43986,121,6,439.62,4,1,1,6,Regulars
43987,582,10,1619.59,1,3,3,7,Regulars
43988,357,14,2937.66,2,5,5,12,At Risk
43989,891,6,849.0,1,1,2,4,Hibernating
43990,3,14,1171.15,5,5,2,12,Loyal
43991,300,6,3304.62,2,1,5,8,Regulars
43992,149,11,4000.05,3,3,5,11,Big Spenders
43993,512,12,1053.05,1,4,2,7,At Risk
43994,827,8,635.54,1,2,1,4,Hibernating
43995,37,12,2063.68,5,4,4,13,Champions
43996,4,18,3357.15,5,5,5,15,Champions
43997,43,11,1187.46,5,3,2,10,Loyal
43998,11,9,751.33,5,2,1,8,Regulars
43999,1484,4,888.9399999999999,1,1,2,4,Hibernating
44000,116,19,2210.9,4,5,4,13,Champions
44001,49,11,916.63,5,3,2,10,Loyal
44002,99,9,1066.25,4,2,2,8,Regulars
44003,118,11,1315.72,4,3,3,10,Loyal
44004,193,11,4595.31,3,3,5,11,Big Spenders
44005,2,9,2859.07,5,2,5,12,Big Spenders
44006,101,7,937.08,4,1,2,7,Regulars
44007,844,14,2880.05,1,5,5,11,At Risk
44008,141,13,1544.83,4,4,3,11,Loyal
44009,556,11,983.28,1,3,2,6,Regulars
44010,8,9,2354.36,5,2,4,11,Big Spenders
44011,156,8,621.88,3,2,1,6,Regulars
44012,129,9,1913.1299999999999,4,2,4,10,Big Spenders
44013,530,8,1184.89,1,2,2,5,Hibernating
44014,400,10,3118.63,2,3,5,10,Regulars
44015,305,6,648.42,2,1,1,4,Hibernating
44016,194,10,942.31,3,3,2,8,Regulars
44017,756,5,628.05,1,1,1,3,Hibernating
44018,94,8,825.5,4,2,1,7,Regulars
44019,169,13,2437.12,3,4,4,11,Big Spenders
44020,204,16,5306.540000000001,3,5,5,13,Big Spenders
44021,152,13,1562.3,3,4,3,10,Regulars
44022,37,11,1497.69,5,3,3,11,Loyal
44023,139,22,2897.91,4,5,5,14,Champions
44024,624,9,2951.0299999999997,1,2,5,8,Regulars
44025,223,9,3650.4900000000002,3,2,5,10,Big Spenders
44026,4,9,2258.4700000000003,5,2,4,11,Big Spenders
44027,236,11,899.32,3,3,2,8,Regulars
44028,540,12,3296.78,1,4,5,10,At Risk
44029,0,12,1131.04,5,4,2,11,Loyal
44030,538,11,1998.89,1,3,4,8,Regulars
44031,37,8,1217.88,5,2,2,9,Regulars
44032,140,8,815.18,4,2,1,7,Regulars
44033,311,14,4697.95,2,5,5,12,At Risk
44034,638,11,1145.8999999999999,1,3,2,6,Regulars
44035,1,13,2171.46,5,4,4,13,Champions
44036,99,11,1941.43,4,3,4,11,Loyal
44037,144,13,1365.49,4,4,3,11,Loyal
44038,216,7,1236.9,3,1,2,6,Regulars
44039,783,7,2631.7799999999997,1,1,5,7,Regulars
44040,244,5,1609.8899999999999,3,1,3,7,Regulars
44041,166,9,1409.88,3,2,3,8,Regulars
44042,348,7,913.1000000000001,2,1,2,5,Hibernating
44043,186,3,196.5,3,1,1,5,Regulars
44044,618,8,1306.07,1,2,3,6,Regulars
44045,234,10,854.13,3,3,2,8,Regulars
44046,324,17,1973.91,2,5,4,11,At Risk
44047,55,15,5327.27,5,5,5,15,Champions
44048,594,11,944.38,1,3,2,6,Regulars
44049,1,6,2432.2799999999997,5,1,4,10,Big Spenders
44050,78,9,696.26,4,2,1,7,Regulars
44051,160,12,1476.8,3,4,3,10,Regulars
44052,400,19,3103.19,2,5,5,12,At Risk
44053,35,14,3647.84,5,5,5,15,Champions
44054,979,10,1185.6200000000001,1,3,2,6,Regulars
44055,686,14,1334.21,1,5,3,9,At Risk
44056,144,16,1387.1399999999999,4,5,3,12,Loyal
44057,727,7,1215.67,1,1,2,4,Hibernating
44058,545,13,2492.72,1,4,4,9,At Risk
44059,5,8,1568.58,5,2,3,10,Regulars
44060,182,9,3951.17,3,2,5,10,Big Spenders
44061,28,13,1372.26,5,4,3,12,Loyal
44062,137,7,1953.2,4,1,4,9,Big Spenders
44063,20,12,2715.81,5,4,5,14,Champions
44064,108,7,1022.3100000000001,4,1,2,7,Regulars
44065,59,12,1381.73,5,4,3,12,Loyal
44066,169,10,1390.52,3,3,3,9,Regulars
44067,88,6,1478.63,4,1,3,8,Regulars
44068,1153,8,898.41,1,2,2,5,Hibernating
44069,374,7,674.7,2,1,1,4,Hibernating
44070,194,9,1010.23,3,2,2,7,Regulars
44071,527,8,2140.34,1,2,4,7,Regulars
44072,143,14,2040.63,4,5,4,13,Champions
44073,208,10,1586.08,3,3,3,9,Regulars
44074,284,8,1518.99,2,2,3,7,Regulars
44075,10,13,1071.4,5,4,2,11,Loyal
44076,96,15,3138.73,4,5,5,14,Champions
44077,211,13,3235.1200000000003,3,4,5,12,Big Spenders
44078,38,9,809.23,5,2,1,8,Regulars
44079,158,12,1183.24,3,4,2,9,Regulars
44080,518,7,903.24,1,1,2,4,Hibernating
44081,17,12,3791.22,5,4,5,14,Champions
44082,442,8,1563.56,2,2,3,7,Regulars
44083,2,7,691.44,5,1,1,7,Regulars
44084,51,11,1397.1700000000003,5,3,3,11,Loyal
44085,275,10,1041.3300000000002,2,3,2,7,Regulars
44086,410,10,1341.36,2,3,3,8,Regulars
44087,381,12,936.27,2,4,2,8,At Risk
44088,19,17,3069.68,5,5,5,15,Champions
44089,173,6,1540.1,3,1,3,7,Regulars
44090,12,7,1101.84,5,1,2,8,Regulars
44091,124,9,1231.9299999999998,4,2,2,8,Regulars
44092,952,5,304.68,1,1,1,3,Hibernating
44093,159,8,2789.5099999999998,3,2,5,10,Big Spenders
44094,279,3,534.6700000000001,2,1,1,4,Hibernating
44095,66,7,578.8199999999999,4,1,1,6,Regulars
44096,462,13,1016.99,1,4,2,7,At Risk
44097,1,14,2021.82,5,5,4,14,Champions
44098,40,11,1506.93,5,3,3,11,Loyal
44099,97,12,1646.38,4,4,3,11,Loyal
44100,615,5,322.7,1,1,1,3,Hibernating
44101,110,5,234.25,4,1,1,6,Regulars
44102,567,7,790.99,1,1,1,3,Hibernating
44103,17,11,1213.45,5,3,2,10,Loyal
44104,6,15,1351.59,5,5,3,13,Loyal
44105,327,8,1418.55,2,2,3,7,Regulars
44106,110,13,3301.79,4,4,5,13,Champions
44107,645,14,4813.94,1,5,5,11,At Risk
44108,453,5,549.8199999999999,2,1,1,4,Hibernating
44109,283,7,1376.41,2,1,3,6,Regulars
44110,227,11,819.2,3,3,1,7,Regulars
44111,74,12,1011.6800000000001,4,4,2,10,Loyal
44112,57,10,1247.22,5,3,3,11,Loyal
44113,1,13,2298.77,5,4,4,13,Champions
44114,113,11,686.66,4,3,1,8,Loyal
44115,307,6,273.40999999999997,2,1,1,4,Hibernating
44116,234,7,630.33,3,1,1,5,Regulars
44117,37,9,1353.27,5,2,3,10,Regulars
44118,803,10,2817.9599999999996,1,3,5,9,Regulars
44119,154,9,975.9300000000001,3,2,2,7,Regulars
44120,251,7,723.3,2,1,1,4,Hibernating
44121,753,6,1169.73,1,1,2,4,Hibernating
44122,389,9,1567.9499999999998,2,2,3,7,Regulars
44123,220,16,2371.02,3,5,4,12,Big Spenders
44124,436,12,2400.71,2,4,4,10,At Risk
44125,490,11,1838.6,1,3,4,8,Regulars
44126,186,11,2932.1299999999997,3,3,5,11,Big Spenders
44127,772,10,1189.1200000000001,1,3,2,6,Regulars
44128,176,12,626.13,3,4,1,8,Regulars
44129,61,12,1539.81,5,4,3,12,Loyal
44130,78,12,3042.7,4,4,5,13,Champions
44131,472,13,1787.66,1,4,4,9,At Risk
44132,385,10,1068.05,2,3,2,7,Regulars
44133,31,12,1550.47,5,4,3,12,Loyal
44134,197,8,1954.57,3,2,4,9,Big Spenders
44135,91,6,1552.87,4,1,3,8,Regulars
44136,229,8,986.02,3,2,2,7,Regulars
44137,578,11,1329.35,1,3,3,7,Regulars
44138,330,7,1266.14,2,1,3,6,Regulars
44139,166,16,3479.85,3,5,5,13,Big Spenders
44140,201,12,3577.86,3,4,5,12,Big Spenders
44141,390,13,1462.14,2,4,3,9,At Risk
44142,281,11,1539.94,2,3,3,8,Regulars
44143,107,11,1902.17,4,3,4,11,Loyal
44144,407,9,3060.1800000000003,2,2,5,9,Regulars
44145,519,19,3782.2899999999995,1,5,5,11,At Risk
44146,690,10,888.08,1,3,2,6,Regulars
44147,198,6,871.13,3,1,2,6,Regulars
44148,104,8,837.5899999999999,4,2,1,7,Regulars
44149,1113,9,950.5500000000001,1,2,2,5,Hibernating
44150,91,13,2163.73,4,4,4,12,Champions
44151,167,7,1680.11,3,1,3,7,Regulars
44152,226,14,3041.5699999999997,3,5,5,13,Big Spenders
44153,92,5,376.01,4,1,1,6,Regulars
44154,260,14,1675.0300000000002,2,5,3,10,At Risk
44155,158,10,1447.26,3,3,3,9,Regulars
44156,282,9,1892.3899999999999,2,2,4,8,Regulars
44157,195,9,675.14,3,2,1,6,Regulars
44158,380,5,1487.3700000000001,2,1,3,6,Regulars
44159,40,12,1231.12,5,4,2,11,Loyal
44160,35,11,1453.33,5,3,3,11,Loyal
44161,312,19,1645.18,2,5,3,10,At Risk
44162,175,14,1714.8,3,5,3,11,Regulars
44163,791,11,2279.5400000000004,1,3,4,8,Regulars
44164,48,10,2139.5099999999998,5,3,4,12,Loyal
44165,322,9,2042.33,2,2,4,8,Regulars
44166,447,11,1694.6,2,3,3,8,Regulars
44167,221,12,929.21,3,4,2,9,Regulars
44168,243,12,3805.02,3,4,5,12,Big Spenders
44169,165,11,615.3,3,3,1,7,Regulars
44170,300,8,947.01,2,2,2,6,Hibernating
44171,518,12,4818.4,1,4,5,10,At Risk
44172,298,10,2646.38,2,3,5,10,Regulars
44173,84,13,3110.34,4,4,5,13,Champions
44174,184,12,3668.3100000000004,3,4,5,12,Big Spenders
44175,184,10,1560.54,3,3,3,9,Regulars
44176,18,7,803.76,5,1,1,7,Regulars
44177,89,12,1333.32,4,4,3,11,Loyal
44178,563,16,1626.05,1,5,3,9,At Risk
44179,270,9,1201.56,2,2,2,6,Hibernating
44180,12,11,621.28,5,3,1,9,Loyal
44181,960,4,923.69,1,1,2,4,Hibernating
44182,509,8,2922.2599999999998,1,2,5,8,Regulars
44183,302,10,1807.7,2,3,4,9,Regulars
44184,383,14,2412.96,2,5,4,11,At Risk
44185,812,7,477.45,1,1,1,3,Hibernating
44186,90,9,1918.46,4,2,4,10,Big Spenders
44187,170,7,1308.59,3,1,3,7,Regulars
44188,25,10,896.7,5,3,2,10,Loyal
44189,33,18,1638.27,5,5,3,13,Loyal
44190,90,12,3753.17,4,4,5,13,Champions
44191,568,12,3062.1200000000003,1,4,5,10,At Risk
44192,173,12,2567.48,3,4,4,11,Big Spenders
44193,350,13,1543.44,2,4,3,9,At Risk
44194,475,9,1208.3700000000001,1,2,2,5,Hibernating
44195,266,12,2038.5199999999998,2,4,4,10,At Risk
44196,158,13,3413.49,3,4,5,12,Big Spenders
44197,6,15,1339.5800000000002,5,5,3,13,Loyal
44198,847,10,529.39,1,3,1,5,Regulars
44199,125,11,984.77,4,3,2,9,Loyal
44200,442,9,941.41,2,2,2,6,Hibernating
44201,870,10,2876.2799999999997,1,3,5,9,Regulars
44202,61,14,1993.48,5,5,4,14,Champions
44203,201,11,6171.57,3,3,5,11,Big Spenders
44204,238,8,761.43,3,2,1,6,Regulars
44205,47,12,1862.09,5,4,4,13,Champions
44206,832,10,1466.3899999999999,1,3,3,7,Regulars
44207,463,13,2317.31,1,4,4,9,At Risk
44208,288,11,1179.6299999999999,2,3,2,7,Regulars
44209,35,8,767.04,5,2,1,8,Regulars
44210,216,12,1832.96,3,4,4,11,Big Spenders
44211,215,11,1001.88,3,3,2,8,Regulars
44212,78,11,3270.9300000000003,4,3,5,12,Loyal
44213,464,15,3473.0900000000006,1,5,5,11,At Risk
44214,506,19,3554.95,1,5,5,11,At Risk
44215,28,10,1191.17,5,3,2,10,Loyal
44216,110,12,1614.65,4,4,3,11,Loyal
44217,36,11,1284.64,5,3,3,11,Loyal
44218,20,19,2118.2,5,5,4,14,Champions
44219,202,7,1676.94,3,1,3,7,Regulars
44220,140,8,840.74,4,2,1,7,Regulars
44221,41,7,1285.4499999999998,5,1,3,9,Regulars
44222,95,8,694.65,4,2,1,7,Regulars
44223,49,6,832.77,5,1,1,7,Regulars
44224,946,9,3539.2100000000005,1,2,5,8,Regulars
44225,1233,6,663.5,1,1,1,3,Hibernating
44226,94,10,1512.63,4,3,3,10,Loyal
44227,299,13,936.9,2,4,2,8,At Risk
44228,361,5,374.65000000000003,2,1,1,4,Hibernating
44229,200,6,506.94,3,1,1,5,Regulars
44230,66,12,1254.3999999999999,4,4,3,11,Loyal
44231,630,10,1164.25,1,3,2,6,Regulars
44232,93,13,2589.41,4,4,5,13,Champions
44233,49,16,2289.08,5,5,4,14,Champions
44234,806,9,998.95,1,2,2,5,Hibernating
44235,8,10,1075.64,5,3,2,10,Loyal
44236,62,16,2680.8199999999997,5,5,5,15,Champions
44237,216,15,1333.61,3,5,3,11,Regulars
44238,503,14,1761.3100000000002,1,5,4,10,At Risk
44239,443,9,1738.7,2,2,4,8,Regulars
44240,56,10,2248.17,5,3,4,12,Loyal
44241,4,11,2225.65,5,3,4,12,Loyal
44242,179,6,1158.13,3,1,2,6,Regulars
44243,92,10,1424.94,4,3,3,10,Loyal
44244,45,12,1293.6,5,4,3,12,Loyal
44245,506,14,2305.48,1,5,4,10,At Risk
44246,174,9,878.3,3,2,2,7,Regulars
44247,43,10,2108.94,5,3,4,12,Loyal
44248,316,6,571.51,2,1,1,4,Hibernating
44249,278,12,1455.5199999999998,2,4,3,9,At Risk
44250,640,7,418.25,1,1,1,3,Hibernating
44251,43,9,1664.19,5,2,3,10,Regulars
44252,69,12,2400.4199999999996,4,4,4,12,Champions
44253,67,9,1112.53,4,2,2,8,Regulars
44254,408,6,535.84,2,1,1,4,Hibernating
44255,289,10,1664.25,2,3,3,8,Regulars
44256,468,8,822.79,1,2,1,4,Hibernating
44257,834,7,2242.01,1,1,4,6,Regulars
44258,1388,4,681.68,1,1,1,3,Hibernating
44259,352,13,1686.19,2,4,3,9,At Risk
44260,76,15,2224.33,4,5,4,13,Champions
44261,172,10,1705.8600000000001,3,3,3,9,Regulars
44262,7,12,2360.7400000000002,5,4,4,13,Champions
44263,24,11,1126.43,5,3,2,10,Loyal
44264,87,7,851.85,4,1,2,7,Regulars
44265,76,12,1341.67,4,4,3,11,Loyal
44266,665,9,1479.3600000000001,1,2,3,6,Regulars
44267,25,9,3960.2400000000002,5,2,5,12,Big Spenders
44268,275,7,1584.76,2,1,3,6,Regulars
44269,101,6,2249.2799999999997,4,1,4,9,Big Spenders
44270,602,6,1530.98,1,1,3,5,Regulars
44271,425,10,3371.79,2,3,5,10,Regulars
44272,202,11,919.3199999999999,3,3,2,8,Regulars
44273,1807,2,334.40999999999997,1,1,1,3,Hibernating
44274,239,11,1894.95,3,3,4,10,Big Spenders
44275,40,11,846.75,5,3,2,10,Loyal
44276,111,16,2984.4800000000005,4,5,5,14,Champions
44277,12,13,1255.66,5,4,3,12,Loyal
44278,26,7,1236.89,5,1,2,8,Regulars
44279,469,11,1351.26,1,3,3,7,Regulars
44280,29,11,2885.09,5,3,5,13,Loyal
44281,56,7,1406.32,5,1,3,9,Regulars
44282,604,8,2492.3999999999996,1,2,4,7,Regulars
44283,540,5,299.51000000000005,1,1,1,3,Hibernating
44284,110,11,3044.51,4,3,5,12,Loyal
44285,886,10,1141.65,1,3,2,6,Regulars
44286,29,5,416.86,5,1,1,7,Regulars
44287,335,5,678.4,2,1,1,4,Hibernating
44288,314,10,1742.7799999999997,2,3,4,9,Regulars
44289,56,7,784.64,5,1,1,7,Regulars
44290,421,13,1344.91,2,4,3,9,At Risk
44291,15,11,1663.22,5,3,3,11,Loyal
44292,180,5,723.73,3,1,1,5,Regulars
44293,27,10,1680.73,5,3,3,11,Loyal
44294,99,13,1180.99,4,4,2,10,Loyal
44295,633,10,900.95,1,3,2,6,Regulars
44296,218,10,1370.58,3,3,3,9,Regulars
44297,231,8,682.23,3,2,1,6,Regulars
44298,287,9,837.68,2,2,1,5,Hibernating
44299,1342,6,2100.03,1,1,4,6,Regulars
44300,37,11,2095.36,5,3,4,12,Loyal
44301,505,9,807.81,1,2,1,4,Hibernating
44302,191,17,2873.48,3,5,5,13,Big Spenders
44303,362,6,792.6099999999999,2,1,1,4,Hibernating
44304,139,11,1698.1,4,3,3,10,Loyal
44305,13,12,2232.94,5,4,4,13,Champions
44306,175,11,1310.8899999999999,3,3,3,9,Regulars
44307,725,7,2388.47,1,1,4,6,Regulars
44308,211,13,1530.1599999999999,3,4,3,10,Regulars
44309,129,11,1477.62,4,3,3,10,Loyal
44310,434,7,1781.13,2,1,4,7,Regulars
44311,301,9,1239.9699999999998,2,2,2,6,Hibernating
44312,189,13,1233.01,3,4,2,9,Regulars
44313,512,12,3938.88,1,4,5,10,At Risk
44314,259,6,3051.34,2,1,5,8,Regulars
44315,186,13,590.42,3,4,1,8,Regulars
44316,33,12,1619.13,5,4,3,12,Loyal
44317,440,8,2840.9500000000003,2,2,5,9,Regulars
44318,35,9,692.84,5,2,1,8,Regulars
44319,14,12,1494.08,5,4,3,12,Loyal
44320,13,13,4480.12,5,4,5,14,Champions
44321,239,8,3844.15,3,2,5,10,Big Spenders
44322,456,6,684.0,2,1,1,4,Hibernating
44323,173,9,1414.0700000000002,3,2,3,8,Regulars
44324,174,10,513.34,3,3,1,7,Regulars
44325,336,8,1383.3899999999996,2,2,3,7,Regulars
44326,234,14,1571.1,3,5,3,11,Regulars
44327,216,8,1469.52,3,2,3,8,Regulars
44328,1279,4,683.51,1,1,1,3,Hibernating
44329,348,12,2357.73,2,4,4,10,At Risk
44330,35,13,3414.3,5,4,5,14,Champions
44331,366,14,1347.66,2,5,3,10,At Risk
44332,96,9,4849.639999999999,4,2,5,11,Big Spenders
44333,168,12,3207.53,3,4,5,12,Big Spenders
44334,593,12,3429.83,1,4,5,10,At Risk
44335,64,7,625.51,5,1,1,7,Regulars
44336,19,7,501.32000000000005,5,1,1,7,Regulars
44337,239,13,1410.31,3,4,3,10,Regulars
44338,29,19,3502.14,5,5,5,15,Champions
44339,70,11,2176.19,4,3,4,11,Loyal
44340,8,17,2761.4100000000003,5,5,5,15,Champions
44341,258,7,999.64,2,1,2,5,Hibernating
44342,209,8,774.29,3,2,1,6,Regulars
44343,519,12,5188.16,1,4,5,10,At Risk
44344,121,12,2642.2599999999998,4,4,5,13,Champions
44345,271,6,1836.6100000000001,2,1,4,7,Regulars
44346,21,13,3149.3,5,4,5,14,Champions
44347,155,12,2683.79,3,4,5,12,Big Spenders
44348,201,9,1055.81,3,2,2,7,Regulars
44349,150,12,3849.6899999999996,3,4,5,12,Big Spenders
44350,755,13,3284.66,1,4,5,10,At Risk
44351,65,16,2047.1,5,5,4,14,Champions
44352,382,8,1146.19,2,2,2,6,Hibernating
44353,93,10,2440.3700000000003,4,3,4,11,Loyal
44354,200,10,1367.45,3,3,3,9,Regulars
44355,213,11,1779.85,3,3,4,10,Big Spenders
44356,346,7,304.48,2,1,1,4,Hibernating
44357,263,9,593.77,2,2,1,5,Hibernating
44358,38,12,1013.63,5,4,2,11,Loyal
44359,401,10,2217.2200000000003,2,3,4,9,Regulars
44360,213,10,3816.23,3,3,5,11,Big Spenders
44361,7,13,1751.11,5,4,4,13,Champions
44362,139,10,3939.05,4,3,5,12,Loyal
44363,462,8,672.19,1,2,1,4,Hibernating
44364,146,11,1675.3500000000001,4,3,3,10,Loyal
44365,291,8,1082.65,2,2,2,6,Hibernating
44366,563,5,1310.52,1,1,3,5,Regulars
44367,115,7,851.52,4,1,2,7,Regulars
44368,237,11,2124.89,3,3,4,10,Big Spenders
44369,1237,9,786.23,1,2,1,4,Hibernating
44370,41,13,2051.25,5,4,4,13,Champions
44371,504,5,490.95,1,1,1,3,Hibernating
44372,66,13,1458.63,4,4,3,11,Loyal
44373,15,15,1912.26,5,5,4,14,Champions
44374,21,15,4794.11,5,5,5,15,Champions
44375,414,13,1611.33,2,4,3,9,At Risk
44376,115,13,1533.81,4,4,3,11,Loyal
44377,264,8,3428.8,2,2,5,9,Regulars
44378,103,15,1480.46,4,5,3,12,Loyal
44379,140,12,2928.81,4,4,5,13,Champions
44380,1157,4,632.6400000000001,1,1,1,3,Hibernating
44381,420,10,977.81,2,3,2,7,Regulars
44382,69,15,1504.51,4,5,3,12,Loyal
44383,92,13,1196.53,4,4,2,10,Loyal
44384,85,14,953.71,4,5,2,11,Loyal
44385,465,13,2399.9500000000003,1,4,4,9,At Risk
44386,333,15,1801.39,2,5,4,11,At Risk
44387,164,11,6255.24,3,3,5,11,Big Spenders
44388,482,13,1350.79,1,4,3,8,At Risk
44389,47,8,1506.6,5,2,3,10,Regulars
44390,510,9,1368.2699999999998,1,2,3,6,Regulars
44391,166,10,1739.79,3,3,4,10,Big Spenders
44392,75,10,2096.86,4,3,4,11,Loyal
44393,330,10,3938.83,2,3,5,10,Regulars
44394,30,8,984.3699999999999,5,2,2,9,Regulars
44395,164,14,5660.21,3,5,5,13,Big Spenders
44396,43,17,2812.0,5,5,5,15,Champions
44397,19,13,1708.55,5,4,3,12,Loyal
44398,216,4,649.73,3,1,1,5,Regulars
44399,715,11,2121.3,1,3,4,8,Regulars
44400,49,14,2323.92,5,5,4,14,Champions
44401,166,5,428.51,3,1,1,5,Regulars
44402,93,9,3847.95,4,2,5,11,Big Spenders
44403,397,11,1029.05,2,3,2,7,Regulars
44404,244,13,2111.1,3,4,4,11,Big Spenders
44405,629,8,772.5,1,2,1,4,Hibernating
44406,6,12,5849.76,5,4,5,14,Champions
44407,625,3,271.13,1,1,1,3,Hibernating
44408,104,12,1508.53,4,4,3,11,Loyal
44409,605,11,2546.54,1,3,4,8,Regulars
44410,703,16,2066.7499999999995,1,5,4,10,At Risk
44411,54,13,2124.55,5,4,4,13,Champions
44412,194,12,1216.5800000000002,3,4,2,9,Regulars
44413,214,11,1722.4499999999998,3,3,3,9,Regulars
44414,377,7,714.6999999999999,2,1,1,4,Hibernating
44415,27,11,1049.58,5,3,2,10,Loyal
44416,52,7,1106.6,5,1,2,8,Regulars
44417,200,11,2243.03,3,3,4,10,Big Spenders
44418,155,6,984.6500000000001,3,1,2,6,Regulars
44419,889,8,2142.53,1,2,4,7,Regulars
44420,342,10,1911.34,2,3,4,9,Regulars
44421,458,10,1239.19,2,3,2,7,Regulars
44422,291,6,678.27,2,1,1,4,Hibernating
44423,100,10,2258.89,4,3,4,11,Loyal
44424,321,10,1590.83,2,3,3,8,Regulars
44425,616,7,891.09,1,1,2,4,Hibernating
44426,359,7,399.94000000000005,2,1,1,4,Hibernating
44427,60,14,4297.12,5,5,5,15,Champions
44428,68,6,1272.14,4,1,3,8,Regulars
44429,351,16,2002.3200000000002,2,5,4,11,At Risk
44430,363,7,374.59999999999997,2,1,1,4,Hibernating
44431,512,11,2012.99,1,3,4,8,Regulars
44432,621,10,2384.9700000000003,1,3,4,8,Regulars
44433,172,10,1354.71,3,3,3,9,Regulars
44434,130,6,1075.17,4,1,2,7,Regulars
44435,531,8,1709.43,1,2,3,6,Regulars
44436,78,11,1754.41,4,3,4,11,Loyal
44437,267,9,1359.99,2,2,3,7,Regulars
44438,528,10,2106.13,1,3,4,8,Regulars
44439,859,9,974.21,1,2,2,5,Hibernating
44440,172,10,1579.36,3,3,3,9,Regulars
44441,85,12,1198.88,4,4,2,10,Loyal
44442,457,9,4162.469999999999,2,2,5,9,Regulars
44443,489,11,2072.29,1,3,4,8,Regulars
44444,1124,6,1124.77,1,1,2,4,Hibernating
44445,208,11,714.0300000000001,3,3,1,7,Regulars
44446,422,10,1738.1399999999999,2,3,4,9,Regulars
44447,187,9,676.06,3,2,1,6,Regulars
44448,279,9,953.0300000000001,2,2,2,6,Hibernating
44449,20,12,1200.58,5,4,2,11,Loyal
44450,269,9,959.95,2,2,2,6,Hibernating
44451,564,10,740.43,1,3,1,5,Regulars
44452,611,7,1195.76,1,1,2,4,Hibernating
44453,694,7,639.63,1,1,1,3,Hibernating
44454,1201,12,1568.2,1,4,3,8,At Risk
44455,35,13,940.0,5,4,2,11,Loyal
44456,446,9,2182.59,2,2,4,8,Regulars
44457,145,9,1156.75,4,2,2,8,Regulars
44458,37,8,773.19,5,2,1,8,Regulars
44459,402,6,642.54,2,1,1,4,Hibernating
44460,236,14,1357.33,3,5,3,11,Regulars
44461,23,8,1311.74,5,2,3,10,Regulars
44462,189,16,1784.12,3,5,4,12,Big Spenders
44463,77,8,2395.01,4,2,4,10,Big Spenders
44464,132,13,1195.9,4,4,2,10,Loyal
44465,145,12,3326.06,4,4,5,13,Champions
44466,0,9,551.3100000000001,5,2,1,8,Regulars
44467,26,9,925.45,5,2,2,9,Regulars
44468,125,11,771.2900000000001,4,3,1,8,Loyal
44469,447,10,3972.85,2,3,5,10,Regulars
44470,72,14,2082.78,4,5,4,13,Champions
44471,269,12,1567.99,2,4,3,9,At Risk
44472,118,10,1291.07,4,3,3,10,Loyal
44473,133,5,591.7700000000001,4,1,1,6,Regulars
44474,262,12,1810.51,2,4,4,10,At Risk
44475,846,10,1084.78,1,3,2,6,Regulars
44476,122,10,3077.3399999999997,4,3,5,12,Loyal
44477,285,9,2206.89,2,2,4,8,Regulars
44478,130,10,868.81,4,3,2,9,Loyal
44479,219,6,660.0699999999999,3,1,1,5,Regulars
44480,23,14,2710.41,5,5,5,15,Champions
44481,412,12,1066.52,2,4,2,8,At Risk
44482,474,8,462.28000000000003,1,2,1,4,Hibernating
44483,186,16,3768.48,3,5,5,13,Big Spenders
44484,534,10,1894.1399999999999,1,3,4,8,Regulars
44485,272,12,1164.34,2,4,2,8,At Risk
44486,338,13,1630.93,2,4,3,9,At Risk
44487,141,10,1568.24,4,3,3,10,Loyal
44488,29,11,3393.2799999999997,5,3,5,13,Loyal
44489,244,11,2683.62,3,3,5,11,Big Spenders
44490,33,12,1592.23,5,4,3,12,Loyal
44491,37,10,916.73,5,3,2,10,Loyal
44492,155,13,3686.9399999999996,3,4,5,12,Big Spenders
44493,24,18,3168.68,5,5,5,15,Champions
44494,420,11,2899.27,2,3,5,10,Regulars
44495,514,8,331.25,1,2,1,4,Hibernating
44496,25,9,950.15,5,2,2,9,Regulars
44497,261,6,2900.74,2,1,5,8,Regulars
44498,57,13,1547.01,5,4,3,12,Loyal
44499,48,13,1688.48,5,4,3,12,Loyal
44500,506,6,812.2,1,1,1,3,Hibernating
44501,410,12,1445.72,2,4,3,9,At Risk
44502,204,13,2896.02,3,4,5,12,Big Spenders
44503,837,5,755.9200000000001,1,1,1,3,Hibernating
44504,342,10,1325.23,2,3,3,8,Regulars
44505,184,12,3100.79,3,4,5,12,Big Spenders
44506,58,7,3582.96,5,1,5,11,Big Spenders
44507,272,13,1046.52,2,4,2,8,At Risk
44508,199,12,872.59,3,4,2,9,Regulars
44509,165,11,6892.89,3,3,5,11,Big Spenders
44510,174,9,2413.71,3,2,4,9,Big Spenders
44511,440,4,316.33,2,1,1,4,Hibernating
44512,66,11,1288.24,4,3,3,10,Loyal
44513,388,16,4070.1299999999997,2,5,5,12,At Risk
44514,724,15,1658.3899999999999,1,5,3,9,At Risk
44515,830,7,850.9,1,1,2,4,Hibernating
44516,133,11,1886.9299999999998,4,3,4,11,Loyal
44517,19,13,1231.69,5,4,2,11,Loyal
44518,2,18,2028.66,5,5,4,14,Champions
44519,203,11,1176.77,3,3,2,8,Regulars
44520,259,11,1622.3000000000002,2,3,3,8,Regulars
44521,110,11,3089.79,4,3,5,12,Loyal
44522,109,12,981.1,4,4,2,10,Loyal
44523,9,6,302.46,5,1,1,7,Regulars
44524,670,8,620.65,1,2,1,4,Hibernating
44525,195,8,795.1999999999999,3,2,1,6,Regulars
44526,44,12,1372.1,5,4,3,12,Loyal
44527,755,10,3155.02,1,3,5,9,Regulars
44528,334,9,1080.6200000000001,2,2,2,6,Hibernating
44529,39,12,2722.5,5,4,5,14,Champions
44530,138,12,1347.47,4,4,3,11,Loyal
44531,208,11,1800.78,3,3,4,10,Big Spenders
44532,55,17,1698.76,5,5,3,13,Loyal
44533,4,15,2208.36,5,5,4,14,Champions
44534,205,6,353.72999999999996,3,1,1,5,Regulars
44535,452,7,1059.14,2,1,2,5,Hibernating
44536,713,10,2653.6499999999996,1,3,5,9,Regulars
44537,207,12,2384.8199999999997,3,4,4,11,Big Spenders
44538,278,13,1249.48,2,4,3,9,At Risk
44539,57,12,2393.3,5,4,4,13,Champions
44540,88,12,4350.63,4,4,5,13,Champions
44541,99,5,571.48,4,1,1,6,Regulars
44542,448,8,894.95,2,2,2,6,Hibernating
44543,170,13,1319.58,3,4,3,10,Regulars
44544,148,9,1713.58,3,2,3,8,Regulars
44545,173,8,986.27,3,2,2,7,Regulars
44546,173,10,6253.7300000000005,3,3,5,11,Big Spenders
44547,221,11,1264.72,3,3,3,9,Regulars
44548,377,12,1815.2400000000002,2,4,4,10,At Risk
44549,204,8,1121.24,3,2,2,7,Regulars
44550,262,8,738.81,2,2,1,5,Hibernating
44551,8,9,404.94,5,2,1,8,Regulars
44552,8,12,1072.1100000000001,5,4,2,11,Loyal
44553,220,8,3055.4,3,2,5,10,Big Spenders
44554,161,9,4287.07,3,2,5,10,Big Spenders
44555,179,16,1567.56,3,5,3,11,Regulars
44556,158,12,1883.22,3,4,4,11,Big Spenders
44557,723,16,3294.8900000000003,1,5,5,11,At Risk
44558,108,14,1316.6,4,5,3,12,Loyal
44559,609,6,555.79,1,1,1,3,Hibernating
44560,84,6,445.86,4,1,1,6,Regulars
44561,402,7,1865.03,2,1,4,7,Regulars
44562,215,8,2251.08,3,2,4,9,Big Spenders
44563,34,14,1136.41,5,5,2,12,Loyal
44564,305,10,1101.6100000000001,2,3,2,7,Regulars
44565,686,12,2027.83,1,4,4,9,At Risk
44566,140,7,2796.45,4,1,5,10,Big Spenders
44567,647,8,1557.12,1,2,3,6,Regulars
44568,432,14,3565.28,2,5,5,12,At Risk
44569,221,9,947.51,3,2,2,7,Regulars
44570,976,9,625.0799999999999,1,2,1,4,Hibernating
44571,76,12,991.11,4,4,2,10,Loyal
44572,470,5,490.26,1,1,1,3,Hibernating
44573,297,8,1168.0,2,2,2,6,Hibernating
44574,63,18,2322.67,5,5,4,14,Champions
44575,602,8,732.2900000000001,1,2,1,4,Hibernating
44576,808,6,1119.07,1,1,2,4,Hibernating
44577,181,5,404.32,3,1,1,5,Regulars
44578,69,15,4105.88,4,5,5,14,Champions
44579,44,8,1931.8100000000002,5,2,4,11,Big Spenders
44580,129,7,1041.42,4,1,2,7,Regulars
44581,77,13,1914.6100000000001,4,4,4,12,Champions
44582,38,11,1825.3600000000001,5,3,4,12,Loyal
44583,128,14,3708.54,4,5,5,14,Champions
44584,342,5,876.0400000000001,2,1,2,5,Hibernating
44585,560,6,522.98,1,1,1,3,Hibernating
44586,63,9,825.9,5,2,1,8,Regulars
44587,320,9,861.38,2,2,2,6,Hibernating
44588,358,5,1456.15,2,1,3,6,Regulars
44589,42,12,1983.9399999999998,5,4,4,13,Champions
44590,270,12,1093.21,2,4,2,8,At Risk
44591,131,11,1353.18,4,3,3,10,Loyal
44592,831,10,737.48,1,3,1,5,Regulars
44593,9,10,1465.1399999999999,5,3,3,11,Loyal
44594,1015,11,1075.77,1,3,2,6,Regulars
44595,47,12,2289.69,5,4,4,13,Champions
44596,475,7,1424.63,1,1,3,5,Regulars
44597,23,7,821.42,5,1,1,7,Regulars
44598,389,12,1289.82,2,4,3,9,At Risk
44599,530,14,3260.72,1,5,5,11,At Risk
44600,199,9,572.83,3,2,1,6,Regulars
44601,166,10,1892.35,3,3,4,10,Big Spenders
44602,6,7,2168.1000000000004,5,1,4,10,Big Spenders
44603,149,15,3030.82,3,5,5,13,Big Spenders
44604,209,9,2061.66,3,2,4,9,Big Spenders
44605,194,11,1196.0900000000001,3,3,2,8,Regulars
44606,1273,9,531.75,1,2,1,4,Hibernating
44607,577,16,2037.56,1,5,4,10,At Risk
44608,428,7,3697.04,2,1,5,8,Regulars
44609,76,11,1795.91,4,3,4,11,Loyal
44610,96,10,1352.65,4,3,3,10,Loyal
44611,161,14,829.18,3,5,1,9,Regulars
44612,306,11,2423.24,2,3,4,9,Regulars
44613,239,11,944.6700000000001,3,3,2,8,Regulars
44614,90,10,1753.42,4,3,4,11,Loyal
44615,7,6,1193.15,5,1,2,8,Regulars
44616,290,15,3040.58,2,5,5,12,At Risk
44617,1,13,1405.3400000000001,5,4,3,12,Loyal
44618,780,5,477.13,1,1,1,3,Hibernating
44619,301,11,1237.27,2,3,2,7,Regulars
44620,30,8,970.79,5,2,2,9,Regulars
44621,9,12,2828.5,5,4,5,14,Champions
44622,34,13,1620.3,5,4,3,12,Loyal
44623,804,9,1069.27,1,2,2,5,Hibernating
44624,120,11,1011.92,4,3,2,9,Loyal
44625,58,8,706.5,5,2,1,8,Regulars
44626,93,8,705.47,4,2,1,7,Regulars
44627,641,8,785.84,1,2,1,4,Hibernating
44628,228,12,3455.8900000000003,3,4,5,12,Big Spenders
44629,241,7,505.48,3,1,1,5,Regulars
44630,250,12,769.68,2,4,1,7,At Risk
44631,817,7,1607.71,1,1,3,5,Regulars
44632,309,15,2217.57,2,5,4,11,At Risk
44633,75,11,2152.86,4,3,4,11,Loyal
44634,160,12,1263.55,3,4,3,10,Regulars
44635,364,13,1350.63,2,4,3,9,At Risk
44636,83,11,1570.52,4,3,3,10,Loyal
44637,1518,3,103.29,1,1,1,3,Hibernating
44638,138,14,1161.11,4,5,2,11,Loyal
44639,204,12,4202.119999999999,3,4,5,12,Big Spenders
44640,118,14,1763.1399999999999,4,5,4,13,Champions
44641,551,15,1232.6399999999999,1,5,2,8,At Risk
44642,155,11,2393.09,3,3,4,10,Big Spenders
44643,539,12,1738.0,1,4,4,9,At Risk
44644,211,11,2325.33,3,3,4,10,Big Spenders
44645,330,6,2332.32,2,1,4,7,Regulars
44646,281,10,1546.27,2,3,3,8,Regulars
44647,298,8,1716.91,2,2,3,7,Regulars
44648,105,12,1110.93,4,4,2,10,Loyal
44649,149,14,3709.58,3,5,5,13,Big Spenders
44650,207,11,3328.95,3,3,5,11,Big Spenders
44651,575,6,2273.08,1,1,4,6,Regulars
44652,705,9,707.4899999999999,1,2,1,4,Hibernating
44653,891,8,2369.57,1,2,4,7,Regulars
44654,503,9,1015.65,1,2,2,5,Hibernating
44655,133,10,2417.89,4,3,4,11,Loyal
44656,464,8,1025.1,1,2,2,5,Hibernating
44657,106,11,3535.09,4,3,5,12,Loyal
44658,358,16,3218.39,2,5,5,12,At Risk
44659,44,9,3187.25,5,2,5,12,Big Spenders
44660,347,9,1249.08,2,2,3,7,Regulars
44661,635,12,2314.18,1,4,4,9,At Risk
44662,30,10,845.6,5,3,2,10,Loyal
44663,65,10,2833.13,5,3,5,13,Loyal
44664,145,13,1367.71,4,4,3,11,Loyal
44665,470,12,2109.63,1,4,4,9,At Risk
44666,46,13,2297.98,5,4,4,13,Champions
44667,108,15,3046.18,4,5,5,14,Champions
44668,180,12,1498.1200000000001,3,4,3,10,Regulars
44669,675,7,1402.57,1,1,3,5,Regulars
44670,31,12,719.83,5,4,1,10,Loyal
44671,292,13,2987.36,2,4,5,11,At Risk
44672,101,12,2030.35,4,4,4,12,Champions
44673,101,14,2161.54,4,5,4,13,Champions
44674,148,13,1122.78,3,4,2,9,Regulars
44675,165,11,1982.4499999999998,3,3,4,10,Big Spenders
44676,28,11,1180.97,5,3,2,10,Loyal
44677,179,8,1222.92,3,2,2,7,Regulars
44678,305,8,901.12,2,2,2,6,Hibernating
44679,560,13,3017.4300000000003,1,4,5,10,At Risk
44680,56,17,2957.36,5,5,5,15,Champions
44681,797,8,1380.31,1,2,3,6,Regulars
44682,57,17,1509.23,5,5,3,13,Loyal
44683,209,21,5854.55,3,5,5,13,Big Spenders
44684,112,8,767.54,4,2,1,7,Regulars
44685,502,6,340.52,1,1,1,3,Hibernating
44686,389,9,418.82000000000005,2,2,1,5,Hibernating
44687,110,11,4216.08,4,3,5,12,Loyal
44688,127,10,581.4100000000001,4,3,1,8,Loyal
44689,1392,6,395.37,1,1,1,3,Hibernating
44690,127,18,5229.91,4,5,5,14,Champions
44691,645,7,709.1500000000001,1,1,1,3,Hibernating
44692,32,13,2091.26,5,4,4,13,Champions
44693,272,5,448.77,2,1,1,4,Hibernating
44694,367,8,1962.0900000000001,2,2,4,8,Regulars
44695,253,7,502.26,2,1,1,4,Hibernating
44696,274,15,2646.21,2,5,5,12,At Risk
44697,32,10,2755.7999999999997,5,3,5,13,Loyal
44698,372,9,2493.42,2,2,4,8,Regulars
44699,210,13,1615.59,3,4,3,10,Regulars
44700,45,16,2353.1,5,5,4,14,Champions
44701,170,8,684.14,3,2,1,6,Regulars
44702,103,10,1903.51,4,3,4,11,Loyal
44703,253,11,1499.68,2,3,3,8,Regulars
44704,320,8,1427.45,2,2,3,7,Regulars
44705,291,15,6347.21,2,5,5,12,At Risk
44706,93,16,2241.02,4,5,4,13,Champions
44707,96,18,3698.76,4,5,5,14,Champions
44708,507,7,1027.28,1,1,2,4,Hibernating
44709,244,7,569.33,3,1,1,5,Regulars
44710,88,8,1101.72,4,2,2,8,Regulars
44711,178,7,1758.6,3,1,4,8,Big Spenders
44712,55,8,1424.51,5,2,3,10,Regulars
44713,30,8,701.35,5,2,1,8,Regulars
44714,837,6,659.11,1,1,1,3,Hibernating
44715,447,8,468.48999999999995,2,2,1,5,Hibernating
44716,40,17,2491.55,5,5,4,14,Champions
44717,487,5,1048.75,1,1,2,4,Hibernating
44718,7,14,2643.92,5,5,5,15,Champions
44719,43,8,265.71000000000004,5,2,1,8,Regulars
44720,506,8,541.45,1,2,1,4,Hibernating
44721,209,10,995.02,3,3,2,8,Regulars
44722,520,12,1256.94,1,4,3,8,At Risk
44723,260,5,1342.8100000000002,2,1,3,6,Regulars
44724,195,11,1210.39,3,3,2,8,Regulars
44725,768,13,2776.3700000000003,1,4,5,10,At Risk
44726,240,9,780.98,3,2,1,6,Regulars
44727,148,9,1319.17,3,2,3,8,Regulars
44728,92,11,2398.29,4,3,4,11,Loyal
44729,83,10,2751.64,4,3,5,12,Loyal
44730,277,13,2607.4,2,4,5,11,At Risk
44731,277,13,1323.02,2,4,3,9,At Risk
44732,323,16,3555.32,2,5,5,12,At Risk
44733,312,9,2233.81,2,2,4,8,Regulars
44734,210,9,1552.66,3,2,3,8,Regulars
44735,557,12,2313.79,1,4,4,9,At Risk
44736,320,12,1177.9,2,4,2,8,At Risk
44737,457,11,3546.1499999999996,2,3,5,10,Regulars
44738,320,10,4621.33,2,3,5,10,Regulars
44739,226,15,4221.5,3,5,5,13,Big Spenders
44740,337,9,896.21,2,2,2,6,Hibernating
44741,390,3,134.07,2,1,1,4,Hibernating
44742,264,11,1172.13,2,3,2,7,Regulars
44743,53,11,1975.7800000000002,5,3,4,12,Loyal
44744,288,10,2874.92,2,3,5,10,Regulars
44745,194,13,1849.57,3,4,4,11,Big Spenders
44746,168,6,791.73,3,1,1,5,Regulars
44747,40,12,2039.37,5,4,4,13,Champions
44748,161,9,1775.6999999999998,3,2,4,9,Big Spenders
44749,466,9,1742.81,1,2,4,7,Regulars
44750,226,8,2360.1099999999997,3,2,4,9,Big Spenders
44751,177,7,608.3900000000001,3,1,1,5,Regulars
44752,369,8,661.24,2,2,1,5,Hibernating
44753,132,15,1692.25,4,5,3,12,Loyal
44754,20,14,1921.69,5,5,4,14,Champions
44755,80,14,3630.25,4,5,5,14,Champions
44756,372,13,1691.09,2,4,3,9,At Risk
44757,524,14,1844.22,1,5,4,10,At Risk
44758,186,10,1975.27,3,3,4,10,Big Spenders
44759,649,7,1206.3500000000001,1,1,2,4,Hibernating
44760,48,12,1958.1299999999999,5,4,4,13,Champions
44761,299,11,1807.33,2,3,4,9,Regulars
44762,143,7,564.0,4,1,1,6,Regulars
44763,76,10,2208.68,4,3,4,11,Loyal
44764,259,10,2410.52,2,3,4,9,Regulars
44765,212,10,1474.94,3,3,3,9,Regulars
44766,171,13,784.71,3,4,1,8,Regulars
44767,311,16,3502.2799999999997,2,5,5,12,At Risk
44768,119,12,801.87,4,4,1,9,Loyal
44769,104,8,940.2900000000001,4,2,2,8,Regulars
44770,48,10,2127.7400000000002,5,3,4,12,Loyal
44771,611,9,1555.36,1,2,3,6,Regulars
44772,81,8,1206.05,4,2,2,8,Regulars
44773,94,6,1674.6299999999999,4,1,3,8,Regulars
44774,101,6,1498.05,4,1,3,8,Regulars
44775,242,10,1038.08,3,3,2,8,Regulars
44776,41,10,1929.91,5,3,4,12,Loyal
44777,105,9,1889.7,4,2,4,10,Big Spenders
44778,350,11,963.61,2,3,2,7,Regulars
44779,568,8,461.72,1,2,1,4,Hibernating
44780,274,9,974.17,2,2,2,6,Hibernating
44781,415,10,1478.03,2,3,3,8,Regulars
44782,767,8,1845.4999999999998,1,2,4,7,Regulars
44783,7,11,959.7,5,3,2,10,Loyal
44784,213,15,3269.16,3,5,5,13,Big Spenders
44785,789,10,1092.77,1,3,2,6,Regulars
44786,370,9,1074.19,2,2,2,6,Hibernating
44787,39,13,1306.4499999999998,5,4,3,12,Loyal
44788,23,12,2065.5099999999998,5,4,4,13,Champions
44789,625,4,200.56,1,1,1,3,Hibernating
44790,536,8,1089.77,1,2,2,5,Hibernating
44791,14,9,783.56,5,2,1,8,Regulars
44792,127,12,3446.06,4,4,5,13,Champions
44793,87,13,1685.1399999999999,4,4,3,11,Loyal
44794,219,8,3742.0299999999997,3,2,5,10,Big Spenders
44795,191,9,2994.07,3,2,5,10,Big Spenders
44796,222,8,939.78,3,2,2,7,Regulars
44797,150,10,810.31,3,3,1,7,Regulars
44798,205,10,2165.67,3,3,4,10,Big Spenders
44799,591,6,326.15999999999997,1,1,1,3,Hibernating
44800,70,12,1167.1,4,4,2,10,Loyal
44801,148,7,630.4499999999999,3,1,1,5,Regulars
44802,234,7,743.2,3,1,1,5,Regulars
44803,48,12,3646.98,5,4,5,14,Champions
44804,564,7,734.39,1,1,1,3,Hibernating
44805,52,11,1561.21,5,3,3,11,Loyal
44806,20,15,4010.9999999999995,5,5,5,15,Champions
44807,190,17,3397.01,3,5,5,13,Big Spenders
44808,211,10,648.72,3,3,1,7,Regulars
44809,1252,10,1237.47,1,3,2,6,Regulars
44810,184,11,1961.64,3,3,4,10,Big Spenders
44811,139,13,2033.79,4,4,4,12,Champions
44812,148,9,2545.3199999999997,3,2,4,9,Big Spenders
44813,486,9,2389.61,1,2,4,7,Regulars
44814,1332,6,2459.9399999999996,1,1,4,6,Regulars
44815,226,10,1280.44,3,3,3,9,Regulars
44816,45,9,2363.0099999999998,5,2,4,11,Big Spenders
44817,243,9,1349.21,3,2,3,8,Regulars
44818,3,14,4356.06,5,5,5,15,Champions
44819,198,11,1773.65,3,3,4,10,Big Spenders
44820,9,13,4033.7700000000004,5,4,5,14,Champions
44821,277,9,2507.16,2,2,4,8,Regulars
44822,101,10,1637.26,4,3,3,10,Loyal
44823,131,4,1077.52,4,1,2,7,Regulars
44824,399,7,2047.07,2,1,4,7,Regulars
44825,541,9,1210.12,1,2,2,5,Hibernating
44826,512,6,413.17,1,1,1,3,Hibernating
44827,69,14,2898.6400000000003,4,5,5,14,Champions
44828,992,14,3971.64,1,5,5,11,At Risk
44829,249,7,453.61,2,1,1,4,Hibernating
44830,71,7,551.35,4,1,1,6,Regulars
44831,148,13,1511.6999999999998,3,4,3,10,Regulars
44832,57,10,934.9,5,3,2,10,Loyal
44833,319,15,3703.67,2,5,5,12,At Risk
44834,6,12,933.62,5,4,2,11,Loyal
44835,88,12,1426.95,4,4,3,11,Loyal
44836,33,11,739.0,5,3,1,9,Loyal
44837,89,21,3171.97,4,5,5,14,Champions
44838,352,6,722.49,2,1,1,4,Hibernating
44839,850,9,1741.77,1,2,4,7,Regulars
44840,627,8,905.31,1,2,2,5,Hibernating
44841,627,13,3036.5399999999995,1,4,5,10,At Risk
44842,702,7,1304.1299999999999,1,1,3,5,Regulars
44843,120,8,3645.1300000000006,4,2,5,11,Big Spenders
44844,48,6,947.3,5,1,2,8,Regulars
44845,4,11,2584.23,5,3,5,13,Loyal
44846,599,17,3045.8599999999997,1,5,5,11,At Risk
44847,138,12,3336.18,4,4,5,13,Champions
44848,220,6,1237.76,3,1,2,6,Regulars
44849,53,4,836.1800000000001,5,1,1,7,Regulars
44850,305,8,4454.82,2,2,5,9,Regulars
44851,139,12,1198.19,4,4,2,10,Loyal
44852,51,5,3064.19,5,1,5,11,Big Spenders
44853,451,9,1023.22,2,2,2,6,Hibernating
44854,333,9,794.51,2,2,1,5,Hibernating
44855,226,12,2376.84,3,4,4,11,Big Spenders
44856,373,12,1476.47,2,4,3,9,At Risk
44857,535,13,1889.37,1,4,4,9,At Risk
44858,211,12,2438.51,3,4,4,11,Big Spenders
44859,325,7,1911.95,2,1,4,7,Regulars
44860,167,11,6134.4,3,3,5,11,Big Spenders
44861,215,12,1520.97,3,4,3,10,Regulars
44862,807,9,624.99,1,2,1,4,Hibernating
44863,1007,12,1454.38,1,4,3,8,At Risk
44864,523,12,1306.34,1,4,3,8,At Risk
44865,91,9,1474.02,4,2,3,9,Regulars
44866,68,11,876.39,4,3,2,9,Loyal
44867,466,16,2755.35,1,5,5,11,At Risk
44868,378,8,1606.23,2,2,3,7,Regulars
44869,30,13,1228.81,5,4,2,11,Loyal
44870,165,12,3203.1600000000003,3,4,5,12,Big Spenders
44871,135,7,667.63,4,1,1,6,Regulars
44872,124,11,1761.39,4,3,4,11,Loyal
44873,1148,10,386.43,1,3,1,5,Regulars
44874,161,12,1382.78,3,4,3,10,Regulars
44875,128,11,1912.74,4,3,4,11,Loyal
44876,0,14,4520.8099999999995,5,5,5,15,Champions
44877,198,10,1363.68,3,3,3,9,Regulars
44878,230,9,1027.8,3,2,2,7,Regulars
44879,66,14,1823.44,4,5,4,13,Champions
44880,298,11,2648.1099999999997,2,3,5,10,Regulars
44881,127,8,555.0,4,2,1,7,Regulars
44882,225,13,935.19,3,4,2,9,Regulars
44883,166,9,2717.96,3,2,5,10,Big Spenders
44884,220,17,3773.27,3,5,5,13,Big Spenders
44885,220,8,887.5,3,2,2,7,Regulars
44886,523,9,1023.41,1,2,2,5,Hibernating
44887,78,8,3534.98,4,2,5,11,Big Spenders
44888,93,10,1471.48,4,3,3,10,Loyal
44889,280,13,2282.77,2,4,4,10,At Risk
44890,373,14,1954.08,2,5,4,11,At Risk
44891,833,10,3113.89,1,3,5,9,Regulars
44892,656,7,393.19,1,1,1,3,Hibernating
44893,699,6,769.39,1,1,1,3,Hibernating
44894,64,9,1036.47,5,2,2,9,Regulars
44895,191,12,2053.88,3,4,4,11,Big Spenders
44896,195,11,2881.2,3,3,5,11,Big Spenders
44897,442,10,1259.3500000000001,2,3,3,8,Regulars
44898,281,11,2679.55,2,3,5,10,Regulars
44899,209,14,1590.06,3,5,3,11,Regulars
44900,533,11,1124.33,1,3,2,6,Regulars
44901,136,7,1974.87,4,1,4,9,Big Spenders
44902,574,9,1054.58,1,2,2,5,Hibernating
44903,37,14,1748.45,5,5,4,14,Champions
44904,140,11,1514.85,4,3,3,10,Loyal
44905,207,11,1604.22,3,3,3,9,Regulars
44906,317,7,366.42,2,1,1,4,Hibernating
44907,51,12,1483.77,5,4,3,12,Loyal
44908,86,8,377.87,4,2,1,7,Regulars
44909,242,10,1415.93,3,3,3,9,Regulars
44910,109,5,1101.0900000000001,4,1,2,7,Regulars
44911,98,11,1259.99,4,3,3,10,Loyal
44912,313,8,3320.25,2,2,5,9,Regulars
44913,650,11,722.15,1,3,1,5,Regulars
44914,247,10,2492.63,3,3,4,10,Big Spenders
44915,718,5,712.91,1,1,1,3,Hibernating
44916,65,11,1336.43,5,3,3,11,Loyal
44917,140,15,2231.67,4,5,4,13,Champions
44918,206,12,2532.04,3,4,4,11,Big Spenders
44919,59,12,3223.13,5,4,5,14,Champions
44920,454,7,1376.5300000000002,2,1,3,6,Regulars
44921,25,13,1730.39,5,4,4,13,Champions
44922,157,11,459.61,3,3,1,7,Regulars
44923,116,13,1464.74,4,4,3,11,Loyal
44924,167,11,1324.32,3,3,3,9,Regulars
44925,338,10,2131.42,2,3,4,9,Regulars
44926,225,14,3104.48,3,5,5,13,Big Spenders
44927,400,9,2819.65,2,2,5,9,Regulars
44928,80,8,693.85,4,2,1,7,Regulars
44929,57,10,3258.73,5,3,5,13,Loyal
44930,169,10,906.31,3,3,2,8,Regulars
44931,947,4,306.29,1,1,1,3,Hibernating
44932,156,7,1027.1,3,1,2,6,Regulars
44933,228,8,897.9,3,2,2,7,Regulars
44934,224,7,1026.29,3,1,2,6,Regulars
44935,158,9,3527.09,3,2,5,10,Big Spenders
44936,226,8,1497.53,3,2,3,8,Regulars
44937,289,6,906.59,2,1,2,5,Hibernating
44938,151,8,912.45,3,2,2,7,Regulars
44939,196,9,1580.5200000000002,3,2,3,8,Regulars
44940,381,7,954.95,2,1,2,5,Hibernating
44941,74,7,406.36,4,1,1,6,Regulars
44942,192,14,1291.75,3,5,3,11,Regulars
44943,54,8,1163.79,5,2,2,9,Regulars
44944,123,13,2792.1800000000003,4,4,5,13,Champions
44945,32,8,995.0,5,2,2,9,Regulars
44946,80,18,3141.36,4,5,5,14,Champions
44947,539,7,1014.51,1,1,2,4,Hibernating
44948,185,8,726.53,3,2,1,6,Regulars
44949,272,9,1405.55,2,2,3,7,Regulars
44950,599,7,786.7,1,1,1,3,Hibernating
44951,201,8,1358.46,3,2,3,8,Regulars
44952,142,16,4139.05,4,5,5,14,Champions
44953,336,6,337.24,2,1,1,4,Hibernating
44954,29,8,749.3,5,2,1,8,Regulars
44955,22,9,1294.1399999999999,5,2,3,10,Regulars
44956,208,11,1068.2800000000002,3,3,2,8,Regulars
44957,107,13,975.51,4,4,2,10,Loyal
44958,878,3,397.68,1,1,1,3,Hibernating
44959,4,12,1531.1299999999999,5,4,3,12,Loyal
44960,345,10,467.86,2,3,1,6,Regulars
44961,493,8,1080.6499999999999,1,2,2,5,Hibernating
44962,19,8,1068.98,5,2,2,9,Regulars
44963,850,6,2259.39,1,1,4,6,Regulars
44964,101,6,558.17,4,1,1,6,Regulars
44965,104,14,1598.13,4,5,3,12,Loyal
44966,39,8,1243.52,5,2,3,10,Regulars
44967,170,6,589.14,3,1,1,5,Regulars
44968,152,9,859.68,3,2,2,7,Regulars
44969,195,11,3490.4500000000003,3,3,5,11,Big Spenders
44970,112,6,297.27,4,1,1,6,Regulars
44971,142,13,2388.85,4,4,4,12,Champions
44972,856,10,1006.8700000000001,1,3,2,6,Regulars
44973,669,7,2227.7000000000003,1,1,4,6,Regulars
44974,253,13,2680.6899999999996,2,4,5,11,At Risk
44975,497,14,3874.13,1,5,5,11,At Risk
44976,852,5,640.88,1,1,1,3,Hibernating
44977,163,9,1281.48,3,2,3,8,Regulars
44978,340,5,817.04,2,1,1,4,Hibernating
44979,75,8,1197.17,4,2,2,8,Regulars
44980,135,12,5081.96,4,4,5,13,Champions
44981,842,11,2016.45,1,3,4,8,Regulars
44982,52,14,1305.44,5,5,3,13,Loyal
44983,15,19,3812.84,5,5,5,15,Champions
44984,180,8,587.8199999999999,3,2,1,6,Regulars
44985,54,14,1313.01,5,5,3,13,Loyal
44986,651,5,454.78999999999996,1,1,1,3,Hibernating
44987,475,12,1144.98,1,4,2,7,At Risk
44988,106,10,1812.74,4,3,4,11,Loyal
44989,713,9,693.71,1,2,1,4,Hibernating
44990,102,12,3267.18,4,4,5,13,Champions
44991,94,10,840.17,4,3,1,8,Loyal
44992,318,11,4214.09,2,3,5,10,Regulars
44993,701,11,2644.6,1,3,5,9,Regulars
44994,154,11,2186.7999999999997,3,3,4,10,Big Spenders
44995,4,9,682.45,5,2,1,8,Regulars
44996,56,11,4210.9,5,3,5,13,Loyal
44997,40,17,2362.73,5,5,4,14,Champions
44998,33,13,2611.18,5,4,5,14,Champions
44999,26,11,2397.77,5,3,4,12,Loyal
45000,57,11,1693.0900000000001,5,3,3,11,Loyal
45001,45,10,3401.73,5,3,5,13,Loyal
45002,700,5,282.48,1,1,1,3,Hibernating
45003,746,9,2745.93,1,2,5,8,Regulars
45004,119,6,956.36,4,1,2,7,Regulars
45005,143,9,1140.18,4,2,2,8,Regulars
45006,59,11,848.47,5,3,2,10,Loyal
45007,335,13,1025.7,2,4,2,8,At Risk
45008,76,14,4068.16,4,5,5,14,Champions
45009,196,13,4231.92,3,4,5,12,Big Spenders
45010,635,7,723.65,1,1,1,3,Hibernating
45011,414,8,1721.6499999999999,2,2,3,7,Regulars
45012,65,12,2473.94,5,4,4,13,Champions
45013,29,8,1372.72,5,2,3,10,Regulars
45014,454,10,953.3199999999999,2,3,2,7,Regulars
45015,237,12,1251.93,3,4,3,10,Regulars
45016,216,6,878.37,3,1,2,6,Regulars
45017,312,8,1650.8300000000002,2,2,3,7,Regulars
45018,488,3,398.21,1,1,1,3,Hibernating
45019,108,12,2106.42,4,4,4,12,Champions
45020,210,15,1774.82,3,5,4,12,Big Spenders
45021,17,11,1553.04,5,3,3,11,Loyal
45022,89,8,2749.35,4,2,5,11,Big Spenders
45023,9,8,2372.9500000000003,5,2,4,11,Big Spenders
45024,235,9,944.8599999999999,3,2,2,7,Regulars
45025,24,11,1601.04,5,3,3,11,Loyal
45026,360,9,1316.56,2,2,3,7,Regulars
45027,1179,3,600.89,1,1,1,3,Hibernating
45028,75,11,1212.23,4,3,2,9,Loyal
45029,117,5,555.7800000000001,4,1,1,6,Regulars
45030,882,7,2296.68,1,1,4,6,Regulars
45031,218,16,1355.33,3,5,3,11,Regulars
45032,214,11,2794.43,3,3,5,11,Big Spenders
45033,337,13,1372.28,2,4,3,9,At Risk
45034,338,9,1062.47,2,2,2,6,Hibernating
45035,905,8,987.0699999999999,1,2,2,5,Hibernating
45036,491,10,1671.72,1,3,3,7,Regulars
45037,101,17,1838.13,4,5,4,13,Champions
45038,569,11,1063.02,1,3,2,6,Regulars
45039,211,6,2154.0099999999998,3,1,4,8,Big Spenders
45040,44,10,2782.95,5,3,5,13,Loyal
45041,815,6,1828.8899999999999,1,1,4,6,Regulars
45042,174,11,890.67,3,3,2,8,Regulars
45043,20,12,2539.02,5,4,4,13,Champions
45044,331,8,1338.77,2,2,3,7,Regulars
45045,458,9,3689.15,2,2,5,9,Regulars
45046,515,8,962.97,1,2,2,5,Hibernating
45047,208,9,2058.08,3,2,4,9,Big Spenders
45048,45,15,2213.57,5,5,4,14,Champions
45049,514,10,2721.83,1,3,5,9,Regulars
45050,14,16,4140.46,5,5,5,15,Champions
45051,54,8,715.25,5,2,1,8,Regulars
45052,429,7,1069.37,2,1,2,5,Hibernating
45053,656,9,1587.5100000000002,1,2,3,6,Regulars
45054,337,16,6516.570000000001,2,5,5,12,At Risk
45055,48,12,3350.75,5,4,5,14,Champions
45056,243,8,2754.41,3,2,5,10,Big Spenders
45057,355,8,1566.98,2,2,3,7,Regulars
45058,623,6,1199.49,1,1,2,4,Hibernating
45059,75,10,1244.16,4,3,3,10,Loyal
45060,30,17,1990.6299999999999,5,5,4,14,Champions
45061,126,12,1190.48,4,4,2,10,Loyal
45062,197,11,766.8,3,3,1,7,Regulars
45063,449,14,3173.08,2,5,5,12,At Risk
45064,257,9,589.4300000000001,2,2,1,5,Hibernating
45065,139,8,817.11,4,2,1,7,Regulars
45066,213,11,1037.75,3,3,2,8,Regulars
45067,78,11,1401.89,4,3,3,10,Loyal
45068,99,8,830.05,4,2,1,7,Regulars
45069,454,5,1480.95,2,1,3,6,Regulars
45070,479,6,628.77,1,1,1,3,Hibernating
45071,220,9,999.78,3,2,2,7,Regulars
45072,35,14,1813.97,5,5,4,14,Champions
45073,34,9,1036.61,5,2,2,9,Regulars
45074,703,11,3228.04,1,3,5,9,Regulars
45075,137,8,1636.97,4,2,3,9,Regulars
45076,331,7,1117.6599999999999,2,1,2,5,Hibernating
45077,59,14,1834.24,5,5,4,14,Champions
45078,1630,5,562.94,1,1,1,3,Hibernating
45079,313,13,1321.49,2,4,3,9,At Risk
45080,603,5,236.47,1,1,1,3,Hibernating
45081,846,8,3039.9,1,2,5,8,Regulars
45082,6,6,566.1600000000001,5,1,1,7,Regulars
45083,212,7,1790.8700000000001,3,1,4,8,Big Spenders
45084,66,9,1534.85,4,2,3,9,Regulars
45085,220,9,2356.82,3,2,4,9,Big Spenders
45086,85,10,722.48,4,3,1,8,Loyal
45087,160,14,3018.66,3,5,5,13,Big Spenders
45088,699,11,2144.06,1,3,4,8,Regulars
45089,63,7,2055.01,5,1,4,10,Big Spenders
45090,174,6,2332.5699999999997,3,1,4,8,Big Spenders
45091,241,11,2721.1800000000003,3,3,5,11,Big Spenders
45092,791,9,908.1,1,2,2,5,Hibernating
45093,49,12,1531.02,5,4,3,12,Loyal
45094,573,13,2646.67,1,4,5,10,At Risk
45095,427,8,1418.7,2,2,3,7,Regulars
45096,229,7,1155.84,3,1,2,6,Regulars
45097,337,7,1095.67,2,1,2,5,Hibernating
45098,639,7,1798.15,1,1,4,6,Regulars
45099,272,11,2149.11,2,3,4,9,Regulars
45100,139,14,5037.82,4,5,5,14,Champions
45101,87,11,1099.01,4,3,2,9,Loyal
45102,429,13,4831.64,2,4,5,11,At Risk
45103,192,13,2203.5299999999997,3,4,4,11,Big Spenders
45104,625,3,310.27,1,1,1,3,Hibernating
45105,830,11,1156.39,1,3,2,6,Regulars
45106,575,7,948.1400000000001,1,1,2,4,Hibernating
45107,436,7,2463.59,2,1,4,7,Regulars
45108,384,8,1530.5300000000002,2,2,3,7,Regulars
45109,299,10,1328.6100000000001,2,3,3,8,Regulars
45110,335,21,1759.07,2,5,4,11,At Risk
45111,480,13,5046.7,1,4,5,10,At Risk
45112,242,13,1456.6399999999999,3,4,3,10,Regulars
45113,682,8,1825.15,1,2,4,7,Regulars
45114,135,10,893.66,4,3,2,9,Loyal
45115,246,11,2163.29,3,3,4,10,Big Spenders
45116,181,8,1107.29,3,2,2,7,Regulars
45117,23,5,595.39,5,1,1,7,Regulars
45118,293,9,886.0000000000001,2,2,2,6,Hibernating
45119,122,15,3644.42,4,5,5,14,Champions
45120,1039,5,304.53999999999996,1,1,1,3,Hibernating
45121,112,6,585.4499999999999,4,1,1,6,Regulars
45122,149,10,2134.85,3,3,4,10,Big Spenders
45123,811,9,981.14,1,2,2,5,Hibernating
45124,408,9,1648.12,2,2,3,7,Regulars
45125,61,8,1219.46,5,2,2,9,Regulars
45126,870,6,2071.55,1,1,4,6,Regulars
45127,221,15,1821.42,3,5,4,12,Big Spenders
45128,0,14,2898.1000000000004,5,5,5,15,Champions
45129,49,9,1477.01,5,2,3,10,Regulars
45130,270,12,1092.8600000000001,2,4,2,8,At Risk
45131,725,6,860.01,1,1,2,4,Hibernating
45132,150,11,2813.6200000000003,3,3,5,11,Big Spenders
45133,203,10,725.0,3,3,1,7,Regulars
45134,1053,6,847.42,1,1,2,4,Hibernating
45135,14,15,3777.31,5,5,5,15,Champions
45136,398,5,998.45,2,1,2,5,Hibernating
45137,189,11,3600.13,3,3,5,11,Big Spenders
45138,75,10,897.56,4,3,2,9,Loyal
45139,292,12,3244.93,2,4,5,11,At Risk
45140,802,7,999.55,1,1,2,4,Hibernating
45141,40,11,1541.69,5,3,3,11,Loyal
45142,297,13,984.0600000000001,2,4,2,8,At Risk
45143,161,14,1969.23,3,5,4,12,Big Spenders
45144,49,8,899.3000000000001,5,2,2,9,Regulars
45145,447,7,565.5600000000001,2,1,1,4,Hibernating
45146,134,12,1533.27,4,4,3,11,Loyal
45147,78,13,1390.6200000000001,4,4,3,11,Loyal
45148,486,16,2716.8,1,5,5,11,At Risk
45149,526,9,1739.1599999999999,1,2,4,7,Regulars
45150,781,9,4648.55,1,2,5,8,Regulars
45151,645,6,773.0100000000001,1,1,1,3,Hibernating
45152,1200,4,2460.48,1,1,4,6,Regulars
45153,93,12,747.24,4,4,1,9,Loyal
45154,747,12,1158.68,1,4,2,7,At Risk
45155,41,7,605.39,5,1,1,7,Regulars
45156,730,8,1512.52,1,2,3,6,Regulars
45157,277,8,719.0899999999999,2,2,1,5,Hibernating
45158,81,14,3980.91,4,5,5,14,Champions
45159,247,9,916.67,3,2,2,7,Regulars
45160,189,10,3773.4599999999996,3,3,5,11,Big Spenders
45161,145,4,330.02,4,1,1,6,Regulars
45162,101,10,1374.39,4,3,3,10,Loyal
45163,476,5,326.86,1,1,1,3,Hibernating
45164,309,12,1231.87,2,4,2,8,At Risk
45165,23,15,2253.4,5,5,4,14,Champions
45166,17,6,414.32,5,1,1,7,Regulars
45167,17,8,1593.1299999999999,5,2,3,10,Regulars
45168,624,10,1754.6999999999998,1,3,4,8,Regulars
45169,32,10,2045.24,5,3,4,12,Loyal
45170,139,9,1230.4,4,2,2,8,Regulars
45171,163,11,1582.63,3,3,3,9,Regulars
45172,245,12,1684.32,3,4,3,10,Regulars
45173,52,9,4746.43,5,2,5,12,Big Spenders
45174,124,13,2794.31,4,4,5,13,Champions
45175,251,7,1033.67,2,1,2,5,Hibernating
45176,118,11,906.67,4,3,2,9,Loyal
45177,271,12,1081.11,2,4,2,8,At Risk
45178,6,20,3484.44,5,5,5,15,Champions
45179,143,12,2272.61,4,4,4,12,Champions
45180,449,5,448.26,2,1,1,4,Hibernating
45181,285,13,3954.8599999999997,2,4,5,11,At Risk
45182,1076,5,627.5,1,1,1,3,Hibernating
45183,212,11,1745.31,3,3,4,10,Big Spenders
45184,40,11,3125.5299999999997,5,3,5,13,Loyal
45185,308,9,965.27,2,2,2,6,Hibernating
45186,158,12,2677.71,3,4,5,12,Big Spenders
45187,99,9,1501.83,4,2,3,9,Regulars
45188,195,13,985.6800000000001,3,4,2,9,Regulars
45189,723,6,447.46000000000004,1,1,1,3,Hibernating
45190,318,7,935.99,2,1,2,5,Hibernating
45191,135,12,3349.2300000000005,4,4,5,13,Champions
45192,53,9,961.41,5,2,2,9,Regulars
45193,76,13,1703.63,4,4,3,11,Loyal
45194,671,9,867.22,1,2,2,5,Hibernating
45195,542,8,2686.2999999999997,1,2,5,8,Regulars
45196,505,13,1506.43,1,4,3,8,At Risk
45197,441,14,3210.8900000000003,2,5,5,12,At Risk
45198,142,13,1719.3700000000001,4,4,3,11,Loyal
45199,56,12,822.47,5,4,1,10,Loyal
45200,6,8,1559.0,5,2,3,10,Regulars
45201,106,15,1945.7,4,5,4,13,Champions
45202,260,10,1811.8300000000002,2,3,4,9,Regulars
45203,223,9,531.26,3,2,1,6,Regulars
45204,497,9,769.3000000000001,1,2,1,4,Hibernating
45205,258,17,3097.0,2,5,5,12,At Risk
45206,284,7,2091.59,2,1,4,7,Regulars
45207,133,9,2069.61,4,2,4,10,Big Spenders
45208,127,17,3020.2400000000002,4,5,5,14,Champions
45209,102,8,1041.55,4,2,2,8,Regulars
45210,135,10,2599.33,4,3,5,12,Loyal
45211,74,9,1214.58,4,2,2,8,Regulars
45212,11,11,2723.3700000000003,5,3,5,13,Loyal
45213,228,10,1100.88,3,3,2,8,Regulars
45214,712,13,2957.55,1,4,5,10,At Risk
45215,42,8,968.53,5,2,2,9,Regulars
45216,281,9,1257.73,2,2,3,7,Regulars
45217,184,19,3753.8799999999997,3,5,5,13,Big Spenders
45218,155,9,1293.3999999999999,3,2,3,8,Regulars
45219,80,9,2027.27,4,2,4,10,Big Spenders
45220,23,9,4423.18,5,2,5,12,Big Spenders
45221,37,12,3525.56,5,4,5,14,Champions
45222,220,10,1117.8,3,3,2,8,Regulars
45223,371,11,1888.57,2,3,4,9,Regulars
45224,409,12,1590.49,2,4,3,9,At Risk
45225,398,8,920.51,2,2,2,6,Hibernating
45226,644,10,3239.16,1,3,5,9,Regulars
45227,262,16,2152.21,2,5,4,11,At Risk
45228,76,11,1088.36,4,3,2,9,Loyal
45229,281,9,1043.74,2,2,2,6,Hibernating
45230,89,10,1032.8999999999999,4,3,2,9,Loyal
45231,52,9,3611.26,5,2,5,12,Big Spenders
45232,193,17,2451.87,3,5,4,12,Big Spenders
45233,94,11,737.8199999999999,4,3,1,8,Loyal
45234,10,11,2601.02,5,3,5,13,Loyal
45235,699,10,1172.98,1,3,2,6,Regulars
45236,270,10,1700.09,2,3,3,8,Regulars
45237,96,12,1302.13,4,4,3,11,Loyal
45238,476,9,3265.55,1,2,5,8,Regulars
45239,148,9,1972.76,3,2,4,9,Big Spenders
45240,391,10,2866.4700000000003,2,3,5,10,Regulars
45241,619,8,1893.79,1,2,4,7,Regulars
45242,479,10,2148.85,1,3,4,8,Regulars
45243,158,11,1365.6200000000001,3,3,3,9,Regulars
45244,38,10,2889.29,5,3,5,13,Loyal
45245,848,6,540.92,1,1,1,3,Hibernating
45246,281,13,2296.02,2,4,4,10,At Risk
45247,90,8,3133.9499999999994,4,2,5,11,Big Spenders
45248,112,11,1239.85,4,3,2,9,Loyal
45249,382,9,833.9,2,2,1,5,Hibernating
45250,224,10,992.0799999999999,3,3,2,8,Regulars
45251,66,9,2268.87,4,2,4,10,Big Spenders
45252,493,12,1448.05,1,4,3,8,At Risk
45253,439,5,2178.8,2,1,4,7,Regulars
45254,97,15,2836.35,4,5,5,14,Champions
45255,14,18,3381.64,5,5,5,15,Champions
45256,119,8,884.15,4,2,2,8,Regulars
45257,142,12,1377.23,4,4,3,11,Loyal
45258,249,11,1917.27,2,3,4,9,Regulars
45259,106,14,1976.3,4,5,4,13,Champions
45260,573,18,7757.1,1,5,5,11,At Risk
45261,96,10,1018.05,4,3,2,9,Loyal
45262,132,6,1230.6100000000001,4,1,2,7,Regulars
45263,96,9,1092.22,4,2,2,8,Regulars
45264,580,10,1315.0,1,3,3,7,Regulars
45265,608,5,443.06,1,1,1,3,Hibernating
45266,0,12,1412.17,5,4,3,12,Loyal
45267,122,11,1823.72,4,3,4,11,Loyal
45268,235,18,2406.1800000000003,3,5,4,12,Big Spenders
45269,385,11,1306.67,2,3,3,8,Regulars
45270,161,14,1018.7,3,5,2,10,Regulars
45271,425,8,857.65,2,2,2,6,Hibernating
45272,165,12,2077.4900000000002,3,4,4,11,Big Spenders
45273,906,4,1971.7400000000002,1,1,4,6,Regulars
45274,998,9,703.9,1,2,1,4,Hibernating
45275,109,12,1453.51,4,4,3,11,Loyal
45276,321,12,3722.65,2,4,5,11,At Risk
45277,76,9,1427.72,4,2,3,9,Regulars
45278,211,9,460.44,3,2,1,6,Regulars
45279,45,8,658.3,5,2,1,8,Regulars
45280,213,9,1091.68,3,2,2,7,Regulars
45281,225,10,1025.06,3,3,2,8,Regulars
45282,185,11,902.28,3,3,2,8,Regulars
45283,93,8,755.4200000000001,4,2,1,7,Regulars
45284,116,9,2021.43,4,2,4,10,Big Spenders
45285,99,11,2622.37,4,3,5,12,Loyal
45286,239,10,1062.51,3,3,2,8,Regulars
45287,58,9,2792.79,5,2,5,12,Big Spenders
45288,30,15,4310.61,5,5,5,15,Champions
45289,233,11,2033.3600000000001,3,3,4,10,Big Spenders
45290,146,11,949.22,4,3,2,9,Loyal
45291,184,8,3074.04,3,2,5,10,Big Spenders
45292,266,9,994.06,2,2,2,6,Hibernating
45293,282,12,3654.7700000000004,2,4,5,11,At Risk
45294,172,9,3313.26,3,2,5,10,Big Spenders
45295,186,11,953.6,3,3,2,8,Regulars
45296,121,15,2821.13,4,5,5,14,Champions
45297,82,8,4018.34,4,2,5,11,Big Spenders
45298,296,12,2418.27,2,4,4,10,At Risk
45299,227,16,1914.71,3,5,4,12,Big Spenders
45300,581,9,1158.55,1,2,2,5,Hibernating
45301,6,13,3487.28,5,4,5,14,Champions
45302,152,11,762.64,3,3,1,7,Regulars
45303,11,9,795.2,5,2,1,8,Regulars
45304,292,9,3895.39,2,2,5,9,Regulars
45305,18,9,1228.5300000000002,5,2,2,9,Regulars
45306,551,11,1805.19,1,3,4,8,Regulars
45307,527,10,1818.83,1,3,4,8,Regulars
45308,578,18,3342.8,1,5,5,11,At Risk
45309,108,10,2010.3600000000001,4,3,4,11,Loyal
45310,38,7,2440.2599999999998,5,1,4,10,Big Spenders
45311,588,11,2752.06,1,3,5,9,Regulars
45312,18,11,1569.3,5,3,3,11,Loyal
45313,80,8,1146.05,4,2,2,8,Regulars
45314,554,9,553.6700000000001,1,2,1,4,Hibernating
45315,30,10,3439.29,5,3,5,13,Loyal
45316,219,13,2801.96,3,4,5,12,Big Spenders
45317,38,9,1263.3,5,2,3,10,Regulars
45318,296,12,1658.92,2,4,3,9,At Risk
45319,424,6,725.24,2,1,1,4,Hibernating
45320,176,10,1882.72,3,3,4,10,Big Spenders
45321,86,7,610.3399999999999,4,1,1,6,Regulars
45322,67,10,1236.94,4,3,2,9,Loyal
45323,893,11,1082.78,1,3,2,6,Regulars
45324,522,12,2521.42,1,4,4,9,At Risk
45325,935,7,720.29,1,1,1,3,Hibernating
45326,946,4,772.36,1,1,1,3,Hibernating
45327,26,8,1163.65,5,2,2,9,Regulars
45328,190,8,2464.23,3,2,4,9,Big Spenders
45329,228,10,1115.82,3,3,2,8,Regulars
45330,361,7,1507.69,2,1,3,6,Regulars
45331,453,12,792.7,2,4,1,7,At Risk
45332,72,14,1335.46,4,5,3,12,Loyal
45333,193,10,2025.59,3,3,4,10,Big Spenders
45334,435,9,1967.32,2,2,4,8,Regulars
45335,40,13,2123.78,5,4,4,13,Champions
45336,60,9,615.47,5,2,1,8,Regulars
45337,348,12,1972.6,2,4,4,10,At Risk
45338,29,11,2891.1000000000004,5,3,5,13,Loyal
45339,641,6,944.26,1,1,2,4,Hibernating
45340,235,13,2193.6,3,4,4,11,Big Spenders
45341,196,17,2573.75,3,5,5,13,Big Spenders
45342,851,7,888.9200000000001,1,1,2,4,Hibernating
45343,162,7,680.85,3,1,1,5,Regulars
45344,595,7,2691.11,1,1,5,7,Regulars
45345,58,8,1235.1100000000001,5,2,2,9,Regulars
45346,210,7,574.55,3,1,1,5,Regulars
45347,329,10,3272.75,2,3,5,10,Regulars
45348,183,11,1301.97,3,3,3,9,Regulars
45349,24,14,2097.2799999999997,5,5,4,14,Champions
45350,173,9,634.7,3,2,1,6,Regulars
45351,189,16,3102.4399999999996,3,5,5,13,Big Spenders
45352,9,16,2340.99,5,5,4,14,Champions
45353,283,7,1048.27,2,1,2,5,Hibernating
45354,1099,9,4239.5,1,2,5,8,Regulars
45355,42,10,1787.74,5,3,4,12,Loyal
45356,272,8,947.4399999999999,2,2,2,6,Hibernating
45357,598,14,1509.23,1,5,3,9,At Risk
45358,135,8,1137.3,4,2,2,8,Regulars
45359,255,7,1524.04,2,1,3,6,Regulars
45360,35,10,894.2800000000001,5,3,2,10,Loyal
45361,523,8,803.31,1,2,1,4,Hibernating
45362,2,9,1442.68,5,2,3,10,Regulars
45363,53,12,976.98,5,4,2,11,Loyal
45364,6,12,4406.5,5,4,5,14,Champions
45365,48,13,919.4300000000001,5,4,2,11,Loyal
45366,23,14,1315.92,5,5,3,13,Loyal
45367,379,9,614.59,2,2,1,5,Hibernating
45368,208,10,1524.6000000000001,3,3,3,9,Regulars
45369,5,11,2644.96,5,3,5,13,Loyal
45370,193,6,588.53,3,1,1,5,Regulars
45371,393,5,1273.27,2,1,3,6,Regulars
45372,83,10,2749.1000000000004,4,3,5,12,Loyal
45373,2,13,1115.82,5,4,2,11,Loyal
45374,117,13,1714.42,4,4,3,11,Loyal
45375,90,12,865.91,4,4,2,10,Loyal
45376,111,7,748.22,4,1,1,6,Regulars
45377,522,5,463.26,1,1,1,3,Hibernating
45378,56,4,524.4,5,1,1,7,Regulars
45379,362,5,1602.44,2,1,3,6,Regulars
45380,967,7,786.37,1,1,1,3,Hibernating
45381,477,7,837.85,1,1,1,3,Hibernating
45382,177,14,3853.8199999999997,3,5,5,13,Big Spenders
45383,162,15,1536.67,3,5,3,11,Regulars
45384,404,14,1152.83,2,5,2,9,At Risk
45385,7,12,5797.67,5,4,5,14,Champions
45386,92,10,2511.35,4,3,4,11,Loyal
45387,232,9,843.86,3,2,1,6,Regulars
45388,125,12,2060.4500000000003,4,4,4,12,Champions
45389,156,15,1837.3400000000001,3,5,4,12,Big Spenders
45390,17,8,2402.9900000000002,5,2,4,11,Big Spenders
45391,187,11,1198.44,3,3,2,8,Regulars
45392,42,10,1213.07,5,3,2,10,Loyal
45393,12,10,856.37,5,3,2,10,Loyal
45394,597,11,1857.44,1,3,4,8,Regulars
45395,124,10,2426.81,4,3,4,11,Loyal
45396,120,11,1695.18,4,3,3,10,Loyal
45397,225,13,2957.21,3,4,5,12,Big Spenders
45398,158,11,2552.25,3,3,4,10,Big Spenders
45399,656,11,2668.59,1,3,5,9,Regulars
45400,0,9,2343.4100000000003,5,2,4,11,Big Spenders
45401,75,13,1391.67,4,4,3,11,Loyal
45402,197,9,1472.46,3,2,3,8,Regulars
45403,291,8,2037.72,2,2,4,8,Regulars
45404,129,14,1870.7199999999998,4,5,4,13,Champions
45405,201,11,820.58,3,3,1,7,Regulars
45406,6,12,1560.14,5,4,3,12,Loyal
45407,182,13,1537.85,3,4,3,10,Regulars
45408,125,10,1525.4,4,3,3,10,Loyal
45409,6,9,906.6700000000001,5,2,2,9,Regulars
45410,231,9,684.73,3,2,1,6,Regulars
45411,83,8,841.72,4,2,1,7,Regulars
45412,593,13,4580.75,1,4,5,10,At Risk
45413,174,13,1260.58,3,4,3,10,Regulars
45414,51,10,1344.16,5,3,3,11,Loyal
45415,873,8,1297.66,1,2,3,6,Regulars
45416,137,3,2121.77,4,1,4,9,Big Spenders
45417,570,7,3935.3000000000006,1,1,5,7,Regulars
45418,59,12,2213.11,5,4,4,13,Champions
45419,243,14,5164.429999999999,3,5,5,13,Big Spenders
45420,111,10,852.02,4,3,2,9,Loyal
45421,180,10,3326.8900000000003,3,3,5,11,Big Spenders
45422,48,13,2768.49,5,4,5,14,Champions
45423,268,9,2237.8,2,2,4,8,Regulars
45424,214,7,1371.3999999999999,3,1,3,7,Regulars
45425,496,11,1792.6399999999999,1,3,4,8,Regulars
45426,285,14,2427.06,2,5,4,11,At Risk
45427,113,11,1361.06,4,3,3,10,Loyal
45428,34,9,1472.01,5,2,3,10,Regulars
45429,90,7,752.64,4,1,1,6,Regulars
45430,84,13,1954.84,4,4,4,12,Champions
45431,626,7,365.84,1,1,1,3,Hibernating
45432,119,9,762.61,4,2,1,7,Regulars
45433,622,4,1225.09,1,1,2,4,Hibernating
45434,6,5,433.64,5,1,1,7,Regulars
45435,204,6,1205.99,3,1,2,6,Regulars
45436,640,5,532.25,1,1,1,3,Hibernating
45437,265,9,3392.89,2,2,5,9,Regulars
45438,261,8,1189.07,2,2,2,6,Hibernating
45439,198,8,820.79,3,2,1,6,Regulars
45440,362,11,1394.3,2,3,3,8,Regulars
45441,50,13,4888.25,5,4,5,14,Champions
45442,399,8,647.02,2,2,1,5,Hibernating
45443,223,6,4386.8,3,1,5,9,Big Spenders
45444,0,9,1633.5,5,2,3,10,Regulars
45445,180,12,2200.17,3,4,4,11,Big Spenders
45446,106,12,1818.4499999999998,4,4,4,12,Champions
45447,77,11,1109.46,4,3,2,9,Loyal
45448,112,10,1167.23,4,3,2,9,Loyal
45449,337,9,792.9399999999999,2,2,1,5,Hibernating
45450,68,12,924.6899999999999,4,4,2,10,Loyal
45451,136,11,1264.07,4,3,3,10,Loyal
45452,168,10,1727.53,3,3,4,10,Big Spenders
45453,609,5,766.43,1,1,1,3,Hibernating
45454,170,11,2786.6,3,3,5,11,Big Spenders
45455,483,8,1045.42,1,2,2,5,Hibernating
45456,7,12,1049.22,5,4,2,11,Loyal
45457,762,8,724.3,1,2,1,4,Hibernating
45458,279,4,188.88,2,1,1,4,Hibernating
45459,480,10,833.86,1,3,1,5,Regulars
45460,241,7,1929.73,3,1,4,8,Big Spenders
45461,102,10,1901.74,4,3,4,11,Loyal
45462,253,6,373.62,2,1,1,4,Hibernating
45463,290,11,1144.83,2,3,2,7,Regulars
45464,110,11,2641.5599999999995,4,3,5,12,Loyal
45465,938,9,833.0799999999999,1,2,1,4,Hibernating
45466,531,10,1215.58,1,3,2,6,Regulars
45467,59,12,4040.3799999999997,5,4,5,14,Champions
45468,372,8,466.93,2,2,1,5,Hibernating
45469,1556,6,1242.5600000000002,1,1,3,5,Regulars
45470,436,9,829.81,2,2,1,5,Hibernating
45471,31,15,1592.86,5,5,3,13,Loyal
45472,43,13,3202.63,5,4,5,14,Champions
45473,82,12,2832.2000000000003,4,4,5,13,Champions
45474,239,8,1328.65,3,2,3,8,Regulars
45475,365,6,306.17,2,1,1,4,Hibernating
45476,301,9,733.06,2,2,1,5,Hibernating
45477,861,6,1336.94,1,1,3,5,Regulars
45478,76,11,2611.1800000000003,4,3,5,12,Loyal
45479,438,15,1538.99,2,5,3,10,At Risk
45480,615,10,948.25,1,3,2,6,Regulars
45481,526,16,3987.7000000000003,1,5,5,11,At Risk
45482,126,9,982.71,4,2,2,8,Regulars
45483,983,9,1041.79,1,2,2,5,Hibernating
45484,65,10,1733.9299999999998,5,3,4,12,Loyal
45485,69,13,1350.81,4,4,3,11,Loyal
45486,365,9,3547.8900000000003,2,2,5,9,Regulars
45487,111,10,1137.39,4,3,2,9,Loyal
45488,13,9,1354.42,5,2,3,10,Regulars
45489,720,7,567.97,1,1,1,3,Hibernating
45490,54,11,1111.7799999999997,5,3,2,10,Loyal
45491,715,12,1833.28,1,4,4,9,At Risk
45492,71,9,636.98,4,2,1,7,Regulars
45493,161,12,4009.05,3,4,5,12,Big Spenders
45494,132,8,569.87,4,2,1,7,Regulars
45495,298,9,1450.82,2,2,3,7,Regulars
45496,262,8,995.2,2,2,2,6,Hibernating
45497,81,7,1672.52,4,1,3,8,Regulars
45498,26,10,1199.96,5,3,2,10,Loyal
45499,628,9,1056.74,1,2,2,5,Hibernating
45500,1077,5,2386.27,1,1,4,6,Regulars
45501,35,8,2375.54,5,2,4,11,Big Spenders
45502,143,8,1075.99,4,2,2,8,Regulars
45503,119,13,5334.75,4,4,5,13,Champions
45504,204,10,3680.66,3,3,5,11,Big Spenders
45505,101,14,2990.67,4,5,5,14,Champions
45506,1149,7,758.26,1,1,1,3,Hibernating
45507,189,6,166.0,3,1,1,5,Regulars
45508,83,9,881.41,4,2,2,8,Regulars
45509,0,15,2614.7799999999997,5,5,5,15,Champions
45510,148,7,1474.88,3,1,3,7,Regulars
45511,576,8,598.45,1,2,1,4,Hibernating
45512,61,8,2178.82,5,2,4,11,Big Spenders
45513,477,9,1197.33,1,2,2,5,Hibernating
45514,460,13,862.29,1,4,2,7,At Risk
45515,497,7,916.9899999999999,1,1,2,4,Hibernating
45516,212,12,2906.05,3,4,5,12,Big Spenders
45517,211,16,1874.24,3,5,4,12,Big Spenders
45518,102,15,1842.1100000000001,4,5,4,13,Champions
45519,51,13,1306.83,5,4,3,12,Loyal
45520,7,12,1377.7,5,4,3,12,Loyal
45521,283,6,446.3,2,1,1,4,Hibernating
45522,236,10,744.03,3,3,1,7,Regulars
45523,52,5,243.03,5,1,1,7,Regulars
45524,96,9,798.66,4,2,1,7,Regulars
45525,8,14,2171.9700000000003,5,5,4,14,Champions
45526,854,7,343.31,1,1,1,3,Hibernating
45527,59,15,1995.3,5,5,4,14,Champions
45528,690,8,2233.5699999999997,1,2,4,7,Regulars
45529,75,14,1587.09,4,5,3,12,Loyal
45530,18,14,2857.4,5,5,5,15,Champions
45531,229,12,998.44,3,4,2,9,Regulars
45532,886,7,691.64,1,1,1,3,Hibernating
45533,110,11,1330.6599999999999,4,3,3,10,Loyal
45534,224,7,1301.26,3,1,3,7,Regulars
45535,250,9,1755.12,2,2,4,8,Regulars
45536,50,10,1253.7799999999997,5,3,3,11,Loyal
45537,22,12,1443.35,5,4,3,12,Loyal
45538,479,11,2695.28,1,3,5,9,Regulars
45539,128,13,1583.26,4,4,3,11,Loyal
45540,262,10,1495.45,2,3,3,8,Regulars
45541,158,11,2276.36,3,3,4,10,Big Spenders
45542,573,12,3584.71,1,4,5,10,At Risk
45543,15,11,1428.64,5,3,3,11,Loyal
45544,364,10,2027.6200000000001,2,3,4,9,Regulars
45545,108,12,1404.9,4,4,3,11,Loyal
45546,50,9,566.56,5,2,1,8,Regulars
45547,401,9,3294.6900000000005,2,2,5,9,Regulars
45548,796,7,1183.66,1,1,2,4,Hibernating
45549,119,10,644.16,4,3,1,8,Loyal
45550,511,7,883.45,1,1,2,4,Hibernating
45551,117,10,1043.5,4,3,2,9,Loyal
45552,162,10,586.8,3,3,1,7,Regulars
45553,172,3,278.96999999999997,3,1,1,5,Regulars
45554,125,10,2213.38,4,3,4,11,Loyal
45555,53,12,1869.73,5,4,4,13,Champions
45556,385,11,1605.55,2,3,3,8,Regulars
45557,117,20,4766.43,4,5,5,14,Champions
45558,47,8,698.78,5,2,1,8,Regulars
45559,62,15,1625.63,5,5,3,13,Loyal
45560,175,15,2582.33,3,5,5,13,Big Spenders
45561,838,6,3152.1100000000006,1,1,5,7,Regulars
45562,373,12,4162.1900000000005,2,4,5,11,At Risk
45563,232,8,1418.18,3,2,3,8,Regulars
45564,99,12,1083.33,4,4,2,10,Loyal
45565,169,11,2130.9,3,3,4,10,Big Spenders
45566,105,14,3589.16,4,5,5,14,Champions
45567,125,7,1070.32,4,1,2,7,Regulars
45568,284,10,1522.83,2,3,3,8,Regulars
45569,300,8,3244.1400000000003,2,2,5,9,Regulars
45570,4,20,1978.88,5,5,4,14,Champions
45571,139,8,2210.57,4,2,4,10,Big Spenders
45572,209,13,1579.8,3,4,3,10,Regulars
45573,49,6,1042.45,5,1,2,8,Regulars
45574,142,10,1118.93,4,3,2,9,Loyal
45575,36,9,986.66,5,2,2,9,Regulars
45576,161,14,4766.59,3,5,5,13,Big Spenders
45577,189,12,1457.06,3,4,3,10,Regulars
45578,19,12,4775.13,5,4,5,14,Champions
45579,287,11,3143.63,2,3,5,10,Regulars
45580,11,14,1945.81,5,5,4,14,Champions
45581,181,11,1384.75,3,3,3,9,Regulars
45582,208,12,1633.04,3,4,3,10,Regulars
45583,245,10,1425.64,3,3,3,9,Regulars
45584,56,4,325.23,5,1,1,7,Regulars
45585,524,10,1199.32,1,3,2,6,Regulars
45586,298,12,796.87,2,4,1,7,At Risk
45587,63,14,2913.3599999999997,5,5,5,15,Champions
45588,305,7,509.69000000000005,2,1,1,4,Hibernating
45589,50,12,1299.52,5,4,3,12,Loyal
45590,267,9,824.0999999999999,2,2,1,5,Hibernating
45591,97,17,2539.44,4,5,4,13,Champions
45592,195,10,2200.07,3,3,4,10,Big Spenders
45593,54,10,1665.88,5,3,3,11,Loyal
45594,92,13,3676.18,4,4,5,13,Champions
45595,293,13,1247.38,2,4,3,9,At Risk
45596,54,19,2829.36,5,5,5,15,Champions
45597,818,11,766.31,1,3,1,5,Regulars
45598,89,10,1243.35,4,3,3,10,Loyal
45599,118,14,2358.19,4,5,4,13,Champions
45600,49,12,1556.6499999999999,5,4,3,12,Loyal
45601,225,15,1212.0,3,5,2,10,Regulars
45602,159,6,636.86,3,1,1,5,Regulars
45603,14,11,3286.0900000000006,5,3,5,13,Loyal
45604,538,12,1932.08,1,4,4,9,At Risk
45605,362,10,1519.29,2,3,3,8,Regulars
45606,873,6,668.14,1,1,1,3,Hibernating
45607,140,13,3144.19,4,4,5,13,Champions
45608,21,13,3557.49,5,4,5,14,Champions
45609,486,11,2213.63,1,3,4,8,Regulars
45610,343,9,4392.59,2,2,5,9,Regulars
45611,1019,4,356.14,1,1,1,3,Hibernating
45612,202,9,1247.8300000000002,3,2,3,8,Regulars
45613,4,12,3796.7,5,4,5,14,Champions
45614,10,13,2157.91,5,4,4,13,Champions
45615,23,9,954.1400000000001,5,2,2,9,Regulars
45616,190,5,1266.8799999999999,3,1,3,7,Regulars
45617,104,10,1127.5,4,3,2,9,Loyal
45618,92,8,697.07,4,2,1,7,Regulars
45619,720,11,1127.52,1,3,2,6,Regulars
45620,327,15,1230.21,2,5,2,9,At Risk
45621,659,10,1033.28,1,3,2,6,Regulars
45622,551,12,2837.52,1,4,5,10,At Risk
45623,9,9,520.85,5,2,1,8,Regulars
45624,477,9,1960.14,1,2,4,7,Regulars
45625,463,11,1422.86,1,3,3,7,Regulars
45626,340,8,502.06,2,2,1,5,Hibernating
45627,278,16,1562.3999999999999,2,5,3,10,At Risk
45628,179,9,1465.38,3,2,3,8,Regulars
45629,247,10,800.32,3,3,1,7,Regulars
45630,447,7,3042.74,2,1,5,8,Regulars
45631,940,7,2052.86,1,1,4,6,Regulars
45632,612,14,1971.3,1,5,4,10,At Risk
45633,313,7,546.27,2,1,1,4,Hibernating
45634,118,27,6366.02,4,5,5,14,Champions
45635,143,8,698.1,4,2,1,7,Regulars
45636,23,10,1886.18,5,3,4,12,Loyal
45637,118,12,890.9,4,4,2,10,Loyal
45638,365,8,1047.94,2,2,2,6,Hibernating
45639,71,10,2047.88,4,3,4,11,Loyal
45640,351,8,1804.74,2,2,4,8,Regulars
45641,157,17,2308.33,3,5,4,12,Big Spenders
45642,1,9,1439.64,5,2,3,10,Regulars
45643,63,8,1588.93,5,2,3,10,Regulars
45644,555,10,2719.56,1,3,5,9,Regulars
45645,244,9,1584.6,3,2,3,8,Regulars
45646,156,9,613.26,3,2,1,6,Regulars
45647,227,9,1164.6899999999998,3,2,2,7,Regulars
45648,68,12,1672.27,4,4,3,11,Loyal
45649,132,8,685.8,4,2,1,7,Regulars
45650,213,8,1275.46,3,2,3,8,Regulars
45651,172,8,2313.5600000000004,3,2,4,9,Big Spenders
45652,113,12,3688.36,4,4,5,13,Champions
45653,41,15,1122.65,5,5,2,12,Loyal
45654,155,9,1071.17,3,2,2,7,Regulars
45655,53,15,4239.400000000001,5,5,5,15,Champions
45656,211,8,930.13,3,2,2,7,Regulars
45657,67,13,2044.1999999999998,4,4,4,12,Champions
45658,26,12,1204.24,5,4,2,11,Loyal
45659,860,9,2391.63,1,2,4,7,Regulars
45660,55,10,1630.15,5,3,3,11,Loyal
45661,52,12,909.63,5,4,2,11,Loyal
45662,331,6,1691.29,2,1,3,6,Regulars
45663,64,12,741.39,5,4,1,10,Loyal
45664,90,13,3160.55,4,4,5,13,Champions
45665,18,8,1231.02,5,2,2,9,Regulars
45666,96,13,1304.7,4,4,3,11,Loyal
45667,164,10,649.85,3,3,1,7,Regulars
45668,430,8,1381.8400000000001,2,2,3,7,Regulars
45669,648,12,3022.23,1,4,5,10,At Risk
45670,359,8,778.22,2,2,1,5,Hibernating
45671,427,9,507.91999999999996,2,2,1,5,Hibernating
45672,270,11,1270.6100000000001,2,3,3,8,Regulars
45673,1005,6,482.77,1,1,1,3,Hibernating
45674,155,18,4209.15,3,5,5,13,Big Spenders
45675,23,6,318.20000000000005,5,1,1,7,Regulars
45676,246,14,1516.39,3,5,3,11,Regulars
45677,197,9,2563.01,3,2,4,9,Big Spenders
45678,321,10,837.9300000000001,2,3,1,6,Regulars
45679,918,1,19.53,1,1,1,3,Hibernating
45680,146,12,1424.87,4,4,3,11,Loyal
45681,376,11,690.77,2,3,1,6,Regulars
45682,0,16,4551.66,5,5,5,15,Champions
45683,279,8,1469.1200000000001,2,2,3,7,Regulars
45684,92,11,900.8299999999999,4,3,2,9,Loyal
45685,192,8,624.05,3,2,1,6,Regulars
45686,398,8,970.88,2,2,2,6,Hibernating
45687,1354,5,255.09,1,1,1,3,Hibernating
45688,31,11,805.8,5,3,1,9,Loyal
45689,173,10,3052.4100000000003,3,3,5,11,Big Spenders
45690,23,13,1882.59,5,4,4,13,Champions
45691,67,10,1563.91,4,3,3,10,Loyal
45692,61,16,1845.8899999999999,5,5,4,14,Champions
45693,44,12,2011.67,5,4,4,13,Champions
45694,44,10,2125.2400000000002,5,3,4,12,Loyal
45695,320,12,1114.12,2,4,2,8,At Risk
45696,750,10,1933.74,1,3,4,8,Regulars
45697,486,9,1617.0900000000001,1,2,3,6,Regulars
45698,1,13,1234.68,5,4,2,11,Loyal
45699,449,8,1771.88,2,2,4,8,Regulars
45700,85,14,4443.7,4,5,5,14,Champions
45701,18,10,2481.91,5,3,4,12,Loyal
45702,548,14,1387.58,1,5,3,9,At Risk
45703,195,16,3772.5099999999998,3,5,5,13,Big Spenders
45704,67,8,639.59,4,2,1,7,Regulars
45705,543,10,1546.46,1,3,3,7,Regulars
45706,149,6,1557.3700000000001,3,1,3,7,Regulars
45707,0,10,3674.71,5,3,5,13,Loyal
45708,33,8,868.06,5,2,2,9,Regulars
45709,309,14,1175.28,2,5,2,9,At Risk
45710,1229,2,218.5,1,1,1,3,Hibernating
45711,22,13,4335.49,5,4,5,14,Champions
45712,59,9,2676.87,5,2,5,12,Big Spenders
45713,90,12,1695.98,4,4,3,11,Loyal
45714,282,13,2007.67,2,4,4,10,At Risk
45715,675,7,806.44,1,1,1,3,Hibernating
45716,172,12,1557.98,3,4,3,10,Regulars
45717,257,16,4624.83,2,5,5,12,At Risk
45718,253,9,1059.1699999999998,2,2,2,6,Hibernating
45719,177,18,3335.68,3,5,5,13,Big Spenders
45720,66,10,681.86,4,3,1,8,Loyal
45721,260,12,1927.62,2,4,4,10,At Risk
45722,293,12,3833.0099999999998,2,4,5,11,At Risk
45723,82,12,1587.36,4,4,3,11,Loyal
45724,25,10,1172.08,5,3,2,10,Loyal
45725,187,11,1362.19,3,3,3,9,Regulars
45726,8,11,1979.64,5,3,4,12,Loyal
45727,110,12,1077.52,4,4,2,10,Loyal
45728,615,11,1782.29,1,3,4,8,Regulars
45729,761,8,1422.5,1,2,3,6,Regulars
45730,475,9,2488.6,1,2,4,7,Regulars
45731,258,16,2366.48,2,5,4,11,At Risk
45732,8,16,4026.3599999999997,5,5,5,15,Champions
45733,226,11,1192.76,3,3,2,8,Regulars
45734,9,21,3299.31,5,5,5,15,Champions
45735,320,15,2497.91,2,5,4,11,At Risk
45736,119,16,1876.91,4,5,4,13,Champions
45737,216,5,645.65,3,1,1,5,Regulars
45738,436,9,2270.4300000000003,2,2,4,8,Regulars
45739,155,6,939.47,3,1,2,6,Regulars
45740,75,13,2270.3,4,4,4,12,Champions
45741,6,18,3633.29,5,5,5,15,Champions
45742,122,12,3114.36,4,4,5,13,Champions
45743,457,11,1602.78,2,3,3,8,Regulars
45744,402,10,1070.02,2,3,2,7,Regulars
45745,143,8,1244.3,4,2,3,9,Regulars
45746,575,8,1794.79,1,2,4,7,Regulars
45747,463,11,2314.7400000000002,1,3,4,8,Regulars
45748,62,13,2257.17,5,4,4,13,Champions
45749,222,9,1149.49,3,2,2,7,Regulars
45750,175,6,3351.3,3,1,5,9,Big Spenders
45751,191,12,1339.7,3,4,3,10,Regulars
45752,1680,2,293.38,1,1,1,3,Hibernating
45753,267,12,3802.3900000000003,2,4,5,11,At Risk
45754,180,17,2212.31,3,5,4,12,Big Spenders
45755,305,9,1121.43,2,2,2,6,Hibernating
45756,646,14,3656.95,1,5,5,11,At Risk
45757,93,9,1101.35,4,2,2,8,Regulars
45758,136,11,1328.49,4,3,3,10,Loyal
45759,348,9,3209.84,2,2,5,9,Regulars
45760,27,11,774.25,5,3,1,9,Loyal
45761,565,4,540.35,1,1,1,3,Hibernating
45762,178,13,3115.2,3,4,5,12,Big Spenders
45763,34,12,1004.98,5,4,2,11,Loyal
45764,50,10,1266.4,5,3,3,11,Loyal
45765,192,12,904.63,3,4,2,9,Regulars
45766,231,10,2408.26,3,3,4,10,Big Spenders
45767,76,13,1693.27,4,4,3,11,Loyal
45768,181,6,785.62,3,1,1,5,Regulars
45769,545,10,2334.2,1,3,4,8,Regulars
45770,33,12,1123.6200000000001,5,4,2,11,Loyal
45771,457,10,1497.34,2,3,3,8,Regulars
45772,154,12,1374.22,3,4,3,10,Regulars
45773,9,12,5560.1900000000005,5,4,5,14,Champions
45774,545,6,2086.29,1,1,4,6,Regulars
45775,152,13,2186.36,3,4,4,11,Big Spenders
45776,862,7,1544.9199999999998,1,1,3,5,Regulars
45777,263,9,1856.2199999999998,2,2,4,8,Regulars
45778,228,5,812.6099999999999,3,1,1,5,Regulars
45779,216,8,1814.13,3,2,4,9,Big Spenders
45780,72,10,4785.580000000001,4,3,5,12,Loyal
45781,246,11,2998.22,3,3,5,11,Big Spenders
45782,38,6,1569.42,5,1,3,9,Regulars
45783,12,17,1195.12,5,5,2,12,Loyal
45784,3,10,2503.58,5,3,4,12,Loyal
45785,49,11,1530.55,5,3,3,11,Loyal
45786,1042,5,312.29,1,1,1,3,Hibernating
45787,19,10,4040.96,5,3,5,13,Loyal
45788,1258,6,356.74,1,1,1,3,Hibernating
45789,54,8,1413.05,5,2,3,10,Regulars
45790,1,17,2810.42,5,5,5,15,Champions
45791,909,9,781.23,1,2,1,4,Hibernating
45792,212,7,898.7399999999999,3,1,2,6,Regulars
45793,175,12,3483.41,3,4,5,12,Big Spenders
45794,174,12,3748.38,3,4,5,12,Big Spenders
45795,185,8,464.64,3,2,1,6,Regulars
45796,556,11,4958.35,1,3,5,9,Regulars
45797,373,6,368.83000000000004,2,1,1,4,Hibernating
45798,1598,4,166.08,1,1,1,3,Hibernating
45799,218,17,4128.86,3,5,5,13,Big Spenders
45800,9,11,1354.17,5,3,3,11,Loyal
45801,30,12,1909.46,5,4,4,13,Champions
45802,33,16,4380.14,5,5,5,15,Champions
45803,229,9,542.12,3,2,1,6,Regulars
45804,128,13,3342.82,4,4,5,13,Champions
45805,111,12,936.0300000000001,4,4,2,10,Loyal
45806,6,14,2158.37,5,5,4,14,Champions
45807,368,15,2870.37,2,5,5,12,At Risk
45808,79,6,998.17,4,1,2,7,Regulars
45809,11,8,359.70000000000005,5,2,1,8,Regulars
45810,551,12,1323.22,1,4,3,8,At Risk
45811,1047,6,677.41,1,1,1,3,Hibernating
45812,542,8,1332.05,1,2,3,6,Regulars
45813,267,11,1109.53,2,3,2,7,Regulars
45814,109,7,2229.45,4,1,4,9,Big Spenders
45815,185,14,4656.9400000000005,3,5,5,13,Big Spenders
45816,298,11,2552.96,2,3,4,9,Regulars
45817,214,7,1777.41,3,1,4,8,Big Spenders
45818,90,13,2185.62,4,4,4,12,Champions
45819,728,9,989.52,1,2,2,5,Hibernating
45820,228,12,1256.9099999999999,3,4,3,10,Regulars
45821,535,12,1853.95,1,4,4,9,At Risk
45822,600,6,1123.55,1,1,2,4,Hibernating
45823,146,12,6135.89,4,4,5,13,Champions
45824,466,9,1837.6399999999999,1,2,4,7,Regulars
45825,860,7,852.61,1,1,2,4,Hibernating
45826,12,8,1391.52,5,2,3,10,Regulars
45827,298,10,1478.2,2,3,3,8,Regulars
45828,501,12,2899.87,1,4,5,10,At Risk
45829,160,6,769.4599999999999,3,1,1,5,Regulars
45830,540,9,2697.03,1,2,5,8,Regulars
45831,108,15,1817.09,4,5,4,13,Champions
45832,1,11,1439.8,5,3,3,11,Loyal
45833,222,9,1108.33,3,2,2,7,Regulars
45834,297,10,714.82,2,3,1,6,Regulars
45835,496,10,2209.05,1,3,4,8,Regulars
45836,406,8,5229.79,2,2,5,9,Regulars
45837,129,18,2202.91,4,5,4,13,Champions
45838,108,7,746.2299999999999,4,1,1,6,Regulars
45839,253,9,2392.3599999999997,2,2,4,8,Regulars
45840,209,12,1683.31,3,4,3,10,Regulars
45841,203,12,2995.7200000000003,3,4,5,12,Big Spenders
45842,250,10,2995.1,2,3,5,10,Regulars
45843,79,6,2221.6,4,1,4,9,Big Spenders
45844,190,13,3056.0899999999997,3,4,5,12,Big Spenders
45845,120,11,1612.5,4,3,3,10,Loyal
45846,113,12,1905.69,4,4,4,12,Champions
45847,123,14,3743.7199999999993,4,5,5,14,Champions
45848,89,12,2943.89,4,4,5,13,Champions
45849,175,2,122.54,3,1,1,5,Regulars
45850,272,8,838.44,2,2,1,5,Hibernating
45851,26,9,829.1999999999999,5,2,1,8,Regulars
45852,111,10,637.4,4,3,1,8,Loyal
45853,311,7,1441.42,2,1,3,6,Regulars
45854,72,18,3008.14,4,5,5,14,Champions
45855,82,16,2666.23,4,5,5,14,Champions
45856,112,9,1328.1499999999999,4,2,3,9,Regulars
45857,979,13,3250.35,1,4,5,10,At Risk
45858,328,13,3508.07,2,4,5,11,At Risk
45859,516,13,3732.1799999999994,1,4,5,10,At Risk
45860,239,8,514.4300000000001,3,2,1,6,Regulars
45861,230,9,707.24,3,2,1,6,Regulars
45862,346,12,4346.75,2,4,5,11,At Risk
45863,26,7,540.73,5,1,1,7,Regulars
45864,604,4,1102.6399999999999,1,1,2,4,Hibernating
45865,67,7,1195.75,4,1,2,7,Regulars
45866,831,5,3289.64,1,1,5,7,Regulars
45867,151,14,2866.29,3,5,5,13,Big Spenders
45868,50,10,522.12,5,3,1,9,Loyal
45869,386,8,911.54,2,2,2,6,Hibernating
45870,571,9,714.26,1,2,1,4,Hibernating
45871,513,6,903.99,1,1,2,4,Hibernating
45872,126,8,960.66,4,2,2,8,Regulars
45873,279,11,1155.7,2,3,2,7,Regulars
45874,43,12,1825.36,5,4,4,13,Champions
45875,247,16,2562.16,3,5,4,12,Big Spenders
45876,23,14,5374.160000000001,5,5,5,15,Champions
45877,287,15,2165.96,2,5,4,11,At Risk
45878,157,13,1104.03,3,4,2,9,Regulars
45879,155,16,3104.89,3,5,5,13,Big Spenders
45880,387,11,1863.8000000000002,2,3,4,9,Regulars
45881,185,11,2187.42,3,3,4,10,Big Spenders
45882,262,8,5416.03,2,2,5,9,Regulars
45883,42,10,1336.09,5,3,3,11,Loyal
45884,172,14,1657.1100000000001,3,5,3,11,Regulars
45885,1026,9,1525.96,1,2,3,6,Regulars
45886,123,9,1538.26,4,2,3,9,Regulars
45887,343,9,537.1899999999999,2,2,1,5,Hibernating
45888,89,15,2467.96,4,5,4,13,Champions
45889,90,10,794.12,4,3,1,8,Loyal
45890,127,12,1326.14,4,4,3,11,Loyal
45891,148,12,1057.3700000000001,3,4,2,9,Regulars
45892,297,10,2814.7999999999997,2,3,5,10,Regulars
45893,382,9,658.73,2,2,1,5,Hibernating
45894,558,5,2057.74,1,1,4,6,Regulars
45895,127,7,622.35,4,1,1,6,Regulars
45896,100,7,844.73,4,1,1,6,Regulars
45897,152,12,2175.4900000000002,3,4,4,11,Big Spenders
45898,537,7,530.12,1,1,1,3,Hibernating
45899,57,6,667.34,5,1,1,7,Regulars
45900,247,13,1653.2,3,4,3,10,Regulars
45901,333,10,2718.7400000000002,2,3,5,10,Regulars
45902,39,12,2885.52,5,4,5,14,Champions
45903,1141,10,971.14,1,3,2,6,Regulars
45904,16,12,1184.0,5,4,2,11,Loyal
45905,998,7,819.89,1,1,1,3,Hibernating
45906,169,14,1828.5,3,5,4,12,Big Spenders
45907,69,15,5741.71,4,5,5,14,Champions
45908,92,14,2978.2,4,5,5,14,Champions
45909,279,20,3843.66,2,5,5,12,At Risk
45910,428,5,537.66,2,1,1,4,Hibernating
45911,100,14,3696.6299999999997,4,5,5,14,Champions
45912,141,22,4129.21,4,5,5,14,Champions
45913,145,14,1475.5300000000002,4,5,3,12,Loyal
45914,128,11,1240.54,4,3,2,9,Loyal
45915,231,11,1191.89,3,3,2,8,Regulars
45916,181,11,2932.3,3,3,5,11,Big Spenders
45917,1155,7,619.1700000000001,1,1,1,3,Hibernating
45918,263,8,919.01,2,2,2,6,Hibernating
45919,676,7,1556.57,1,1,3,5,Regulars
45920,60,14,2051.23,5,5,4,14,Champions
45921,351,9,826.67,2,2,1,5,Hibernating
45922,14,13,3614.99,5,4,5,14,Champions
45923,484,8,1139.03,1,2,2,5,Hibernating
45924,144,9,2859.0899999999997,4,2,5,11,Big Spenders
45925,382,7,563.5600000000001,2,1,1,4,Hibernating
45926,239,9,2214.19,3,2,4,9,Big Spenders
45927,873,11,3507.2999999999997,1,3,5,9,Regulars
45928,20,10,1197.35,5,3,2,10,Loyal
45929,18,11,1619.34,5,3,3,11,Loyal
45930,82,15,1194.21,4,5,2,11,Loyal
45931,459,10,1696.1399999999999,2,3,3,8,Regulars
45932,430,9,1221.1399999999999,2,2,2,6,Hibernating
45933,77,7,671.1,4,1,1,6,Regulars
45934,1370,4,996.45,1,1,2,4,Hibernating
45935,168,8,693.95,3,2,1,6,Regulars
45936,37,8,1044.64,5,2,2,9,Regulars
45937,205,10,1254.29,3,3,3,9,Regulars
45938,279,18,3347.21,2,5,5,12,At Risk
45939,177,7,1147.2,3,1,2,6,Regulars
45940,44,12,1136.96,5,4,2,11,Loyal
45941,255,12,2933.14,2,4,5,11,At Risk
45942,261,8,651.84,2,2,1,5,Hibernating
45943,241,18,4279.79,3,5,5,13,Big Spenders
45944,5,13,2235.43,5,4,4,13,Champions
45945,55,18,1476.5,5,5,3,13,Loyal
45946,286,13,1705.72,2,4,3,9,At Risk
45947,181,12,2069.74,3,4,4,11,Big Spenders
45948,68,6,876.58,4,1,2,7,Regulars
45949,151,11,948.7,3,3,2,8,Regulars
45950,80,12,3051.64,4,4,5,13,Champions
45951,1377,4,1952.73,1,1,4,6,Regulars
45952,148,13,1675.87,3,4,3,10,Regulars
45953,328,11,1987.74,2,3,4,9,Regulars
45954,243,14,2203.55,3,5,4,12,Big Spenders
45955,96,11,1840.54,4,3,4,11,Loyal
45956,266,12,1325.97,2,4,3,9,At Risk
45957,140,12,2159.94,4,4,4,12,Champions
45958,89,12,1040.26,4,4,2,10,Loyal
45959,212,13,2138.13,3,4,4,11,Big Spenders
45960,425,9,3605.38,2,2,5,9,Regulars
45961,744,8,1096.08,1,2,2,5,Hibernating
45962,586,5,333.27,1,1,1,3,Hibernating
45963,1075,6,1351.0800000000002,1,1,3,5,Regulars
45964,536,6,518.79,1,1,1,3,Hibernating
45965,448,9,1543.5700000000002,2,2,3,7,Regulars
45966,442,15,1929.1,2,5,4,11,At Risk
45967,896,7,472.79,1,1,1,3,Hibernating
45968,1015,13,1964.81,1,4,4,9,At Risk
45969,19,11,857.04,5,3,2,10,Loyal
45970,19,9,1115.27,5,2,2,9,Regulars
45971,42,12,1457.3,5,4,3,12,Loyal
45972,95,17,1227.8700000000001,4,5,2,11,Loyal
45973,57,8,2339.69,5,2,4,11,Big Spenders
45974,59,13,2097.48,5,4,4,13,Champions
45975,0,13,1952.9900000000002,5,4,4,13,Champions
45976,464,10,3797.7599999999998,1,3,5,9,Regulars
45977,244,6,1100.9,3,1,2,6,Regulars
45978,76,14,2627.16,4,5,5,14,Champions
45979,608,10,2143.0,1,3,4,8,Regulars
45980,1313,3,214.54000000000002,1,1,1,3,Hibernating
45981,316,13,1226.76,2,4,2,8,At Risk
45982,461,8,1470.5700000000002,1,2,3,6,Regulars
45983,956,9,1284.29,1,2,3,6,Regulars
45984,345,13,1644.2199999999998,2,4,3,9,At Risk
45985,141,9,1343.63,4,2,3,9,Regulars
45986,214,15,3030.4199999999996,3,5,5,13,Big Spenders
45987,307,8,1540.46,2,2,3,7,Regulars
45988,601,7,445.51,1,1,1,3,Hibernating
45989,143,8,869.02,4,2,2,8,Regulars
45990,183,12,1717.8899999999999,3,4,3,10,Regulars
45991,244,7,1470.8,3,1,3,7,Regulars
45992,23,9,983.74,5,2,2,9,Regulars
45993,389,19,1578.9,2,5,3,10,At Risk
45994,197,8,1290.18,3,2,3,8,Regulars
45995,23,9,1266.05,5,2,3,10,Regulars
45996,187,9,627.6600000000001,3,2,1,6,Regulars
45997,195,13,1555.39,3,4,3,10,Regulars
45998,233,11,1380.67,3,3,3,9,Regulars
45999,166,15,1178.5,3,5,2,10,Regulars
46000,60,10,2172.42,5,3,4,12,Loyal
46001,148,6,1145.94,3,1,2,6,Regulars
46002,181,7,335.54999999999995,3,1,1,5,Regulars
46003,172,16,3032.51,3,5,5,13,Big Spenders
46004,451,15,3487.34,2,5,5,12,At Risk
46005,906,5,1064.44,1,1,2,4,Hibernating
46006,358,9,1057.69,2,2,2,6,Hibernating
46007,321,15,3325.5,2,5,5,12,At Risk
46008,126,8,1749.2600000000002,4,2,4,10,Big Spenders
46009,151,13,3079.1899999999996,3,4,5,12,Big Spenders
46010,446,8,1208.4099999999999,2,2,2,6,Hibernating
46011,34,9,3642.2700000000004,5,2,5,12,Big Spenders
46012,118,13,2112.96,4,4,4,12,Champions
46013,555,12,1053.89,1,4,2,7,At Risk
46014,41,10,433.79,5,3,1,9,Loyal
46015,27,9,713.85,5,2,1,8,Regulars
46016,531,12,1747.76,1,4,4,9,At Risk
46017,164,12,3868.67,3,4,5,12,Big Spenders
46018,110,13,563.3,4,4,1,9,Loyal
46019,57,8,852.43,5,2,2,9,Regulars
46020,614,14,1965.53,1,5,4,10,At Risk
46021,45,12,1181.62,5,4,2,11,Loyal
46022,178,5,556.9200000000001,3,1,1,5,Regulars
46023,145,13,2989.48,4,4,5,13,Champions
46024,179,8,3561.8999999999996,3,2,5,10,Big Spenders
46025,75,9,422.06,4,2,1,7,Regulars
46026,336,10,2298.14,2,3,4,9,Regulars
46027,42,17,7437.9,5,5,5,15,Champions
46028,358,6,4096.7,2,1,5,8,Regulars
46029,75,12,814.12,4,4,1,9,Loyal
46030,466,9,829.01,1,2,1,4,Hibernating
46031,666,4,1374.3300000000002,1,1,3,5,Regulars
46032,329,8,1212.49,2,2,2,6,Hibernating
46033,1,6,2423.33,5,1,4,10,Big Spenders
46034,334,12,1355.44,2,4,3,9,At Risk
46035,119,12,3090.9600000000005,4,4,5,13,Champions
46036,505,9,1989.09,1,2,4,7,Regulars
46037,56,13,4642.4800000000005,5,4,5,14,Champions
46038,19,14,1582.25,5,5,3,13,Loyal
46039,141,8,2204.2299999999996,4,2,4,10,Big Spenders
46040,1302,4,332.02,1,1,1,3,Hibernating
46041,996,6,345.09000000000003,1,1,1,3,Hibernating
46042,0,11,3607.25,5,3,5,13,Loyal
46043,127,11,2466.84,4,3,4,11,Loyal
46044,44,15,2124.77,5,5,4,14,Champions
46045,33,9,771.51,5,2,1,8,Regulars
46046,22,7,679.9100000000001,5,1,1,7,Regulars
46047,38,8,451.11,5,2,1,8,Regulars
46048,187,9,1079.35,3,2,2,7,Regulars
46049,447,10,3388.0099999999993,2,3,5,10,Regulars
46050,161,12,4862.45,3,4,5,12,Big Spenders
46051,72,12,595.38,4,4,1,9,Loyal
46052,296,7,963.89,2,1,2,5,Hibernating
46053,171,12,1916.37,3,4,4,11,Big Spenders
46054,164,11,782.88,3,3,1,7,Regulars
46055,24,10,2994.02,5,3,5,13,Loyal
46056,1195,10,1254.48,1,3,3,7,Regulars
46057,181,12,1863.54,3,4,4,11,Big Spenders
46058,154,14,2168.62,3,5,4,12,Big Spenders
46059,370,11,1558.5,2,3,3,8,Regulars
46060,197,6,1061.78,3,1,2,6,Regulars
46061,170,12,3350.1000000000004,3,4,5,12,Big Spenders
46062,351,16,5239.91,2,5,5,12,At Risk
46063,128,13,2705.87,4,4,5,13,Champions
46064,124,9,1018.79,4,2,2,8,Regulars
46065,135,6,1170.59,4,1,2,7,Regulars
46066,80,15,1896.96,4,5,4,13,Champions
46067,562,6,604.04,1,1,1,3,Hibernating
46068,283,9,1290.91,2,2,3,7,Regulars
46069,290,14,2097.95,2,5,4,11,At Risk
46070,386,13,3339.9100000000003,2,4,5,11,At Risk
46071,328,11,1601.78,2,3,3,8,Regulars
46072,190,14,1541.8,3,5,3,11,Regulars
46073,107,18,3130.38,4,5,5,14,Champions
46074,1126,9,3387.8399999999997,1,2,5,8,Regulars
46075,372,10,2747.76,2,3,5,10,Regulars
46076,456,7,526.95,2,1,1,4,Hibernating
46077,10,13,5624.650000000001,5,4,5,14,Champions
46078,206,10,1404.0700000000002,3,3,3,9,Regulars
46079,538,8,549.16,1,2,1,4,Hibernating
46080,201,11,923.35,3,3,2,8,Regulars
46081,166,11,2044.01,3,3,4,10,Big Spenders
46082,1044,10,1376.18,1,3,3,7,Regulars
46083,158,13,1644.81,3,4,3,10,Regulars
46084,11,12,1810.9000000000003,5,4,4,13,Champions
46085,92,10,1480.92,4,3,3,10,Loyal
46086,822,7,2591.77,1,1,5,7,Regulars
46087,210,3,2433.33,3,1,4,8,Big Spenders
46088,94,14,1788.23,4,5,4,13,Champions
46089,343,10,2351.8,2,3,4,9,Regulars
46090,342,11,1042.1100000000001,2,3,2,7,Regulars
46091,65,7,2328.95,5,1,4,10,Big Spenders
46092,7,11,841.88,5,3,1,9,Loyal
46093,124,7,655.08,4,1,1,6,Regulars
46094,806,7,691.79,1,1,1,3,Hibernating
46095,239,13,1773.3,3,4,4,11,Big Spenders
46096,405,9,690.47,2,2,1,5,Hibernating
46097,186,10,1375.3300000000002,3,3,3,9,Regulars
46098,24,14,1768.42,5,5,4,14,Champions
46099,307,11,804.5699999999999,2,3,1,6,Regulars
46100,122,13,2091.05,4,4,4,12,Champions
46101,215,11,2946.51,3,3,5,11,Big Spenders
46102,147,12,1864.67,4,4,4,12,Champions
46103,449,7,2130.06,2,1,4,7,Regulars
46104,613,10,1878.21,1,3,4,8,Regulars
46105,75,17,1629.74,4,5,3,12,Loyal
46106,348,8,1041.44,2,2,2,6,Hibernating
46107,329,12,1161.8600000000001,2,4,2,8,At Risk
46108,182,8,1071.52,3,2,2,7,Regulars
46109,561,13,2477.12,1,4,4,9,At Risk
46110,19,9,1590.07,5,2,3,10,Regulars
46111,428,6,2269.03,2,1,4,7,Regulars
46112,460,8,614.23,1,2,1,4,Hibernating
46113,105,9,625.63,4,2,1,7,Regulars
46114,308,18,2202.7200000000003,2,5,4,11,At Risk
46115,369,13,2328.23,2,4,4,10,At Risk
46116,304,12,1226.1200000000001,2,4,2,8,At Risk
46117,236,10,1467.11,3,3,3,9,Regulars
46118,247,12,1755.8600000000001,3,4,4,11,Big Spenders
46119,192,9,690.22,3,2,1,6,Regulars
46120,289,14,3761.71,2,5,5,12,At Risk
46121,354,10,1234.15,2,3,2,7,Regulars
46122,399,12,1258.16,2,4,3,9,At Risk
46123,721,8,1016.41,1,2,2,5,Hibernating
46124,124,14,1331.97,4,5,3,12,Loyal
46125,42,10,828.64,5,3,1,9,Loyal
46126,111,2,123.06,4,1,1,6,Regulars
46127,305,14,2012.38,2,5,4,11,At Risk
46128,274,11,3799.39,2,3,5,10,Regulars
46129,42,16,1880.1399999999999,5,5,4,14,Champions
46130,446,12,1237.3700000000001,2,4,2,8,At Risk
46131,170,7,958.47,3,1,2,6,Regulars
46132,261,10,1015.04,2,3,2,7,Regulars
46133,144,12,1146.6299999999999,4,4,2,10,Loyal
46134,658,10,1367.65,1,3,3,7,Regulars
46135,525,4,700.1200000000001,1,1,1,3,Hibernating
46136,74,14,1872.01,4,5,4,13,Champions
46137,770,11,1440.57,1,3,3,7,Regulars
46138,613,10,1891.89,1,3,4,8,Regulars
46139,985,7,809.94,1,1,1,3,Hibernating
46140,681,15,1302.27,1,5,3,9,At Risk
46141,343,8,1655.77,2,2,3,7,Regulars
46142,327,8,648.11,2,2,1,5,Hibernating
46143,50,6,1172.42,5,1,2,8,Regulars
46144,181,9,1571.03,3,2,3,8,Regulars
46145,925,8,2597.0299999999997,1,2,5,8,Regulars
46146,90,11,3084.87,4,3,5,12,Loyal
46147,219,13,1765.3400000000001,3,4,4,11,Big Spenders
46148,156,16,2640.44,3,5,5,13,Big Spenders
46149,231,8,298.35,3,2,1,6,Regulars
46150,191,13,1135.6100000000001,3,4,2,9,Regulars
46151,144,9,1811.45,4,2,4,10,Big Spenders
46152,49,8,744.0,5,2,1,8,Regulars
46153,23,11,1047.24,5,3,2,10,Loyal
46154,148,8,969.96,3,2,2,7,Regulars
46155,86,15,1536.3799999999999,4,5,3,12,Loyal
46156,230,12,744.31,3,4,1,8,Regulars
46157,182,13,1250.34,3,4,3,10,Regulars
46158,138,10,1165.86,4,3,2,9,Loyal
46159,494,9,1178.63,1,2,2,5,Hibernating
46160,287,12,4044.8900000000003,2,4,5,11,At Risk
46161,28,13,2409.49,5,4,4,13,Champions
46162,485,10,835.29,1,3,1,5,Regulars
46163,492,18,3170.6499999999996,1,5,5,11,At Risk
46164,518,8,1299.69,1,2,3,6,Regulars
46165,49,9,2139.23,5,2,4,11,Big Spenders
46166,557,10,1130.28,1,3,2,6,Regulars
46167,75,8,1376.19,4,2,3,9,Regulars
46168,329,10,320.8,2,3,1,6,Regulars
46169,128,10,1613.6,4,3,3,10,Loyal
46170,158,16,1811.32,3,5,4,12,Big Spenders
46171,447,13,1318.39,2,4,3,9,At Risk
46172,200,8,1148.13,3,2,2,7,Regulars
46173,145,6,1646.43,4,1,3,8,Regulars
46174,6,15,2108.85,5,5,4,14,Champions
46175,23,7,834.25,5,1,1,7,Regulars
46176,118,13,1930.17,4,4,4,12,Champions
46177,1005,9,918.41,1,2,2,5,Hibernating
46178,152,11,2601.9100000000003,3,3,5,11,Big Spenders
46179,261,13,1218.59,2,4,2,8,At Risk
46180,13,15,4210.280000000001,5,5,5,15,Champions
46181,328,13,1882.56,2,4,4,10,At Risk
46182,853,16,2512.99,1,5,4,10,At Risk
46183,183,10,1504.54,3,3,3,9,Regulars
46184,131,10,1862.02,4,3,4,11,Loyal
46185,209,4,487.11,3,1,1,5,Regulars
46186,114,10,1093.1,4,3,2,9,Loyal
46187,135,11,5288.719999999999,4,3,5,12,Loyal
46188,74,11,2014.06,4,3,4,11,Loyal
46189,274,13,2569.3,2,4,4,10,At Risk
46190,105,11,2059.85,4,3,4,11,Loyal
46191,599,4,934.0,1,1,2,4,Hibernating
46192,85,12,2394.89,4,4,4,12,Champions
46193,296,7,1642.76,2,1,3,6,Regulars
46194,901,7,888.17,1,1,2,4,Hibernating
46195,445,11,2091.28,2,3,4,9,Regulars
46196,19,12,6361.410000000001,5,4,5,14,Champions
46197,25,12,1738.2199999999998,5,4,4,13,Champions
46198,73,13,886.0,4,4,2,10,Loyal
46199,196,15,1245.9099999999999,3,5,3,11,Regulars
46200,91,9,561.25,4,2,1,7,Regulars
46201,100,11,1651.07,4,3,3,10,Loyal
46202,924,6,380.34000000000003,1,1,1,3,Hibernating
46203,110,11,1201.46,4,3,2,9,Loyal
46204,124,9,796.5600000000001,4,2,1,7,Regulars
46205,108,7,1944.93,4,1,4,9,Big Spenders
46206,111,10,2800.58,4,3,5,12,Loyal
46207,372,14,3383.71,2,5,5,12,At Risk
46208,299,14,1998.14,2,5,4,11,At Risk
46209,309,8,756.12,2,2,1,5,Hibernating
46210,469,6,1083.9,1,1,2,4,Hibernating
46211,84,10,944.63,4,3,2,9,Loyal
46212,498,12,942.65,1,4,2,7,At Risk
46213,13,12,4381.45,5,4,5,14,Champions
46214,19,6,745.33,5,1,1,7,Regulars
46215,126,10,2750.7,4,3,5,12,Loyal
46216,184,11,924.95,3,3,2,8,Regulars
46217,190,10,1051.9,3,3,2,8,Regulars
46218,448,11,2657.73,2,3,5,10,Regulars
46219,47,9,943.04,5,2,2,9,Regulars
46220,531,16,4989.85,1,5,5,11,At Risk
46221,135,12,1942.8700000000001,4,4,4,12,Champions
46222,275,7,906.39,2,1,2,5,Hibernating
46223,225,12,2066.52,3,4,4,11,Big Spenders
46224,236,5,758.25,3,1,1,5,Regulars
46225,578,7,750.26,1,1,1,3,Hibernating
46226,279,12,982.76,2,4,2,8,At Risk
46227,39,12,1551.07,5,4,3,12,Loyal
46228,98,7,402.99,4,1,1,6,Regulars
46229,403,13,3071.56,2,4,5,11,At Risk
46230,41,9,841.64,5,2,1,8,Regulars
46231,95,4,635.9300000000001,4,1,1,6,Regulars
46232,488,8,1865.3999999999999,1,2,4,7,Regulars
46233,38,8,2305.21,5,2,4,11,Big Spenders
46234,54,14,1814.21,5,5,4,14,Champions
46235,144,14,991.65,4,5,2,11,Loyal
46236,126,10,1267.06,4,3,3,10,Loyal
46237,43,12,1897.46,5,4,4,13,Champions
46238,335,12,1589.96,2,4,3,9,At Risk
46239,14,19,4845.9,5,5,5,15,Champions
46240,386,7,614.5799999999999,2,1,1,4,Hibernating
46241,75,8,2418.4900000000002,4,2,4,10,Big Spenders
46242,395,11,1116.16,2,3,2,7,Regulars
46243,120,10,2452.31,4,3,4,11,Loyal
46244,543,8,1110.27,1,2,2,5,Hibernating
46245,195,10,1462.08,3,3,3,9,Regulars
46246,166,8,413.31,3,2,1,6,Regulars
46247,116,12,2857.03,4,4,5,13,Champions
46248,151,9,829.61,3,2,1,6,Regulars
46249,274,13,3086.48,2,4,5,11,At Risk
46250,46,10,1564.37,5,3,3,11,Loyal
46251,775,13,577.51,1,4,1,6,At Risk
46252,26,9,1301.81,5,2,3,10,Regulars
46253,154,13,836.8900000000001,3,4,1,8,Regulars
46254,28,12,1329.65,5,4,3,12,Loyal
46255,54,13,2822.5299999999997,5,4,5,14,Champions
46256,467,15,1954.57,1,5,4,10,At Risk
46257,29,11,1201.19,5,3,2,10,Loyal
46258,1005,6,718.3599999999999,1,1,1,3,Hibernating
46259,64,15,1453.35,5,5,3,13,Loyal
46260,659,10,2220.1800000000003,1,3,4,8,Regulars
46261,732,11,1837.9,1,3,4,8,Regulars
46262,71,13,3438.7300000000005,4,4,5,13,Champions
46263,960,11,903.84,1,3,2,6,Regulars
46264,63,5,638.62,5,1,1,7,Regulars
46265,84,13,2167.5099999999998,4,4,4,12,Champions
46266,157,11,1721.19,3,3,3,9,Regulars
46267,506,7,4024.6000000000004,1,1,5,7,Regulars
46268,205,10,839.8,3,3,1,7,Regulars
46269,75,9,567.6800000000001,4,2,1,7,Regulars
46270,94,10,1099.66,4,3,2,9,Loyal
46271,1155,5,1529.17,1,1,3,5,Regulars
46272,212,12,2705.2599999999998,3,4,5,12,Big Spenders
46273,265,12,4496.5599999999995,2,4,5,11,At Risk
46274,91,8,3347.94,4,2,5,11,Big Spenders
46275,763,11,1329.3,1,3,3,7,Regulars
46276,28,13,1667.35,5,4,3,12,Loyal
46277,418,16,4822.72,2,5,5,12,At Risk
46278,191,11,679.6899999999999,3,3,1,7,Regulars
46279,51,14,1350.42,5,5,3,13,Loyal
46280,1,10,2622.7,5,3,5,13,Loyal
46281,448,11,1016.9200000000001,2,3,2,7,Regulars
46282,129,14,3178.41,4,5,5,14,Champions
46283,168,7,523.28,3,1,1,5,Regulars
46284,76,5,1404.78,4,1,3,8,Regulars
46285,21,17,1559.46,5,5,3,13,Loyal
46286,184,10,570.83,3,3,1,7,Regulars
46287,127,9,1446.22,4,2,3,9,Regulars
46288,438,9,1330.57,2,2,3,7,Regulars
46289,216,9,2112.12,3,2,4,9,Big Spenders
46290,196,11,1290.95,3,3,3,9,Regulars
46291,341,13,3098.45,2,4,5,11,At Risk
46292,121,10,1264.54,4,3,3,10,Loyal
46293,48,9,1649.5,5,2,3,10,Regulars
46294,229,13,2052.22,3,4,4,11,Big Spenders
46295,53,9,1647.79,5,2,3,10,Regulars
46296,154,14,2746.5800000000004,3,5,5,13,Big Spenders
46297,379,9,2251.97,2,2,4,8,Regulars
46298,11,5,966.1100000000001,5,1,2,8,Regulars
46299,73,14,2454.5800000000004,4,5,4,13,Champions
46300,136,11,3061.14,4,3,5,12,Loyal
46301,22,17,1585.9,5,5,3,13,Loyal
46302,164,17,1756.75,3,5,4,12,Big Spenders
46303,432,7,743.3499999999999,2,1,1,4,Hibernating
46304,247,12,2953.6,3,4,5,12,Big Spenders
46305,410,5,925.4300000000001,2,1,2,5,Hibernating
46306,342,8,2209.34,2,2,4,8,Regulars
46307,824,5,391.86,1,1,1,3,Hibernating
46308,2,7,2803.1000000000004,5,1,5,11,Big Spenders
46309,132,11,1199.5,4,3,2,9,Loyal
46310,110,11,5617.93,4,3,5,12,Loyal
46311,23,11,1251.28,5,3,3,11,Loyal
46312,127,14,2099.32,4,5,4,13,Champions
46313,173,10,1455.1799999999998,3,3,3,9,Regulars
46314,553,8,2801.04,1,2,5,8,Regulars
46315,32,10,2137.47,5,3,4,12,Loyal
46316,403,9,1388.4299999999998,2,2,3,7,Regulars
46317,89,15,6650.540000000001,4,5,5,14,Champions
46318,162,16,1207.37,3,5,2,10,Regulars
46319,799,9,1090.59,1,2,2,5,Hibernating
46320,50,10,2988.5,5,3,5,13,Loyal
46321,94,13,2987.5,4,4,5,13,Champions
46322,499,2,163.34,1,1,1,3,Hibernating
46323,107,13,1846.18,4,4,4,12,Champions
46324,49,5,327.3,5,1,1,7,Regulars
46325,3,9,1668.19,5,2,3,10,Regulars
46326,43,10,1179.9,5,3,2,10,Loyal
46327,160,7,3862.55,3,1,5,9,Big Spenders
46328,104,10,2988.93,4,3,5,12,Loyal
46329,12,15,3421.6400000000003,5,5,5,15,Champions
46330,427,15,3735.2,2,5,5,12,At Risk
46331,266,13,1325.07,2,4,3,9,At Risk
46332,181,10,2105.31,3,3,4,10,Big Spenders
46333,154,15,3807.0,3,5,5,13,Big Spenders
46334,52,9,1091.99,5,2,2,9,Regulars
46335,334,8,2228.87,2,2,4,8,Regulars
46336,456,10,3368.3,2,3,5,10,Regulars
46337,313,15,1170.66,2,5,2,9,At Risk
46338,541,6,2792.54,1,1,5,7,Regulars
46339,136,13,1896.27,4,4,4,12,Champions
46340,111,10,1122.57,4,3,2,9,Loyal
46341,141,16,1611.15,4,5,3,12,Loyal
46342,262,12,2716.8599999999997,2,4,5,11,At Risk
46343,75,12,2304.67,4,4,4,12,Champions
46344,151,11,1782.41,3,3,4,10,Big Spenders
46345,834,12,1051.1100000000001,1,4,2,7,At Risk
46346,76,13,3965.7700000000004,4,4,5,13,Champions
46347,117,9,2905.94,4,2,5,11,Big Spenders
46348,180,7,711.1800000000001,3,1,1,5,Regulars
46349,29,13,1066.81,5,4,2,11,Loyal
46350,255,10,1092.6,2,3,2,7,Regulars
46351,804,7,701.8,1,1,1,3,Hibernating
46352,495,12,1265.78,1,4,3,8,At Risk
46353,244,10,1244.54,3,3,3,9,Regulars
46354,72,9,2010.99,4,2,4,10,Big Spenders
46355,80,11,617.35,4,3,1,8,Loyal
46356,103,18,3418.08,4,5,5,14,Champions
46357,52,14,2216.27,5,5,4,14,Champions
46358,692,11,1193.6299999999999,1,3,2,6,Regulars
46359,5,11,1398.3400000000001,5,3,3,11,Loyal
46360,18,9,449.06,5,2,1,8,Regulars
46361,270,12,2249.97,2,4,4,10,At Risk
46362,99,12,3918.4400000000005,4,4,5,13,Champions
46363,107,12,1046.3,4,4,2,10,Loyal
46364,246,18,3738.7200000000003,3,5,5,13,Big Spenders
46365,469,12,1165.6499999999999,1,4,2,7,At Risk
46366,54,12,2935.3,5,4,5,14,Champions
46367,174,11,1138.95,3,3,2,8,Regulars
46368,74,8,1302.72,4,2,3,9,Regulars
46369,139,11,899.6999999999999,4,3,2,9,Loyal
46370,325,13,1845.72,2,4,4,10,At Risk
46371,531,14,7000.36,1,5,5,11,At Risk
46372,59,6,307.41,5,1,1,7,Regulars
46373,214,4,1142.99,3,1,2,6,Regulars
46374,290,6,2381.6099999999997,2,1,4,7,Regulars
46375,60,9,1785.6599999999999,5,2,4,11,Big Spenders
46376,138,13,2984.28,4,4,5,13,Champions
46377,657,8,1050.22,1,2,2,5,Hibernating
46378,327,16,3308.74,2,5,5,12,At Risk
46379,875,7,855.13,1,1,2,4,Hibernating
46380,176,9,913.14,3,2,2,7,Regulars
46381,243,12,586.23,3,4,1,8,Regulars
46382,196,5,592.96,3,1,1,5,Regulars
46383,119,11,1916.64,4,3,4,11,Loyal
46384,115,11,3197.27,4,3,5,12,Loyal
46385,15,13,2772.09,5,4,5,14,Champions
46386,202,8,3952.75,3,2,5,10,Big Spenders
46387,140,18,2087.76,4,5,4,13,Champions
46388,90,9,1958.13,4,2,4,10,Big Spenders
46389,155,10,1223.25,3,3,2,8,Regulars
46390,325,11,2201.12,2,3,4,9,Regulars
46391,80,10,3548.81,4,3,5,12,Loyal
46392,180,8,3156.83,3,2,5,10,Big Spenders
46393,86,17,3073.85,4,5,5,14,Champions
46394,5,10,939.56,5,3,2,10,Loyal
46395,285,11,1465.71,2,3,3,8,Regulars
46396,133,14,2469.12,4,5,4,13,Champions
46397,685,9,800.14,1,2,1,4,Hibernating
46398,424,14,2312.8199999999997,2,5,4,11,At Risk
46399,103,11,1089.81,4,3,2,9,Loyal
46400,749,4,630.9200000000001,1,1,1,3,Hibernating
46401,44,7,697.54,5,1,1,7,Regulars
46402,47,9,685.08,5,2,1,8,Regulars
46403,17,12,1549.75,5,4,3,12,Loyal
46404,174,5,507.34999999999997,3,1,1,5,Regulars
46405,403,11,2112.21,2,3,4,9,Regulars
46406,182,8,721.09,3,2,1,6,Regulars
46407,22,7,295.78,5,1,1,7,Regulars
46408,168,7,340.74,3,1,1,5,Regulars
46409,284,15,2674.16,2,5,5,12,At Risk
46410,263,5,646.31,2,1,1,4,Hibernating
46411,208,14,2884.9999999999995,3,5,5,13,Big Spenders
46412,129,12,1405.52,4,4,3,11,Loyal
46413,403,9,993.63,2,2,2,6,Hibernating
46414,211,5,1976.8400000000001,3,1,4,8,Big Spenders
46415,261,9,1064.2,2,2,2,6,Hibernating
46416,69,8,1174.8400000000001,4,2,2,8,Regulars
46417,91,15,2935.27,4,5,5,14,Champions
46418,110,19,1995.22,4,5,4,13,Champions
46419,220,7,518.13,3,1,1,5,Regulars
46420,34,10,1236.0700000000002,5,3,2,10,Loyal
46421,44,9,1869.6399999999999,5,2,4,11,Big Spenders
46422,70,11,1241.49,4,3,3,10,Loyal
46423,572,7,1326.02,1,1,3,5,Regulars
46424,155,12,1634.8,3,4,3,10,Regulars
46425,71,7,1288.31,4,1,3,8,Regulars
46426,102,11,1441.5300000000002,4,3,3,10,Loyal
46427,127,8,589.49,4,2,1,7,Regulars
46428,445,14,1867.55,2,5,4,11,At Risk
46429,919,7,659.6600000000001,1,1,1,3,Hibernating
46430,443,11,4826.26,2,3,5,10,Regulars
46431,45,11,1164.9099999999999,5,3,2,10,Loyal
46432,214,9,1040.1100000000001,3,2,2,7,Regulars
46433,155,11,2624.96,3,3,5,11,Big Spenders
46434,66,11,984.1500000000001,4,3,2,9,Loyal
46435,140,14,3478.09,4,5,5,14,Champions
46436,454,10,842.6199999999999,2,3,1,6,Regulars
46437,766,10,969.93,1,3,2,6,Regulars
46438,534,10,691.57,1,3,1,5,Regulars
46439,676,9,2089.7400000000002,1,2,4,7,Regulars
46440,47,16,1097.48,5,5,2,12,Loyal
46441,214,8,5567.46,3,2,5,10,Big Spenders
46442,56,11,1090.3600000000001,5,3,2,10,Loyal
46443,151,9,925.88,3,2,2,7,Regulars
46444,720,14,1499.27,1,5,3,9,At Risk
46445,234,10,3243.7000000000003,3,3,5,11,Big Spenders
46446,41,20,2785.84,5,5,5,15,Champions
46447,188,6,575.76,3,1,1,5,Regulars
46448,170,7,1449.9299999999998,3,1,3,7,Regulars
46449,148,11,3196.7100000000005,3,3,5,11,Big Spenders
46450,7,11,2700.6,5,3,5,13,Loyal
46451,39,6,1546.8200000000002,5,1,3,9,Regulars
46452,453,7,883.62,2,1,2,5,Hibernating
46453,91,10,1567.73,4,3,3,10,Loyal
46454,465,10,6888.14,1,3,5,9,Regulars
46455,202,10,2591.27,3,3,5,11,Big Spenders
46456,344,14,3523.46,2,5,5,12,At Risk
46457,23,6,2657.11,5,1,5,11,Big Spenders
46458,970,9,784.14,1,2,1,4,Hibernating
46459,19,10,2039.0800000000002,5,3,4,12,Loyal
46460,236,11,1128.8799999999999,3,3,2,8,Regulars
46461,81,9,934.33,4,2,2,8,Regulars
46462,519,11,1423.06,1,3,3,7,Regulars
46463,855,9,1132.08,1,2,2,5,Hibernating
46464,311,10,923.6999999999999,2,3,2,7,Regulars
46465,421,10,3525.33,2,3,5,10,Regulars
46466,794,8,1499.69,1,2,3,6,Regulars
46467,262,13,1323.48,2,4,3,9,At Risk
46468,5,11,3829.32,5,3,5,13,Loyal
46469,54,9,3128.55,5,2,5,12,Big Spenders
46470,724,8,695.1999999999999,1,2,1,4,Hibernating
46471,414,10,1477.3799999999999,2,3,3,8,Regulars
46472,1459,7,1227.8799999999999,1,1,2,4,Hibernating
46473,31,17,2217.2999999999997,5,5,4,14,Champions
46474,393,7,1093.38,2,1,2,5,Hibernating
46475,106,10,911.59,4,3,2,9,Loyal
46476,7,15,3916.94,5,5,5,15,Champions
46477,146,14,2348.8,4,5,4,13,Champions
46478,651,9,742.6500000000001,1,2,1,4,Hibernating
46479,293,8,546.6,2,2,1,5,Hibernating
46480,330,15,1313.81,2,5,3,10,At Risk
46481,74,8,1528.69,4,2,3,9,Regulars
46482,112,12,2823.41,4,4,5,13,Champions
46483,204,5,430.79,3,1,1,5,Regulars
46484,118,10,2519.1,4,3,4,11,Loyal
46485,3,10,2547.71,5,3,4,12,Loyal
46486,297,11,1026.72,2,3,2,7,Regulars
46487,211,12,2554.32,3,4,4,11,Big Spenders
46488,207,6,1397.9,3,1,3,7,Regulars
46489,276,9,4188.65,2,2,5,9,Regulars
46490,33,13,3618.78,5,4,5,14,Champions
46491,760,10,2982.85,1,3,5,9,Regulars
46492,20,10,1546.46,5,3,3,11,Loyal
46493,24,14,1730.81,5,5,4,14,Champions
46494,87,7,682.4200000000001,4,1,1,6,Regulars
46495,538,8,990.7199999999999,1,2,2,5,Hibernating
46496,9,15,2096.95,5,5,4,14,Champions
46497,32,14,2179.04,5,5,4,14,Champions
46498,474,7,1543.02,1,1,3,5,Regulars
46499,85,12,1435.5,4,4,3,11,Loyal
46500,307,7,2048.89,2,1,4,7,Regulars
46501,536,7,1739.7100000000003,1,1,4,6,Regulars
46502,101,13,1780.78,4,4,4,12,Champions
46503,23,11,1231.72,5,3,2,10,Loyal
46504,552,9,1087.53,1,2,2,5,Hibernating
46505,337,12,1066.91,2,4,2,8,At Risk
46506,71,8,1208.18,4,2,2,8,Regulars
46507,226,6,2082.5699999999997,3,1,4,8,Big Spenders
46508,427,8,880.04,2,2,2,6,Hibernating
46509,164,13,1396.92,3,4,3,10,Regulars
46510,8,7,2867.8399999999997,5,1,5,11,Big Spenders
46511,131,7,2851.7,4,1,5,10,Big Spenders
46512,239,5,548.04,3,1,1,5,Regulars
46513,338,8,728.4499999999999,2,2,1,5,Hibernating
46514,361,6,1248.79,2,1,3,6,Regulars
46515,272,7,1766.1100000000001,2,1,4,7,Regulars
46516,524,12,1126.56,1,4,2,7,At Risk
46517,111,13,951.77,4,4,2,10,Loyal
46518,98,8,859.47,4,2,2,8,Regulars
46519,195,15,1519.29,3,5,3,11,Regulars
46520,797,6,1627.4199999999998,1,1,3,5,Regulars
46521,110,13,2684.67,4,4,5,13,Champions
46522,497,9,961.84,1,2,2,5,Hibernating
46523,273,17,2734.72,2,5,5,12,At Risk
46524,263,15,1708.5,2,5,3,10,At Risk
46525,414,6,782.2199999999999,2,1,1,4,Hibernating
46526,46,9,1301.74,5,2,3,10,Regulars
46527,192,11,3257.12,3,3,5,11,Big Spenders
46528,610,13,2716.4399999999996,1,4,5,10,At Risk
46529,810,10,2490.41,1,3,4,8,Regulars
46530,395,9,601.7800000000001,2,2,1,5,Hibernating
46531,65,11,3742.92,5,3,5,13,Loyal
46532,541,10,2297.2,1,3,4,8,Regulars
46533,75,15,3452.79,4,5,5,14,Champions
46534,140,8,480.20000000000005,4,2,1,7,Regulars
46535,346,9,770.47,2,2,1,5,Hibernating
46536,188,9,1391.21,3,2,3,8,Regulars
46537,442,9,610.03,2,2,1,5,Hibernating
46538,496,11,915.4,1,3,2,6,Regulars
46539,159,9,1143.75,3,2,2,7,Regulars
46540,355,11,1264.5,2,3,3,8,Regulars
46541,175,10,3054.49,3,3,5,11,Big Spenders
46542,14,11,804.83,5,3,1,9,Loyal
46543,524,10,941.94,1,3,2,6,Regulars
46544,297,11,1322.91,2,3,3,8,Regulars
46545,495,9,2542.43,1,2,4,7,Regulars
46546,293,13,2946.09,2,4,5,11,At Risk
46547,462,12,952.26,1,4,2,7,At Risk
46548,886,5,462.25,1,1,1,3,Hibernating
46549,42,12,1864.4099999999999,5,4,4,13,Champions
46550,253,10,2611.49,2,3,5,10,Regulars
46551,155,7,734.37,3,1,1,5,Regulars
46552,30,9,1289.31,5,2,3,10,Regulars
46553,50,11,1135.26,5,3,2,10,Loyal
46554,373,14,1830.65,2,5,4,11,At Risk
46555,109,11,2970.48,4,3,5,12,Loyal
46556,467,9,1579.0400000000002,1,2,3,6,Regulars
46557,146,12,926.5400000000001,4,4,2,10,Loyal
46558,26,7,603.1,5,1,1,7,Regulars
46559,537,8,614.63,1,2,1,4,Hibernating
46560,288,3,109.39,2,1,1,4,Hibernating
46561,884,12,3951.17,1,4,5,10,At Risk
46562,16,13,1949.99,5,4,4,13,Champions
46563,23,10,1456.25,5,3,3,11,Loyal
46564,224,12,1832.6200000000001,3,4,4,11,Big Spenders
46565,213,6,546.13,3,1,1,5,Regulars
46566,179,7,568.03,3,1,1,5,Regulars
46567,23,8,714.49,5,2,1,8,Regulars
46568,347,9,2194.11,2,2,4,8,Regulars
46569,72,11,1246.8400000000001,4,3,3,10,Loyal
46570,728,9,684.83,1,2,1,4,Hibernating
46571,40,8,1878.88,5,2,4,11,Big Spenders
46572,912,8,880.02,1,2,2,5,Hibernating
46573,101,16,3799.76,4,5,5,14,Champions
46574,65,12,1037.87,5,4,2,11,Loyal
46575,238,9,2719.68,3,2,5,10,Big Spenders
46576,14,14,1678.52,5,5,3,13,Loyal
46577,25,9,1358.81,5,2,3,10,Regulars
46578,936,10,3857.76,1,3,5,9,Regulars
46579,502,10,1052.14,1,3,2,6,Regulars
46580,25,16,1722.14,5,5,3,13,Loyal
46581,200,10,2253.0299999999997,3,3,4,10,Big Spenders
46582,173,10,1643.15,3,3,3,9,Regulars
46583,367,10,1225.0,2,3,2,7,Regulars
46584,662,11,912.7,1,3,2,6,Regulars
46585,13,10,1109.0,5,3,2,10,Loyal
46586,919,9,3343.4799999999996,1,2,5,8,Regulars
46587,121,5,616.54,4,1,1,6,Regulars
46588,133,10,4588.02,4,3,5,12,Loyal
46589,119,6,716.95,4,1,1,6,Regulars
46590,109,11,1740.06,4,3,4,11,Loyal
46591,28,10,2322.16,5,3,4,12,Loyal
46592,758,12,1656.46,1,4,3,8,At Risk
46593,649,8,281.89,1,2,1,4,Hibernating
46594,224,9,1301.67,3,2,3,8,Regulars
46595,90,11,2073.92,4,3,4,11,Loyal
46596,165,11,4254.61,3,3,5,11,Big Spenders
46597,214,9,931.1,3,2,2,7,Regulars
46598,732,12,1547.07,1,4,3,8,At Risk
46599,60,11,1480.66,5,3,3,11,Loyal
46600,492,12,1167.7,1,4,2,7,At Risk
46601,497,9,757.36,1,2,1,4,Hibernating
46602,35,10,770.4100000000001,5,3,1,9,Loyal
46603,273,11,937.26,2,3,2,7,Regulars
46604,198,9,1064.95,3,2,2,7,Regulars
46605,242,14,1080.36,3,5,2,10,Regulars
46606,147,14,3140.67,4,5,5,14,Champions
46607,28,12,4016.0499999999997,5,4,5,14,Champions
46608,180,6,398.58,3,1,1,5,Regulars
46609,23,6,1068.7,5,1,2,8,Regulars
46610,26,19,3592.54,5,5,5,15,Champions
46611,89,12,1169.81,4,4,2,10,Loyal
46612,897,6,340.57,1,1,1,3,Hibernating
46613,165,9,933.47,3,2,2,7,Regulars
46614,278,13,1973.08,2,4,4,10,At Risk
46615,725,9,1121.1200000000001,1,2,2,5,Hibernating
46616,163,12,910.3,3,4,2,9,Regulars
46617,15,8,1726.07,5,2,4,11,Big Spenders
46618,703,13,1847.9499999999998,1,4,4,9,At Risk
46619,169,13,1690.98,3,4,3,10,Regulars
46620,94,11,2601.65,4,3,5,12,Loyal
46621,735,10,2528.0499999999997,1,3,4,8,Regulars
46622,228,14,2832.22,3,5,5,13,Big Spenders
46623,1303,6,3637.68,1,1,5,7,Regulars
46624,234,13,1625.8000000000002,3,4,3,10,Regulars
46625,126,5,392.63,4,1,1,6,Regulars
46626,90,16,2596.12,4,5,5,14,Champions
46627,767,11,611.24,1,3,1,5,Regulars
46628,196,10,1138.04,3,3,2,8,Regulars
46629,204,8,1174.2,3,2,2,7,Regulars
46630,88,12,1800.19,4,4,4,12,Champions
46631,236,8,2229.06,3,2,4,9,Big Spenders
46632,238,8,903.2900000000001,3,2,2,7,Regulars
46633,314,7,1281.1699999999998,2,1,3,6,Regulars
46634,151,9,1415.14,3,2,3,8,Regulars
46635,105,9,1687.09,4,2,3,9,Regulars
46636,50,13,1017.61,5,4,2,11,Loyal
46637,39,17,2083.36,5,5,4,14,Champions
46638,266,13,1587.3200000000002,2,4,3,9,At Risk
46639,203,9,819.6,3,2,1,6,Regulars
46640,49,11,3928.82,5,3,5,13,Loyal
46641,10,11,969.46,5,3,2,10,Loyal
46642,953,7,990.59,1,1,2,4,Hibernating
46643,7,15,2880.11,5,5,5,15,Champions
46644,625,5,176.24,1,1,1,3,Hibernating
46645,107,13,1584.92,4,4,3,11,Loyal
46646,173,7,1312.5500000000002,3,1,3,7,Regulars
46647,44,3,199.92000000000002,5,1,1,7,Regulars
46648,193,10,1924.71,3,3,4,10,Big Spenders
46649,884,10,2191.49,1,3,4,8,Regulars
46650,146,8,1211.8,4,2,2,8,Regulars
46651,146,13,2260.85,4,4,4,12,Champions
46652,628,6,558.52,1,1,1,3,Hibernating
46653,480,7,858.96,1,1,2,4,Hibernating
46654,28,10,2340.82,5,3,4,12,Loyal
46655,206,9,590.22,3,2,1,6,Regulars
46656,49,12,1725.8700000000001,5,4,4,13,Champions
46657,127,9,550.81,4,2,1,7,Regulars
46658,85,14,1713.31,4,5,3,12,Loyal
46659,267,10,917.75,2,3,2,7,Regulars
46660,40,9,1135.5900000000001,5,2,2,9,Regulars
46661,329,10,1211.69,2,3,2,7,Regulars
46662,110,13,1551.51,4,4,3,11,Loyal
46663,92,7,1275.84,4,1,3,8,Regulars
46664,290,9,578.47,2,2,1,5,Hibernating
46665,464,13,1485.95,1,4,3,8,At Risk
46666,65,7,791.66,5,1,1,7,Regulars
46667,768,3,402.45,1,1,1,3,Hibernating
46668,10,8,932.76,5,2,2,9,Regulars
46669,95,13,1467.95,4,4,3,11,Loyal
46670,224,9,1832.1999999999998,3,2,4,9,Big Spenders
46671,367,11,1223.76,2,3,2,7,Regulars
46672,103,19,4611.32,4,5,5,14,Champions
46673,117,9,673.42,4,2,1,7,Regulars
46674,721,6,477.84999999999997,1,1,1,3,Hibernating
46675,478,8,917.46,1,2,2,5,Hibernating
46676,383,10,2296.54,2,3,4,9,Regulars
46677,214,10,1297.8999999999999,3,3,3,9,Regulars
46678,27,12,2602.09,5,4,5,14,Champions
46679,5,13,4926.46,5,4,5,14,Champions
46680,511,7,608.79,1,1,1,3,Hibernating
46681,111,10,4644.31,4,3,5,12,Loyal
46682,74,9,495.13,4,2,1,7,Regulars
46683,221,13,4724.599999999999,3,4,5,12,Big Spenders
46684,372,7,822.4399999999999,2,1,1,4,Hibernating
46685,250,6,2041.3400000000001,2,1,4,7,Regulars
46686,94,21,2588.27,4,5,5,14,Champions
46687,378,7,1587.66,2,1,3,6,Regulars
46688,194,9,546.62,3,2,1,6,Regulars
46689,166,11,792.11,3,3,1,7,Regulars
46690,288,13,2014.31,2,4,4,10,At Risk
46691,298,14,1523.62,2,5,3,10,At Risk
46692,199,10,850.3000000000001,3,3,2,8,Regulars
46693,533,12,1507.77,1,4,3,8,At Risk
46694,119,12,755.97,4,4,1,9,Loyal
46695,8,10,3222.4399999999996,5,3,5,13,Loyal
46696,50,15,3736.0099999999998,5,5,5,15,Champions
46697,206,6,1000.6700000000001,3,1,2,6,Regulars
46698,190,8,1081.4,3,2,2,7,Regulars
46699,90,10,1438.74,4,3,3,10,Loyal
46700,84,10,1650.45,4,3,3,10,Loyal
46701,459,9,1373.97,2,2,3,7,Regulars
46702,105,8,1679.15,4,2,3,9,Regulars
46703,50,13,1252.12,5,4,3,12,Loyal
46704,1474,6,3977.86,1,1,5,7,Regulars
46705,211,7,2008.21,3,1,4,8,Big Spenders
46706,411,10,1376.4,2,3,3,8,Regulars
46707,287,7,806.24,2,1,1,4,Hibernating
46708,267,6,589.83,2,1,1,4,Hibernating
46709,321,11,1512.52,2,3,3,8,Regulars
46710,453,13,2093.11,2,4,4,10,At Risk
46711,173,9,1217.26,3,2,2,7,Regulars
46712,56,10,4634.39,5,3,5,13,Loyal
46713,152,11,2720.79,3,3,5,11,Big Spenders
46714,84,10,728.61,4,3,1,8,Loyal
46715,75,8,961.74,4,2,2,8,Regulars
46716,75,8,578.77,4,2,1,7,Regulars
46717,172,10,1021.78,3,3,2,8,Regulars
46718,66,4,181.91,4,1,1,6,Regulars
46719,420,13,2565.11,2,4,4,10,At Risk
46720,184,12,1661.19,3,4,3,10,Regulars
46721,83,10,2544.5299999999997,4,3,4,11,Loyal
46722,225,13,2222.25,3,4,4,11,Big Spenders
46723,57,15,1190.95,5,5,2,12,Loyal
46724,247,12,1271.75,3,4,3,10,Regulars
46725,467,4,623.85,1,1,1,3,Hibernating
46726,876,10,1202.26,1,3,2,6,Regulars
46727,461,7,841.49,1,1,1,3,Hibernating
46728,186,10,1534.7,3,3,3,9,Regulars
46729,11,11,1374.45,5,3,3,11,Loyal
46730,113,10,1597.96,4,3,3,10,Loyal
46731,108,10,2476.96,4,3,4,11,Loyal
46732,241,11,1380.1,3,3,3,9,Regulars
46733,119,9,1470.21,4,2,3,9,Regulars
46734,146,12,1002.5,4,4,2,10,Loyal
46735,165,9,349.94,3,2,1,6,Regulars
46736,191,15,3496.75,3,5,5,13,Big Spenders
46737,217,10,2444.68,3,3,4,10,Big Spenders
46738,50,9,1137.67,5,2,2,9,Regulars
46739,425,10,3354.2999999999997,2,3,5,10,Regulars
46740,6,13,2643.15,5,4,5,14,Champions
46741,818,9,1437.29,1,2,3,6,Regulars
46742,88,10,747.52,4,3,1,8,Loyal
46743,124,11,993.4300000000001,4,3,2,9,Loyal
46744,29,13,2624.81,5,4,5,14,Champions
46745,632,5,974.35,1,1,2,4,Hibernating
46746,181,9,787.05,3,2,1,6,Regulars
46747,128,9,1322.8,4,2,3,9,Regulars
46748,826,8,1048.75,1,2,2,5,Hibernating
46749,2,10,950.3699999999999,5,3,2,10,Loyal
46750,467,10,2311.87,1,3,4,8,Regulars
46751,300,13,2912.88,2,4,5,11,At Risk
46752,105,12,1026.1799999999998,4,4,2,10,Loyal
46753,78,6,1308.83,4,1,3,8,Regulars
46754,105,9,1962.68,4,2,4,10,Big Spenders
46755,890,4,553.73,1,1,1,3,Hibernating
46756,64,8,521.66,5,2,1,8,Regulars
46757,366,11,2104.55,2,3,4,9,Regulars
46758,249,15,903.9499999999999,2,5,2,9,At Risk
46759,127,11,832.98,4,3,1,8,Loyal
46760,236,12,1264.6200000000001,3,4,3,10,Regulars
46761,130,14,4480.99,4,5,5,14,Champions
46762,164,15,2609.31,3,5,5,13,Big Spenders
46763,1184,3,663.15,1,1,1,3,Hibernating
46764,31,16,2786.48,5,5,5,15,Champions
46765,23,8,704.08,5,2,1,8,Regulars
46766,97,15,2095.16,4,5,4,13,Champions
46767,741,14,1249.43,1,5,3,9,At Risk
46768,1418,4,440.44,1,1,1,3,Hibernating
46769,124,10,605.0500000000001,4,3,1,8,Loyal
46770,245,10,1038.44,3,3,2,8,Regulars
46771,52,12,1295.1799999999998,5,4,3,12,Loyal
46772,27,11,1958.48,5,3,4,12,Loyal
46773,500,10,840.61,1,3,1,5,Regulars
46774,753,9,1184.87,1,2,2,5,Hibernating
46775,54,10,1017.27,5,3,2,10,Loyal
46776,889,3,103.18,1,1,1,3,Hibernating
46777,358,11,2733.9,2,3,5,10,Regulars
46778,33,12,4499.25,5,4,5,14,Champions
46779,179,14,1087.07,3,5,2,10,Regulars
46780,205,4,213.54000000000002,3,1,1,5,Regulars
46781,162,10,1594.19,3,3,3,9,Regulars
46782,545,10,970.79,1,3,2,6,Regulars
46783,121,13,1832.47,4,4,4,12,Champions
46784,132,9,1072.69,4,2,2,8,Regulars
46785,9,16,3723.3999999999996,5,5,5,15,Champions
46786,43,10,2625.3900000000003,5,3,5,13,Loyal
46787,28,5,1010.3199999999999,5,1,2,8,Regulars
46788,703,6,6437.43,1,1,5,7,Regulars
46789,131,13,2132.25,4,4,4,12,Champions
46790,371,8,1270.47,2,2,3,7,Regulars
46791,84,16,3069.0099999999998,4,5,5,14,Champions
46792,453,5,665.9200000000001,2,1,1,4,Hibernating
46793,600,8,948.14,1,2,2,5,Hibernating
46794,196,10,932.47,3,3,2,8,Regulars
46795,215,9,1284.33,3,2,3,8,Regulars
46796,338,12,2131.39,2,4,4,10,At Risk
46797,208,12,1927.1299999999999,3,4,4,11,Big Spenders
46798,51,9,850.96,5,2,2,9,Regulars
46799,704,5,786.0300000000001,1,1,1,3,Hibernating
46800,593,12,1357.84,1,4,3,8,At Risk
46801,367,13,1685.06,2,4,3,9,At Risk
46802,8,6,3127.44,5,1,5,11,Big Spenders
46803,66,6,330.65,4,1,1,6,Regulars
46804,154,6,444.55,3,1,1,5,Regulars
46805,265,5,1457.27,2,1,3,6,Regulars
46806,337,14,1816.24,2,5,4,11,At Risk
46807,343,8,1204.89,2,2,2,6,Hibernating
46808,980,7,776.68,1,1,1,3,Hibernating
46809,82,9,1397.58,4,2,3,9,Regulars
46810,479,8,910.0000000000001,1,2,2,5,Hibernating
46811,630,8,285.85,1,2,1,4,Hibernating
46812,52,14,2203.82,5,5,4,14,Champions
46813,201,13,1657.3200000000002,3,4,3,10,Regulars
46814,41,8,1176.93,5,2,2,9,Regulars
46815,83,17,1890.3899999999999,4,5,4,13,Champions
46816,382,9,760.27,2,2,1,5,Hibernating
46817,68,16,3798.3,4,5,5,14,Champions
46818,20,11,966.67,5,3,2,10,Loyal
46819,37,5,683.32,5,1,1,7,Regulars
46820,265,11,1600.95,2,3,3,8,Regulars
46821,5,11,1129.52,5,3,2,10,Loyal
46822,301,12,1110.53,2,4,2,8,At Risk
46823,221,9,1198.0700000000002,3,2,2,7,Regulars
46824,125,4,255.16,4,1,1,6,Regulars
46825,21,15,1682.52,5,5,3,13,Loyal
46826,43,12,2180.42,5,4,4,13,Champions
46827,1310,4,1756.76,1,1,4,6,Regulars
46828,693,12,1501.6200000000001,1,4,3,8,At Risk
46829,43,12,2733.56,5,4,5,14,Champions
46830,151,10,1699.39,3,3,3,9,Regulars
46831,73,5,586.62,4,1,1,6,Regulars
46832,645,12,1898.56,1,4,4,9,At Risk
46833,187,7,2276.89,3,1,4,8,Big Spenders
46834,249,13,3195.7,2,4,5,11,At Risk
46835,1214,9,853.02,1,2,2,5,Hibernating
46836,101,9,746.11,4,2,1,7,Regulars
46837,177,14,1392.35,3,5,3,11,Regulars
46838,141,10,1166.8000000000002,4,3,2,9,Loyal
46839,602,10,1186.1399999999999,1,3,2,6,Regulars
46840,262,8,904.2,2,2,2,6,Hibernating
46841,23,16,7169.98,5,5,5,15,Champions
46842,146,13,2160.12,4,4,4,12,Champions
46843,208,11,1858.3200000000002,3,3,4,10,Big Spenders
46844,271,13,5033.030000000001,2,4,5,11,At Risk
46845,588,9,1677.99,1,2,3,6,Regulars
46846,0,15,2105.43,5,5,4,14,Champions
46847,216,10,823.03,3,3,1,7,Regulars
46848,469,8,726.12,1,2,1,4,Hibernating
46849,77,12,951.0600000000001,4,4,2,10,Loyal
46850,138,9,1154.81,4,2,2,8,Regulars
46851,42,11,3269.27,5,3,5,13,Loyal
46852,26,10,1759.9099999999999,5,3,4,12,Loyal
46853,586,6,980.3199999999999,1,1,2,4,Hibernating
46854,99,9,1101.23,4,2,2,8,Regulars
46855,120,10,3301.73,4,3,5,12,Loyal
46856,147,13,1941.6599999999999,4,4,4,12,Champions
46857,133,10,1909.87,4,3,4,11,Loyal
46858,213,7,478.32,3,1,1,5,Regulars
46859,418,11,1943.94,2,3,4,9,Regulars
46860,225,11,1059.5,3,3,2,8,Regulars
46861,181,14,2254.21,3,5,4,12,Big Spenders
46862,296,13,1910.75,2,4,4,10,At Risk
46863,459,7,612.74,2,1,1,4,Hibernating
46864,79,12,1309.55,4,4,3,11,Loyal
46865,678,11,1425.52,1,3,3,7,Regulars
46866,259,6,2452.94,2,1,4,7,Regulars
46867,374,8,1589.1899999999998,2,2,3,7,Regulars
46868,4,9,1218.83,5,2,2,9,Regulars
46869,164,12,802.64,3,4,1,8,Regulars
46870,297,12,1869.98,2,4,4,10,At Risk
46871,15,11,1616.92,5,3,3,11,Loyal
46872,167,8,1542.92,3,2,3,8,Regulars
46873,191,16,1909.39,3,5,4,12,Big Spenders
46874,152,9,2208.61,3,2,4,9,Big Spenders
46875,141,13,2262.6,4,4,4,12,Champions
46876,104,11,1438.1100000000001,4,3,3,10,Loyal
46877,465,3,497.60999999999996,1,1,1,3,Hibernating
46878,29,14,924.43,5,5,2,12,Loyal
46879,45,13,1714.02,5,4,3,12,Loyal
46880,94,12,2727.93,4,4,5,13,Champions
46881,216,17,2513.23,3,5,4,12,Big Spenders
46882,112,8,969.73,4,2,2,8,Regulars
46883,175,12,2714.18,3,4,5,12,Big Spenders
46884,65,14,1557.84,5,5,3,13,Loyal
46885,144,12,1066.59,4,4,2,10,Loyal
46886,103,17,3767.3999999999996,4,5,5,14,Champions
46887,93,16,1985.84,4,5,4,13,Champions
46888,398,8,536.9,2,2,1,5,Hibernating
46889,413,10,810.22,2,3,1,6,Regulars
46890,461,6,1209.79,1,1,2,4,Hibernating
46891,761,10,2073.31,1,3,4,8,Regulars
46892,686,7,1604.16,1,1,3,5,Regulars
46893,320,14,2304.94,2,5,4,11,At Risk
46894,99,9,779.23,4,2,1,7,Regulars
46895,502,11,3201.78,1,3,5,9,Regulars
46896,250,13,2439.78,2,4,4,10,At Risk
46897,237,11,5143.2300000000005,3,3,5,11,Big Spenders
46898,485,13,2109.91,1,4,4,9,At Risk
46899,9,11,750.8,5,3,1,9,Loyal
46900,456,8,2011.6,2,2,4,8,Regulars
46901,39,9,1312.1,5,2,3,10,Regulars
46902,120,9,1680.3200000000002,4,2,3,9,Regulars
46903,10,9,1091.42,5,2,2,9,Regulars
46904,297,8,812.44,2,2,1,5,Hibernating
46905,94,8,751.76,4,2,1,7,Regulars
46906,99,12,3124.7400000000002,4,4,5,13,Champions
46907,83,13,1209.54,4,4,2,10,Loyal
46908,110,13,1685.34,4,4,3,11,Loyal
46909,583,8,1036.02,1,2,2,5,Hibernating
46910,156,11,1279.33,3,3,3,9,Regulars
46911,528,9,1317.21,1,2,3,6,Regulars
46912,229,11,3385.23,3,3,5,11,Big Spenders
46913,233,14,2909.42,3,5,5,13,Big Spenders
46914,1273,6,582.99,1,1,1,3,Hibernating
46915,415,6,1252.69,2,1,3,6,Regulars
46916,33,7,883.03,5,1,2,8,Regulars
46917,402,7,672.22,2,1,1,4,Hibernating
46918,147,12,1419.83,4,4,3,11,Loyal
46919,342,10,1399.4,2,3,3,8,Regulars
46920,502,9,1496.48,1,2,3,6,Regulars
46921,313,10,849.17,2,3,2,7,Regulars
46922,79,17,1216.0700000000002,4,5,2,11,Loyal
46923,24,11,1222.58,5,3,2,10,Loyal
46924,266,7,482.22,2,1,1,4,Hibernating
46925,387,8,998.25,2,2,2,6,Hibernating
46926,6,9,744.3199999999999,5,2,1,8,Regulars
46927,398,12,2147.66,2,4,4,10,At Risk
46928,27,13,3264.6,5,4,5,14,Champions
46929,27,11,1644.73,5,3,3,11,Loyal
46930,231,9,670.16,3,2,1,6,Regulars
46931,913,13,3691.12,1,4,5,10,At Risk
46932,1305,7,1519.24,1,1,3,5,Regulars
46933,103,13,1678.17,4,4,3,11,Loyal
46934,90,10,1314.21,4,3,3,10,Loyal
46935,49,10,1021.6600000000001,5,3,2,10,Loyal
46936,526,9,1671.45,1,2,3,6,Regulars
46937,60,14,3550.46,5,5,5,15,Champions
46938,202,15,4866.17,3,5,5,13,Big Spenders
46939,90,7,376.88,4,1,1,6,Regulars
46940,445,11,2667.96,2,3,5,10,Regulars
46941,721,12,4027.86,1,4,5,10,At Risk
46942,214,9,2027.75,3,2,4,9,Big Spenders
46943,654,14,3459.89,1,5,5,11,At Risk
46944,626,8,839.35,1,2,1,4,Hibernating
46945,352,5,525.33,2,1,1,4,Hibernating
46946,45,9,742.52,5,2,1,8,Regulars
46947,48,9,1860.34,5,2,4,11,Big Spenders
46948,109,11,1443.63,4,3,3,10,Loyal
46949,99,6,554.31,4,1,1,6,Regulars
46950,457,5,860.94,2,1,2,5,Hibernating
46951,216,12,976.4499999999999,3,4,2,9,Regulars
46952,621,5,706.9499999999999,1,1,1,3,Hibernating
46953,30,13,2865.3199999999997,5,4,5,14,Champions
46954,766,9,967.5999999999999,1,2,2,5,Hibernating
46955,5,9,1891.5,5,2,4,11,Big Spenders
46956,86,13,1399.98,4,4,3,11,Loyal
46957,11,8,2358.71,5,2,4,11,Big Spenders
46958,66,12,1197.29,4,4,2,10,Loyal
46959,157,9,1062.9,3,2,2,7,Regulars
46960,110,5,403.23,4,1,1,6,Regulars
46961,1105,6,775.52,1,1,1,3,Hibernating
46962,290,9,1186.16,2,2,2,6,Hibernating
46963,45,10,2609.53,5,3,5,13,Loyal
46964,165,11,2404.24,3,3,4,10,Big Spenders
46965,16,12,1544.85,5,4,3,12,Loyal
46966,715,6,902.21,1,1,2,4,Hibernating
46967,160,12,2026.37,3,4,4,11,Big Spenders
46968,361,8,606.39,2,2,1,5,Hibernating
46969,290,6,545.26,2,1,1,4,Hibernating
46970,414,11,872.11,2,3,2,7,Regulars
46971,488,11,2199.04,1,3,4,8,Regulars
46972,194,11,856.67,3,3,2,8,Regulars
46973,416,8,1688.5300000000002,2,2,3,7,Regulars
46974,145,8,842.71,4,2,1,7,Regulars
46975,112,12,1396.3,4,4,3,11,Loyal
46976,89,8,690.52,4,2,1,7,Regulars
46977,88,13,1360.47,4,4,3,11,Loyal
46978,69,11,1269.67,4,3,3,10,Loyal
46979,289,10,1613.31,2,3,3,8,Regulars
46980,69,11,1667.8400000000001,4,3,3,10,Loyal
46981,122,6,268.0,4,1,1,6,Regulars
46982,15,6,938.47,5,1,2,8,Regulars
46983,641,9,1444.67,1,2,3,6,Regulars
46984,352,5,2589.08,2,1,5,8,Regulars
46985,414,7,3342.82,2,1,5,8,Regulars
46986,1085,5,248.99,1,1,1,3,Hibernating
46987,763,9,1454.52,1,2,3,6,Regulars
46988,122,10,819.99,4,3,1,8,Loyal
46989,719,10,2141.88,1,3,4,8,Regulars
46990,658,11,2365.79,1,3,4,8,Regulars
46991,233,10,997.8,3,3,2,8,Regulars
46992,435,9,978.95,2,2,2,6,Hibernating
46993,50,11,2952.2599999999998,5,3,5,13,Loyal
46994,49,12,1288.36,5,4,3,12,Loyal
46995,289,6,1321.38,2,1,3,6,Regulars
46996,230,15,2109.69,3,5,4,12,Big Spenders
46997,54,11,2270.0,5,3,4,12,Loyal
46998,453,10,1521.33,2,3,3,8,Regulars
46999,131,14,1482.84,4,5,3,12,Loyal
47000,190,8,646.3299999999999,3,2,1,6,Regulars
47001,15,7,1001.1100000000001,5,1,2,8,Regulars
47002,192,14,2293.54,3,5,4,12,Big Spenders
47003,390,10,969.68,2,3,2,7,Regulars
47004,782,10,950.87,1,3,2,6,Regulars
47005,867,9,1197.4099999999999,1,2,2,5,Hibernating
47006,295,11,950.6800000000001,2,3,2,7,Regulars
47007,133,15,2270.7599999999998,4,5,4,13,Champions
47008,96,12,1417.88,4,4,3,11,Loyal
47009,267,12,1173.6,2,4,2,8,At Risk
47010,167,9,963.91,3,2,2,7,Regulars
47011,438,14,1658.1899999999998,2,5,3,10,At Risk
47012,164,7,661.64,3,1,1,5,Regulars
47013,509,6,304.2,1,1,1,3,Hibernating
47014,210,10,1675.0,3,3,3,9,Regulars
47015,44,10,714.36,5,3,1,9,Loyal
47016,220,12,1477.23,3,4,3,10,Regulars
47017,621,8,1186.17,1,2,2,5,Hibernating
47018,60,17,6588.69,5,5,5,15,Champions
47019,95,3,540.85,4,1,1,6,Regulars
47020,1267,6,452.77000000000004,1,1,1,3,Hibernating
47021,79,10,1405.4299999999998,4,3,3,10,Loyal
47022,18,13,1647.28,5,4,3,12,Loyal
47023,442,10,2212.59,2,3,4,9,Regulars
47024,579,10,780.5699999999999,1,3,1,5,Regulars
47025,17,7,946.76,5,1,2,8,Regulars
47026,156,13,1224.3400000000001,3,4,2,9,Regulars
47027,98,15,3675.27,4,5,5,14,Champions
47028,139,13,1818.5,4,4,4,12,Champions
47029,213,10,1256.73,3,3,3,9,Regulars
47030,667,4,247.82999999999998,1,1,1,3,Hibernating
47031,303,8,1314.69,2,2,3,7,Regulars
47032,92,8,751.84,4,2,1,7,Regulars
47033,103,7,478.28,4,1,1,6,Regulars
47034,331,13,4431.2,2,4,5,11,At Risk
47035,12,11,881.85,5,3,2,10,Loyal
47036,270,6,585.82,2,1,1,4,Hibernating
47037,542,11,2502.71,1,3,4,8,Regulars
47038,92,9,1275.5900000000001,4,2,3,9,Regulars
47039,308,8,937.63,2,2,2,6,Hibernating
47040,478,5,305.97,1,1,1,3,Hibernating
47041,166,12,1299.24,3,4,3,10,Regulars
47042,30,8,653.29,5,2,1,8,Regulars
47043,34,8,1170.53,5,2,2,9,Regulars
47044,237,9,3052.08,3,2,5,10,Big Spenders
47045,434,7,1020.57,2,1,2,5,Hibernating
47046,274,10,3089.36,2,3,5,10,Regulars
47047,98,23,8015.9,4,5,5,14,Champions
47048,103,12,4285.09,4,4,5,13,Champions
47049,759,11,1792.5499999999997,1,3,4,8,Regulars
47050,591,8,1367.6399999999999,1,2,3,6,Regulars
47051,65,13,783.35,5,4,1,10,Loyal
47052,171,7,1857.73,3,1,4,8,Big Spenders
47053,148,11,3892.23,3,3,5,11,Big Spenders
47054,249,9,1538.06,2,2,3,7,Regulars
47055,125,10,1553.04,4,3,3,10,Loyal
47056,399,14,2187.65,2,5,4,11,At Risk
47057,82,10,1008.11,4,3,2,9,Loyal
47058,245,13,2728.06,3,4,5,12,Big Spenders
47059,261,8,2223.48,2,2,4,8,Regulars
47060,64,13,1093.21,5,4,2,11,Loyal
47061,124,11,2689.74,4,3,5,12,Loyal
47062,127,10,1064.1,4,3,2,9,Loyal
47063,427,3,146.87,2,1,1,4,Hibernating
47064,17,14,2209.92,5,5,4,14,Champions
47065,210,17,3284.16,3,5,5,13,Big Spenders
47066,83,10,1957.29,4,3,4,11,Loyal
47067,156,14,1260.54,3,5,3,11,Regulars
47068,167,9,1249.44,3,2,3,8,Regulars
47069,47,15,1911.28,5,5,4,14,Champions
47070,181,13,1453.64,3,4,3,10,Regulars
47071,143,14,5212.2699999999995,4,5,5,14,Champions
47072,408,9,2630.25,2,2,5,9,Regulars
47073,52,15,1928.95,5,5,4,14,Champions
47074,231,11,1400.72,3,3,3,9,Regulars
47075,36,14,3368.47,5,5,5,15,Champions
47076,127,13,1094.65,4,4,2,10,Loyal
47077,598,13,1276.44,1,4,3,8,At Risk
47078,864,14,1897.51,1,5,4,10,At Risk
47079,497,17,2615.83,1,5,5,11,At Risk
47080,116,9,710.86,4,2,1,7,Regulars
47081,203,13,2698.61,3,4,5,12,Big Spenders
47082,242,8,756.49,3,2,1,6,Regulars
47083,72,8,1567.8,4,2,3,9,Regulars
47084,238,12,3255.91,3,4,5,12,Big Spenders
47085,208,12,3100.0099999999998,3,4,5,12,Big Spenders
47086,930,10,2222.4700000000003,1,3,4,8,Regulars
47087,37,18,4060.63,5,5,5,15,Champions
47088,267,7,1023.28,2,1,2,5,Hibernating
47089,65,11,1529.83,5,3,3,11,Loyal
47090,138,10,1147.17,4,3,2,9,Loyal
47091,351,6,897.7599999999999,2,1,2,5,Hibernating
47092,418,4,627.0,2,1,1,4,Hibernating
47093,541,16,2751.9,1,5,5,11,At Risk
47094,452,6,450.77,2,1,1,4,Hibernating
47095,298,16,2549.57,2,5,4,11,At Risk
47096,176,7,2947.56,3,1,5,9,Big Spenders
47097,634,12,2262.0099999999998,1,4,4,9,At Risk
47098,1293,8,708.0699999999999,1,2,1,4,Hibernating
47099,100,9,980.5,4,2,2,8,Regulars
47100,199,11,3077.37,3,3,5,11,Big Spenders
47101,554,9,736.99,1,2,1,4,Hibernating
47102,34,11,1807.13,5,3,4,12,Loyal
47103,657,12,1276.49,1,4,3,8,At Risk
47104,415,10,851.75,2,3,2,7,Regulars
47105,3,10,938.0500000000001,5,3,2,10,Loyal
47106,62,13,4194.52,5,4,5,14,Champions
47107,230,9,2214.6800000000003,3,2,4,9,Big Spenders
47108,552,10,1555.47,1,3,3,7,Regulars
47109,161,10,1333.1200000000001,3,3,3,9,Regulars
47110,180,11,2335.8,3,3,4,10,Big Spenders
47111,43,9,1733.6599999999999,5,2,4,11,Big Spenders
47112,400,10,791.15,2,3,1,6,Regulars
47113,403,3,247.88000000000002,2,1,1,4,Hibernating
47114,117,12,4805.57,4,4,5,13,Champions
47115,103,15,2020.3700000000001,4,5,4,13,Champions
47116,54,8,955.0,5,2,2,9,Regulars
47117,207,11,1138.0,3,3,2,8,Regulars
47118,108,13,2189.78,4,4,4,12,Champions
47119,61,16,1537.45,5,5,3,13,Loyal
47120,7,18,2116.94,5,5,4,14,Champions
47121,149,15,1832.06,3,5,4,12,Big Spenders
47122,39,14,2108.74,5,5,4,14,Champions
47123,320,7,665.45,2,1,1,4,Hibernating
47124,8,9,1410.3300000000002,5,2,3,10,Regulars
47125,748,8,2134.39,1,2,4,7,Regulars
47126,732,13,853.6700000000001,1,4,2,7,At Risk
47127,164,12,2882.04,3,4,5,12,Big Spenders
47128,432,9,1377.69,2,2,3,7,Regulars
47129,288,5,781.9200000000001,2,1,1,4,Hibernating
47130,879,8,875.36,1,2,2,5,Hibernating
47131,71,9,849.38,4,2,2,8,Regulars
47132,232,15,5536.79,3,5,5,13,Big Spenders
47133,17,13,1681.73,5,4,3,12,Loyal
47134,69,11,1989.78,4,3,4,11,Loyal
47135,21,12,1806.1,5,4,4,13,Champions
47136,454,8,931.65,2,2,2,6,Hibernating
47137,462,6,757.63,1,1,1,3,Hibernating
47138,336,9,1467.69,2,2,3,7,Regulars
47139,1200,5,461.11,1,1,1,3,Hibernating
47140,440,13,2373.92,2,4,4,10,At Risk
47141,230,7,1163.13,3,1,2,6,Regulars
47142,242,7,1125.3200000000002,3,1,2,6,Regulars
47143,911,8,947.6899999999999,1,2,2,5,Hibernating
47144,22,18,5378.41,5,5,5,15,Champions
47145,49,13,1562.35,5,4,3,12,Loyal
47146,240,11,1462.75,3,3,3,9,Regulars
47147,947,7,653.64,1,1,1,3,Hibernating
47148,201,5,547.36,3,1,1,5,Regulars
47149,437,7,994.5699999999999,2,1,2,5,Hibernating
47150,153,7,882.83,3,1,2,6,Regulars
47151,94,7,960.88,4,1,2,7,Regulars
47152,426,11,1139.89,2,3,2,7,Regulars
47153,160,5,1267.32,3,1,3,7,Regulars
47154,261,7,2286.98,2,1,4,7,Regulars
47155,6,14,2091.24,5,5,4,14,Champions
47156,202,15,3457.71,3,5,5,13,Big Spenders
47157,166,15,2162.25,3,5,4,12,Big Spenders
47158,167,13,4564.57,3,4,5,12,Big Spenders
47159,452,6,2085.0499999999997,2,1,4,7,Regulars
47160,335,12,1144.96,2,4,2,8,At Risk
47161,12,7,2112.2200000000003,5,1,4,10,Big Spenders
47162,245,10,862.87,3,3,2,8,Regulars
47163,381,9,1303.37,2,2,3,7,Regulars
47164,864,9,638.0799999999999,1,2,1,4,Hibernating
47165,50,12,1263.94,5,4,3,12,Loyal
47166,913,9,1012.4199999999998,1,2,2,5,Hibernating
47167,3,6,795.16,5,1,1,7,Regulars
47168,536,10,3816.32,1,3,5,9,Regulars
47169,260,3,964.35,2,1,2,5,Hibernating
47170,385,10,1264.41,2,3,3,8,Regulars
47171,211,12,3123.09,3,4,5,12,Big Spenders
47172,445,6,2744.5099999999998,2,1,5,8,Regulars
47173,378,11,1693.19,2,3,3,8,Regulars
47174,194,7,866.4300000000001,3,1,2,6,Regulars
47175,48,8,6158.449999999999,5,2,5,12,Big Spenders
47176,243,14,4243.56,3,5,5,13,Big Spenders
47177,45,8,1139.14,5,2,2,9,Regulars
47178,187,13,4147.71,3,4,5,12,Big Spenders
47179,88,14,3183.53,4,5,5,14,Champions
47180,120,14,2314.65,4,5,4,13,Champions
47181,139,12,2059.35,4,4,4,12,Champions
47182,152,14,1518.8000000000002,3,5,3,11,Regulars
47183,78,9,992.6800000000001,4,2,2,8,Regulars
47184,12,7,1245.99,5,1,3,9,Regulars
47185,852,7,949.44,1,1,2,4,Hibernating
47186,134,9,3955.93,4,2,5,11,Big Spenders
47187,335,14,2234.11,2,5,4,11,At Risk
47188,144,13,5685.33,4,4,5,13,Champions
47189,42,11,3157.21,5,3,5,13,Loyal
47190,230,6,1425.22,3,1,3,7,Regulars
47191,108,9,1641.79,4,2,3,9,Regulars
47192,1,16,2294.7000000000003,5,5,4,14,Champions
47193,354,15,2441.14,2,5,4,11,At Risk
47194,558,14,1361.24,1,5,3,9,At Risk
47195,327,14,1172.93,2,5,2,9,At Risk
47196,208,10,1699.85,3,3,3,9,Regulars
47197,60,12,2910.53,5,4,5,14,Champions
47198,285,10,1277.64,2,3,3,8,Regulars
47199,327,6,2188.98,2,1,4,7,Regulars
47200,462,9,1610.01,1,2,3,6,Regulars
47201,78,11,976.3699999999999,4,3,2,9,Loyal
47202,444,11,1748.19,2,3,4,9,Regulars
47203,168,8,1627.6999999999998,3,2,3,8,Regulars
47204,521,4,1317.57,1,1,3,5,Regulars
47205,213,4,606.49,3,1,1,5,Regulars
47206,238,9,2242.0099999999998,3,2,4,9,Big Spenders
47207,412,11,1354.26,2,3,3,8,Regulars
47208,232,10,1698.35,3,3,3,9,Regulars
47209,814,4,590.4499999999999,1,1,1,3,Hibernating
47210,1296,6,741.34,1,1,1,3,Hibernating
47211,477,8,1174.7700000000002,1,2,2,5,Hibernating
47212,192,7,1199.51,3,1,2,6,Regulars
47213,244,9,1513.57,3,2,3,8,Regulars
47214,333,11,1331.84,2,3,3,8,Regulars
47215,23,9,1303.51,5,2,3,10,Regulars
47216,103,13,1341.05,4,4,3,11,Loyal
47217,680,11,1075.54,1,3,2,6,Regulars
47218,500,15,3759.629999999999,1,5,5,11,At Risk
47219,115,8,590.98,4,2,1,7,Regulars
47220,157,7,3990.2999999999997,3,1,5,9,Big Spenders
47221,300,7,2010.35,2,1,4,7,Regulars
47222,3,10,2898.5699999999997,5,3,5,13,Loyal
47223,459,8,1429.94,2,2,3,7,Regulars
47224,181,6,1794.3200000000002,3,1,4,8,Big Spenders
47225,382,7,779.03,2,1,1,4,Hibernating
47226,27,6,804.96,5,1,1,7,Regulars
47227,87,10,1485.43,4,3,3,10,Loyal
47228,36,10,1728.07,5,3,4,12,Loyal
47229,56,14,2570.89,5,5,4,14,Champions
47230,167,13,2039.9300000000003,3,4,4,11,Big Spenders
47231,533,7,1335.13,1,1,3,5,Regulars
47232,368,5,2926.6499999999996,2,1,5,8,Regulars
47233,247,12,3664.5299999999997,3,4,5,12,Big Spenders
47234,129,10,2897.8799999999997,4,3,5,12,Loyal
47235,26,13,2240.93,5,4,4,13,Champions
47236,391,6,344.21,2,1,1,4,Hibernating
47237,470,9,575.77,1,2,1,4,Hibernating
47238,241,7,1870.54,3,1,4,8,Big Spenders
47239,61,9,1184.88,5,2,2,9,Regulars
47240,208,12,1362.02,3,4,3,10,Regulars
47241,224,12,1548.66,3,4,3,10,Regulars
47242,234,13,1900.91,3,4,4,11,Big Spenders
47243,434,7,1373.94,2,1,3,6,Regulars
47244,297,5,665.13,2,1,1,4,Hibernating
47245,236,9,1384.02,3,2,3,8,Regulars
47246,216,9,639.43,3,2,1,6,Regulars
47247,109,7,1921.68,4,1,4,9,Big Spenders
47248,289,11,1417.53,2,3,3,8,Regulars
47249,87,9,766.3199999999999,4,2,1,7,Regulars
47250,65,10,1063.96,5,3,2,10,Loyal
47251,248,12,1317.13,2,4,3,9,At Risk
47252,125,15,1413.6000000000001,4,5,3,12,Loyal
47253,167,15,1237.6200000000001,3,5,2,10,Regulars
47254,447,12,2048.2,2,4,4,10,At Risk
47255,131,6,642.02,4,1,1,6,Regulars
47256,156,11,2911.25,3,3,5,11,Big Spenders
47257,54,13,1441.92,5,4,3,12,Loyal
47258,481,12,970.93,1,4,2,7,At Risk
47259,175,8,1329.7,3,2,3,8,Regulars
47260,628,5,966.46,1,1,2,4,Hibernating
47261,607,9,1098.96,1,2,2,5,Hibernating
47262,203,11,735.99,3,3,1,7,Regulars
47263,136,11,864.6800000000001,4,3,2,9,Loyal
47264,204,9,1596.6299999999999,3,2,3,8,Regulars
47265,95,10,622.08,4,3,1,8,Loyal
47266,213,9,955.44,3,2,2,7,Regulars
47267,665,13,1697.62,1,4,3,8,At Risk
47268,44,9,1209.56,5,2,2,9,Regulars
47269,89,10,607.15,4,3,1,8,Loyal
47270,445,13,2250.23,2,4,4,10,At Risk
47271,203,10,2629.25,3,3,5,11,Big Spenders
47272,140,11,1001.7599999999999,4,3,2,9,Loyal
47273,10,14,1316.93,5,5,3,13,Loyal
47274,146,9,932.59,4,2,2,8,Regulars
47275,78,13,2898.82,4,4,5,13,Champions
47276,684,6,1189.21,1,1,2,4,Hibernating
47277,56,12,1566.6499999999999,5,4,3,12,Loyal
47278,65,7,904.64,5,1,2,8,Regulars
47279,120,9,3236.66,4,2,5,11,Big Spenders
47280,25,15,3521.5,5,5,5,15,Champions
47281,98,12,1853.6599999999999,4,4,4,12,Champions
47282,363,10,2933.96,2,3,5,10,Regulars
47283,552,9,2277.9700000000003,1,2,4,7,Regulars
47284,66,8,1360.5900000000001,4,2,3,9,Regulars
47285,158,15,3741.43,3,5,5,13,Big Spenders
47286,32,11,2398.09,5,3,4,12,Loyal
47287,73,14,2254.82,4,5,4,13,Champions
47288,206,12,2424.0,3,4,4,11,Big Spenders
47289,181,15,2897.48,3,5,5,13,Big Spenders
47290,1153,12,1778.29,1,4,4,9,At Risk
47291,3,11,1259.74,5,3,3,11,Loyal
47292,153,9,1093.1200000000001,3,2,2,7,Regulars
47293,877,4,729.3,1,1,1,3,Hibernating
47294,397,13,1248.38,2,4,3,9,At Risk
47295,341,8,890.84,2,2,2,6,Hibernating
47296,114,11,1382.85,4,3,3,10,Loyal
47297,86,6,1918.8400000000001,4,1,4,9,Big Spenders
47298,65,16,2370.79,5,5,4,14,Champions
47299,141,13,2226.62,4,4,4,12,Champions
47300,153,8,1408.8400000000001,3,2,3,8,Regulars
47301,154,12,1132.98,3,4,2,9,Regulars
47302,238,9,784.38,3,2,1,6,Regulars
47303,541,11,562.66,1,3,1,5,Regulars
47304,75,11,1444.12,4,3,3,10,Loyal
47305,245,11,3987.42,3,3,5,11,Big Spenders
47306,305,9,877.01,2,2,2,6,Hibernating
47307,48,15,3623.88,5,5,5,15,Champions
47308,162,13,2687.81,3,4,5,12,Big Spenders
47309,357,9,683.78,2,2,1,5,Hibernating
47310,166,18,1555.8,3,5,3,11,Regulars
47311,166,15,2083.16,3,5,4,12,Big Spenders
47312,64,11,2902.32,5,3,5,13,Loyal
47313,529,8,1238.6200000000001,1,2,2,5,Hibernating
47314,33,13,1375.97,5,4,3,12,Loyal
47315,6,17,3872.9,5,5,5,15,Champions
47316,1273,7,1808.2600000000002,1,1,4,6,Regulars
47317,69,7,2115.03,4,1,4,9,Big Spenders
47318,522,15,2628.94,1,5,5,11,At Risk
47319,603,4,209.62,1,1,1,3,Hibernating
47320,39,19,2223.63,5,5,4,14,Champions
47321,365,6,849.69,2,1,2,5,Hibernating
47322,379,6,632.51,2,1,1,4,Hibernating
47323,194,9,1383.92,3,2,3,8,Regulars
47324,166,7,3588.52,3,1,5,9,Big Spenders
47325,264,10,1920.02,2,3,4,9,Regulars
47326,312,7,1186.06,2,1,2,5,Hibernating
47327,316,10,3764.5299999999997,2,3,5,10,Regulars
47328,157,9,1243.6000000000001,3,2,3,8,Regulars
47329,502,8,3201.34,1,2,5,8,Regulars
47330,97,15,1743.0,4,5,4,13,Champions
47331,1744,4,791.38,1,1,1,3,Hibernating
47332,121,12,1380.9399999999998,4,4,3,11,Loyal
47333,573,13,1759.1399999999999,1,4,4,9,At Risk
47334,485,7,380.99,1,1,1,3,Hibernating
47335,188,8,747.03,3,2,1,6,Regulars
47336,168,8,1615.45,3,2,3,8,Regulars
47337,121,6,1507.9499999999998,4,1,3,8,Regulars
47338,526,13,1164.55,1,4,2,7,At Risk
47339,946,7,1596.6799999999998,1,1,3,5,Regulars
47340,156,8,770.37,3,2,1,6,Regulars
47341,193,15,3016.2200000000003,3,5,5,13,Big Spenders
47342,724,7,984.4,1,1,2,4,Hibernating
47343,1115,9,1427.15,1,2,3,6,Regulars
47344,526,7,2122.3599999999997,1,1,4,6,Regulars
47345,480,12,953.64,1,4,2,7,At Risk
47346,216,9,2497.31,3,2,4,9,Big Spenders
47347,49,5,1043.6299999999999,5,1,2,8,Regulars
47348,840,7,913.8000000000002,1,1,2,4,Hibernating
47349,104,10,1002.88,4,3,2,9,Loyal
47350,152,11,2134.29,3,3,4,10,Big Spenders
47351,80,14,2665.36,4,5,5,14,Champions
47352,378,9,597.92,2,2,1,5,Hibernating
47353,47,11,1483.49,5,3,3,11,Loyal
47354,200,13,1353.16,3,4,3,10,Regulars
47355,48,12,3476.5899999999997,5,4,5,14,Champions
47356,26,15,3204.85,5,5,5,15,Champions
47357,160,12,3475.18,3,4,5,12,Big Spenders
47358,884,10,1740.17,1,3,4,8,Regulars
47359,253,10,3979.57,2,3,5,10,Regulars
47360,55,11,1699.68,5,3,3,11,Loyal
47361,182,5,645.77,3,1,1,5,Regulars
47362,283,11,1399.08,2,3,3,8,Regulars
47363,58,10,2323.56,5,3,4,12,Loyal
47364,105,15,2094.16,4,5,4,13,Champions
47365,151,13,1868.27,3,4,4,11,Big Spenders
47366,124,11,1100.49,4,3,2,9,Loyal
47367,19,15,4347.8099999999995,5,5,5,15,Champions
47368,260,9,1462.3600000000001,2,2,3,7,Regulars
47369,541,6,717.61,1,1,1,3,Hibernating
47370,276,9,1627.16,2,2,3,7,Regulars
47371,40,12,3067.83,5,4,5,14,Champions
47372,191,7,770.08,3,1,1,5,Regulars
47373,173,16,2657.15,3,5,5,13,Big Spenders
47374,157,15,1167.58,3,5,2,10,Regulars
47375,557,13,3917.1100000000006,1,4,5,10,At Risk
47376,762,10,1560.1000000000001,1,3,3,7,Regulars
47377,434,11,976.17,2,3,2,7,Regulars
47378,131,7,1517.8,4,1,3,8,Regulars
47379,868,10,948.64,1,3,2,6,Regulars
47380,211,13,1165.6000000000001,3,4,2,9,Regulars
47381,77,12,2672.27,4,4,5,13,Champions
47382,129,16,4048.3199999999997,4,5,5,14,Champions
47383,270,4,1230.57,2,1,2,5,Hibernating
47384,336,12,1221.75,2,4,2,8,At Risk
47385,125,9,2484.14,4,2,4,10,Big Spenders
47386,472,6,2444.23,1,1,4,6,Regulars
47387,82,17,3632.71,4,5,5,14,Champions
47388,468,16,3225.98,1,5,5,11,At Risk
47389,52,10,963.66,5,3,2,10,Loyal
47390,139,7,2034.73,4,1,4,9,Big Spenders
47391,119,20,4642.25,4,5,5,14,Champions
47392,126,11,1174.6100000000001,4,3,2,9,Loyal
47393,132,12,926.98,4,4,2,10,Loyal
47394,22,12,1383.1399999999999,5,4,3,12,Loyal
47395,484,16,2683.7400000000002,1,5,5,11,At Risk
47396,59,13,1046.3,5,4,2,11,Loyal
47397,135,6,993.51,4,1,2,7,Regulars
47398,300,9,620.74,2,2,1,5,Hibernating
47399,40,13,2769.08,5,4,5,14,Champions
47400,153,16,1574.64,3,5,3,11,Regulars
47401,437,11,4487.63,2,3,5,10,Regulars
47402,134,7,1377.02,4,1,3,8,Regulars
47403,43,6,902.02,5,1,2,8,Regulars
47404,564,5,641.52,1,1,1,3,Hibernating
47405,198,15,4294.76,3,5,5,13,Big Spenders
47406,381,14,1978.01,2,5,4,11,At Risk
47407,133,11,3501.79,4,3,5,12,Loyal
47408,519,11,2909.7700000000004,1,3,5,9,Regulars
47409,480,11,1359.97,1,3,3,7,Regulars
47410,211,8,1014.4000000000001,3,2,2,7,Regulars
47411,207,10,1040.37,3,3,2,8,Regulars
47412,300,8,579.64,2,2,1,5,Hibernating
47413,92,6,614.6600000000001,4,1,1,6,Regulars
47414,160,8,952.1,3,2,2,7,Regulars
47415,905,8,1352.1200000000001,1,2,3,6,Regulars
47416,272,13,777.9100000000001,2,4,1,7,At Risk
47417,1144,3,348.72999999999996,1,1,1,3,Hibernating
47418,140,16,4273.110000000001,4,5,5,14,Champions
47419,150,14,1840.37,3,5,4,12,Big Spenders
47420,0,14,2310.0299999999997,5,5,4,14,Champions
47421,439,7,436.78000000000003,2,1,1,4,Hibernating
47422,101,9,1391.63,4,2,3,9,Regulars
47423,708,8,321.92,1,2,1,4,Hibernating
47424,98,10,1310.43,4,3,3,10,Loyal
47425,122,10,3124.08,4,3,5,12,Loyal
47426,676,14,3457.0600000000004,1,5,5,11,At Risk
47427,2727,1,130.28,1,1,1,3,Hibernating
47428,236,12,955.1,3,4,2,9,Regulars
47429,95,16,1270.43,4,5,3,12,Loyal
47430,481,13,1533.1899999999998,1,4,3,8,At Risk
47431,388,6,2415.3,2,1,4,7,Regulars
47432,101,15,2783.23,4,5,5,14,Champions
47433,206,16,2926.06,3,5,5,13,Big Spenders
47434,1,9,1269.88,5,2,3,10,Regulars
47435,92,8,1178.02,4,2,2,8,Regulars
47436,23,9,1460.92,5,2,3,10,Regulars
47437,45,13,3798.29,5,4,5,14,Champions
47438,531,10,1030.92,1,3,2,6,Regulars
47439,474,7,364.54,1,1,1,3,Hibernating
47440,379,12,1364.95,2,4,3,9,At Risk
47441,226,13,1636.53,3,4,3,10,Regulars
47442,497,5,635.3000000000001,1,1,1,3,Hibernating
47443,139,5,2914.0099999999998,4,1,5,10,Big Spenders
47444,207,19,1932.8600000000001,3,5,4,12,Big Spenders
47445,244,11,501.1,3,3,1,7,Regulars
47446,116,10,1617.6,4,3,3,10,Loyal
47447,54,18,2756.7,5,5,5,15,Champions
47448,590,9,1255.17,1,2,3,6,Regulars
47449,74,5,377.4,4,1,1,6,Regulars
47450,2,7,851.3599999999999,5,1,2,8,Regulars
47451,211,10,2002.0,3,3,4,10,Big Spenders
47452,82,13,1413.81,4,4,3,11,Loyal
47453,54,13,1279.71,5,4,3,12,Loyal
47454,71,9,1206.87,4,2,2,8,Regulars
47455,297,12,1485.21,2,4,3,9,At Risk
47456,166,13,1411.89,3,4,3,10,Regulars
47457,37,10,1159.03,5,3,2,10,Loyal
47458,22,10,2171.49,5,3,4,12,Loyal
47459,637,6,1301.8600000000001,1,1,3,5,Regulars
47460,375,6,897.25,2,1,2,5,Hibernating
47461,321,10,1198.6299999999999,2,3,2,7,Regulars
47462,82,9,1343.48,4,2,3,9,Regulars
47463,197,11,1475.57,3,3,3,9,Regulars
47464,493,12,3852.2,1,4,5,10,At Risk
47465,167,10,1843.05,3,3,4,10,Big Spenders
47466,74,10,2217.45,4,3,4,11,Loyal
47467,245,6,809.28,3,1,1,5,Regulars
47468,218,14,3133.54,3,5,5,13,Big Spenders
47469,131,16,5743.46,4,5,5,14,Champions
47470,234,9,1741.63,3,2,4,9,Big Spenders
47471,630,10,964.7199999999999,1,3,2,6,Regulars
47472,145,9,788.1,4,2,1,7,Regulars
47473,21,10,2394.6400000000003,5,3,4,12,Loyal
47474,123,11,1705.37,4,3,3,10,Loyal
47475,109,12,1980.38,4,4,4,12,Champions
47476,416,9,1054.62,2,2,2,6,Hibernating
47477,124,13,1169.8600000000001,4,4,2,10,Loyal
47478,1297,9,2025.04,1,2,4,7,Regulars
47479,199,11,1844.55,3,3,4,10,Big Spenders
47480,342,8,1167.49,2,2,2,6,Hibernating
47481,40,11,677.61,5,3,1,9,Loyal
47482,200,11,1638.33,3,3,3,9,Regulars
47483,168,10,695.14,3,3,1,7,Regulars
47484,95,11,1585.19,4,3,3,10,Loyal
47485,464,6,336.7,1,1,1,3,Hibernating
47486,99,11,1538.1200000000001,4,3,3,10,Loyal
47487,682,8,865.24,1,2,2,5,Hibernating
47488,309,5,510.63,2,1,1,4,Hibernating
47489,619,7,560.74,1,1,1,3,Hibernating
47490,183,8,1960.3500000000001,3,2,4,9,Big Spenders
47491,182,5,695.7800000000001,3,1,1,5,Regulars
47492,48,10,776.8100000000001,5,3,1,9,Loyal
47493,350,8,716.58,2,2,1,5,Hibernating
47494,88,11,1414.43,4,3,3,10,Loyal
47495,582,8,2165.18,1,2,4,7,Regulars
47496,192,18,2553.87,3,5,4,12,Big Spenders
47497,90,7,876.63,4,1,2,7,Regulars
47498,630,12,6367.9800000000005,1,4,5,10,At Risk
47499,685,12,3123.07,1,4,5,10,At Risk
47500,265,4,621.71,2,1,1,4,Hibernating
47501,118,14,1745.86,4,5,4,13,Champions
47502,719,12,2120.83,1,4,4,9,At Risk
47503,228,14,2401.7200000000003,3,5,4,12,Big Spenders
47504,33,16,3531.5699999999997,5,5,5,15,Champions
47505,315,10,1324.75,2,3,3,8,Regulars
47506,963,5,469.8,1,1,1,3,Hibernating
47507,471,5,231.32,1,1,1,3,Hibernating
47508,196,8,1284.25,3,2,3,8,Regulars
47509,371,8,2127.18,2,2,4,8,Regulars
47510,547,9,1090.07,1,2,2,5,Hibernating
47511,185,13,829.83,3,4,1,8,Regulars
47512,205,5,683.54,3,1,1,5,Regulars
47513,212,6,622.77,3,1,1,5,Regulars
47514,128,10,1587.1599999999999,4,3,3,10,Loyal
47515,41,14,2007.1200000000001,5,5,4,14,Champions
47516,759,4,900.51,1,1,2,4,Hibernating
47517,352,8,706.45,2,2,1,5,Hibernating
47518,52,11,1757.71,5,3,4,12,Loyal
47519,78,14,1801.67,4,5,4,13,Champions
47520,259,8,681.49,2,2,1,5,Hibernating
47521,202,6,523.98,3,1,1,5,Regulars
47522,217,7,1113.76,3,1,2,6,Regulars
47523,361,10,2855.22,2,3,5,10,Regulars
47524,151,8,511.49,3,2,1,6,Regulars
47525,55,8,553.8199999999999,5,2,1,8,Regulars
47526,1271,11,2370.2,1,3,4,8,Regulars
47527,323,12,2765.75,2,4,5,11,At Risk
47528,100,12,4902.16,4,4,5,13,Champions
47529,100,12,1295.3,4,4,3,11,Loyal
47530,267,12,1316.6200000000001,2,4,3,9,At Risk
47531,93,6,579.9499999999999,4,1,1,6,Regulars
47532,150,14,915.95,3,5,2,10,Regulars
47533,118,14,2460.5,4,5,4,13,Champions
47534,36,20,2392.14,5,5,4,14,Champions
47535,49,5,319.76,5,1,1,7,Regulars
47536,194,8,956.4399999999999,3,2,2,7,Regulars
47537,155,11,817.68,3,3,1,7,Regulars
47538,287,14,1599.51,2,5,3,10,At Risk
47539,290,16,3951.0299999999997,2,5,5,12,At Risk
47540,1389,7,200.73,1,1,1,3,Hibernating
47541,407,6,755.83,2,1,1,4,Hibernating
47542,620,11,1270.12,1,3,3,7,Regulars
47543,211,10,874.88,3,3,2,8,Regulars
47544,890,9,1339.99,1,2,3,6,Regulars
47545,821,11,828.8199999999999,1,3,1,5,Regulars
47546,496,7,4039.2900000000004,1,1,5,7,Regulars
47547,104,8,343.46,4,2,1,7,Regulars
47548,265,13,2282.32,2,4,4,10,At Risk
47549,453,15,2236.34,2,5,4,11,At Risk
47550,708,8,1012.93,1,2,2,5,Hibernating
47551,22,8,583.25,5,2,1,8,Regulars
47552,599,9,750.63,1,2,1,4,Hibernating
47553,175,13,1339.53,3,4,3,10,Regulars
47554,84,9,1100.73,4,2,2,8,Regulars
47555,100,11,1329.42,4,3,3,10,Loyal
47556,246,16,4274.82,3,5,5,13,Big Spenders
47557,703,7,883.49,1,1,2,4,Hibernating
47558,771,8,936.84,1,2,2,5,Hibernating
47559,213,14,2668.61,3,5,5,13,Big Spenders
47560,75,8,522.05,4,2,1,7,Regulars
47561,379,7,753.06,2,1,1,4,Hibernating
47562,495,13,3033.2300000000005,1,4,5,10,At Risk
47563,121,9,1245.6100000000001,4,2,3,9,Regulars
47564,342,17,2179.82,2,5,4,11,At Risk
47565,296,8,588.7,2,2,1,5,Hibernating
47566,1208,7,3191.9799999999996,1,1,5,7,Regulars
47567,215,8,1365.83,3,2,3,8,Regulars
47568,286,8,745.5799999999999,2,2,1,5,Hibernating
47569,593,6,3543.63,1,1,5,7,Regulars
47570,260,9,2861.9100000000003,2,2,5,9,Regulars
47571,110,10,1255.6799999999998,4,3,3,10,Loyal
47572,648,8,2578.37,1,2,5,8,Regulars
47573,148,14,1715.63,3,5,3,11,Regulars
47574,142,4,570.61,4,1,1,6,Regulars
47575,123,13,3449.18,4,4,5,13,Champions
47576,122,15,2171.62,4,5,4,13,Champions
47577,49,11,4511.9,5,3,5,13,Loyal
47578,73,7,696.16,4,1,1,6,Regulars
47579,88,5,595.6800000000001,4,1,1,6,Regulars
47580,126,18,2422.23,4,5,4,13,Champions
47581,259,14,1526.27,2,5,3,10,At Risk
47582,465,11,1077.45,1,3,2,6,Regulars
47583,232,14,2423.7,3,5,4,12,Big Spenders
47584,287,9,843.7299999999999,2,2,1,5,Hibernating
47585,21,8,762.19,5,2,1,8,Regulars
47586,190,12,812.23,3,4,1,8,Regulars
47587,191,8,1694.47,3,2,3,8,Regulars
47588,60,4,155.56,5,1,1,7,Regulars
47589,20,10,897.26,5,3,2,10,Loyal
47590,43,11,721.21,5,3,1,9,Loyal
47591,271,12,848.28,2,4,2,8,At Risk
47592,214,10,3899.81,3,3,5,11,Big Spenders
47593,17,14,2601.13,5,5,5,15,Champions
47594,959,8,1098.01,1,2,2,5,Hibernating
47595,157,10,1465.6499999999999,3,3,3,9,Regulars
47596,227,11,4975.96,3,3,5,11,Big Spenders
47597,50,10,955.86,5,3,2,10,Loyal
47598,26,7,1050.77,5,1,2,8,Regulars
47599,149,13,932.49,3,4,2,9,Regulars
47600,179,10,414.65,3,3,1,7,Regulars
47601,333,11,1585.6799999999998,2,3,3,8,Regulars
47602,224,12,2313.73,3,4,4,11,Big Spenders
47603,216,16,2260.92,3,5,4,12,Big Spenders
47604,198,11,883.53,3,3,2,8,Regulars
47605,1039,8,804.0600000000001,1,2,1,4,Hibernating
47606,468,8,1222.33,1,2,2,5,Hibernating
47607,559,8,2652.2799999999997,1,2,5,8,Regulars
47608,346,8,3197.19,2,2,5,9,Regulars
47609,1176,8,781.46,1,2,1,4,Hibernating
47610,109,14,4544.55,4,5,5,14,Champions
47611,115,13,2500.2799999999997,4,4,4,12,Champions
47612,90,12,1765.55,4,4,4,12,Champions
47613,1700,8,2321.38,1,2,4,7,Regulars
47614,562,8,647.21,1,2,1,4,Hibernating
47615,704,12,2605.96,1,4,5,10,At Risk
47616,633,7,821.62,1,1,1,3,Hibernating
47617,102,6,779.39,4,1,1,6,Regulars
47618,197,9,3425.8599999999997,3,2,5,10,Big Spenders
47619,921,12,879.97,1,4,2,7,At Risk
47620,280,11,5930.2300000000005,2,3,5,10,Regulars
47621,983,7,497.96000000000004,1,1,1,3,Hibernating
47622,214,7,1359.7600000000002,3,1,3,7,Regulars
47623,554,9,1210.83,1,2,2,5,Hibernating
47624,1210,9,1024.88,1,2,2,5,Hibernating
47625,14,11,1130.88,5,3,2,10,Loyal
47626,608,13,2676.0099999999998,1,4,5,10,At Risk
47627,72,5,526.76,4,1,1,6,Regulars
47628,521,11,2200.52,1,3,4,8,Regulars
47629,12,9,4431.75,5,2,5,12,Big Spenders
47630,143,11,891.57,4,3,2,9,Loyal
47631,240,18,3315.6,3,5,5,13,Big Spenders
47632,20,8,881.38,5,2,2,9,Regulars
47633,251,9,1227.29,2,2,2,6,Hibernating
47634,280,12,1375.39,2,4,3,9,At Risk
47635,848,9,1293.8,1,2,3,6,Regulars
47636,155,14,1275.75,3,5,3,11,Regulars
47637,26,11,3619.69,5,3,5,13,Loyal
47638,156,12,3670.12,3,4,5,12,Big Spenders
47639,766,4,249.8,1,1,1,3,Hibernating
47640,108,12,986.3,4,4,2,10,Loyal
47641,93,6,550.98,4,1,1,6,Regulars
47642,232,14,1983.1399999999999,3,5,4,12,Big Spenders
47643,77,10,1310.54,4,3,3,10,Loyal
47644,5,8,1103.51,5,2,2,9,Regulars
47645,963,10,2722.53,1,3,5,9,Regulars
47646,120,9,1764.07,4,2,4,10,Big Spenders
47647,385,13,1260.94,2,4,3,9,At Risk
47648,90,12,1570.08,4,4,3,11,Loyal
47649,410,8,964.05,2,2,2,6,Hibernating
47650,80,13,1456.9,4,4,3,11,Loyal
47651,95,8,1379.7,4,2,3,9,Regulars
47652,293,7,608.82,2,1,1,4,Hibernating
47653,116,10,3402.5,4,3,5,12,Loyal
47654,85,6,1482.65,4,1,3,8,Regulars
47655,214,8,2284.54,3,2,4,9,Big Spenders
47656,234,10,1577.6699999999998,3,3,3,9,Regulars
47657,26,11,1416.1399999999999,5,3,3,11,Loyal
47658,949,6,2130.11,1,1,4,6,Regulars
47659,195,11,1810.32,3,3,4,10,Big Spenders
47660,26,10,2214.6099999999997,5,3,4,12,Loyal
47661,312,12,996.9200000000001,2,4,2,8,At Risk
47662,182,11,1058.17,3,3,2,8,Regulars
47663,108,11,1098.34,4,3,2,9,Loyal
47664,71,13,3679.56,4,4,5,13,Champions
47665,335,12,3148.9100000000003,2,4,5,11,At Risk
47666,508,6,375.85,1,1,1,3,Hibernating
47667,64,11,1732.28,5,3,4,12,Loyal
47668,31,8,699.35,5,2,1,8,Regulars
47669,106,14,7173.52,4,5,5,14,Champions
47670,141,9,830.15,4,2,1,7,Regulars
47671,798,6,569.24,1,1,1,3,Hibernating
47672,170,7,527.32,3,1,1,5,Regulars
47673,112,11,3527.6,4,3,5,12,Loyal
47674,127,6,561.1700000000001,4,1,1,6,Regulars
47675,207,13,2531.14,3,4,4,11,Big Spenders
47676,260,7,883.1800000000001,2,1,2,5,Hibernating
47677,138,12,1152.1599999999999,4,4,2,10,Loyal
47678,22,15,1415.36,5,5,3,13,Loyal
47679,463,12,2130.93,1,4,4,9,At Risk
47680,809,7,965.0,1,1,2,4,Hibernating
47681,0,12,972.49,5,4,2,11,Loyal
47682,594,13,4264.88,1,4,5,10,At Risk
47683,544,9,1097.24,1,2,2,5,Hibernating
47684,141,17,2127.35,4,5,4,13,Champions
47685,166,6,709.5,3,1,1,5,Regulars
47686,596,10,510.21,1,3,1,5,Regulars
47687,127,11,2657.06,4,3,5,12,Loyal
47688,66,11,1025.99,4,3,2,9,Loyal
47689,67,19,2339.22,4,5,4,13,Champions
47690,86,11,2668.29,4,3,5,12,Loyal
47691,213,10,2853.9,3,3,5,11,Big Spenders
47692,105,16,2016.45,4,5,4,13,Champions
47693,1404,5,1319.27,1,1,3,5,Regulars
47694,68,11,1321.94,4,3,3,10,Loyal
47695,375,14,1793.8600000000001,2,5,4,11,At Risk
47696,271,11,1521.64,2,3,3,8,Regulars
47697,35,7,941.25,5,1,2,8,Regulars
47698,540,9,1131.8899999999999,1,2,2,5,Hibernating
47699,68,10,3760.46,4,3,5,12,Loyal
47700,651,12,3100.42,1,4,5,10,At Risk
47701,65,10,1224.29,5,3,2,10,Loyal
47702,23,13,1721.17,5,4,3,12,Loyal
47703,84,6,552.47,4,1,1,6,Regulars
47704,99,13,986.73,4,4,2,10,Loyal
47705,131,8,1097.1999999999998,4,2,2,8,Regulars
47706,838,8,1347.39,1,2,3,6,Regulars
47707,28,14,2664.6,5,5,5,15,Champions
47708,278,11,1123.1599999999999,2,3,2,7,Regulars
47709,331,9,3430.37,2,2,5,9,Regulars
47710,64,9,1057.09,5,2,2,9,Regulars
47711,186,11,996.5300000000001,3,3,2,8,Regulars
47712,369,9,2547.71,2,2,4,8,Regulars
47713,91,10,1635.0099999999998,4,3,3,10,Loyal
47714,73,10,909.5600000000001,4,3,2,9,Loyal
47715,91,8,471.67,4,2,1,7,Regulars
47716,285,14,2090.25,2,5,4,11,At Risk
47717,623,5,1378.0300000000002,1,1,3,5,Regulars
47718,329,9,1638.6,2,2,3,7,Regulars
47719,25,8,747.67,5,2,1,8,Regulars
47720,28,5,1650.8500000000001,5,1,3,9,Regulars
47721,85,9,465.56,4,2,1,7,Regulars
47722,504,9,987.71,1,2,2,5,Hibernating
47723,179,13,1361.72,3,4,3,10,Regulars
47724,15,14,1739.75,5,5,4,14,Champions
47725,279,14,4229.37,2,5,5,12,At Risk
47726,116,13,1255.98,4,4,3,11,Loyal
47727,411,11,1551.73,2,3,3,8,Regulars
47728,90,11,1951.42,4,3,4,11,Loyal
47729,38,16,4343.5599999999995,5,5,5,15,Champions
47730,496,9,1071.99,1,2,2,5,Hibernating
47731,519,16,2243.4500000000003,1,5,4,10,At Risk
47732,2,13,1196.87,5,4,2,11,Loyal
47733,171,17,1848.32,3,5,4,12,Big Spenders
47734,224,7,1575.58,3,1,3,7,Regulars
47735,0,14,3343.43,5,5,5,15,Champions
47736,60,12,1182.96,5,4,2,11,Loyal
47737,153,6,1360.76,3,1,3,7,Regulars
47738,15,15,4024.0099999999993,5,5,5,15,Champions
47739,837,10,1383.98,1,3,3,7,Regulars
47740,331,9,2976.23,2,2,5,9,Regulars
47741,126,12,1707.74,4,4,3,11,Loyal
47742,318,12,1622.31,2,4,3,9,At Risk
47743,213,12,1678.72,3,4,3,10,Regulars
47744,614,8,1142.19,1,2,2,5,Hibernating
47745,193,11,1120.72,3,3,2,8,Regulars
47746,315,11,1311.25,2,3,3,8,Regulars
47747,38,11,2621.98,5,3,5,13,Loyal
47748,194,9,1423.48,3,2,3,8,Regulars
47749,0,10,1932.64,5,3,4,12,Loyal
47750,120,15,3017.78,4,5,5,14,Champions
47751,279,11,1225.4,2,3,2,7,Regulars
47752,546,6,382.28999999999996,1,1,1,3,Hibernating
47753,279,12,3708.94,2,4,5,11,At Risk
47754,127,11,1080.51,4,3,2,9,Loyal
47755,176,11,1204.55,3,3,2,8,Regulars
47756,518,11,3646.13,1,3,5,9,Regulars
47757,211,10,1070.64,3,3,2,8,Regulars
47758,224,9,2444.07,3,2,4,9,Big Spenders
47759,223,8,943.1700000000001,3,2,2,7,Regulars
47760,10,11,3963.2000000000003,5,3,5,13,Loyal
47761,265,6,661.0799999999999,2,1,1,4,Hibernating
47762,836,13,955.0600000000001,1,4,2,7,At Risk
47763,278,12,2765.05,2,4,5,11,At Risk
47764,552,4,504.13000000000005,1,1,1,3,Hibernating
47765,347,16,3491.96,2,5,5,12,At Risk
47766,165,6,919.51,3,1,2,6,Regulars
47767,154,12,1271.68,3,4,3,10,Regulars
47768,61,14,1612.18,5,5,3,13,Loyal
47769,455,9,2750.7200000000003,2,2,5,9,Regulars
47770,148,12,1049.95,3,4,2,9,Regulars
47771,124,18,2738.77,4,5,5,14,Champions
47772,43,16,1599.46,5,5,3,13,Loyal
47773,348,12,2513.09,2,4,4,10,At Risk
47774,152,9,1556.0,3,2,3,8,Regulars
47775,63,14,3284.73,5,5,5,15,Champions
47776,85,15,4403.23,4,5,5,14,Champions
47777,47,13,3410.38,5,4,5,14,Champions
47778,1338,8,452.32000000000005,1,2,1,4,Hibernating
47779,377,13,1872.57,2,4,4,10,At Risk
47780,62,14,2245.51,5,5,4,14,Champions
47781,53,8,1655.61,5,2,3,10,Regulars
47782,343,13,2318.07,2,4,4,10,At Risk
47783,609,11,1905.64,1,3,4,8,Regulars
47784,44,11,2891.96,5,3,5,13,Loyal
47785,362,9,465.09000000000003,2,2,1,5,Hibernating
47786,249,11,1464.13,2,3,3,8,Regulars
47787,225,8,1133.3700000000001,3,2,2,7,Regulars
47788,831,12,834.92,1,4,1,6,At Risk
47789,372,10,4138.86,2,3,5,10,Regulars
47790,537,10,2770.56,1,3,5,9,Regulars
47791,534,10,4584.4,1,3,5,9,Regulars
47792,1921,4,427.52,1,1,1,3,Hibernating
47793,40,6,785.18,5,1,1,7,Regulars
47794,338,5,329.5,2,1,1,4,Hibernating
47795,94,14,1880.71,4,5,4,13,Champions
47796,491,15,2510.85,1,5,4,10,At Risk
47797,177,8,1378.77,3,2,3,8,Regulars
47798,566,10,886.44,1,3,2,6,Regulars
47799,50,5,324.12,5,1,1,7,Regulars
47800,189,15,1864.8600000000001,3,5,4,12,Big Spenders
47801,817,9,2915.29,1,2,5,8,Regulars
47802,219,16,2401.6,3,5,4,12,Big Spenders
47803,484,10,612.0600000000001,1,3,1,5,Regulars
47804,665,8,1034.21,1,2,2,5,Hibernating
47805,214,10,1596.71,3,3,3,9,Regulars
47806,3,8,1225.79,5,2,2,9,Regulars
47807,239,10,1591.02,3,3,3,9,Regulars
47808,143,7,768.57,4,1,1,6,Regulars
47809,328,11,1086.25,2,3,2,7,Regulars
47810,297,15,3397.89,2,5,5,12,At Risk
47811,518,8,1206.16,1,2,2,5,Hibernating
47812,421,10,676.44,2,3,1,6,Regulars
47813,561,12,3625.61,1,4,5,10,At Risk
47814,798,11,2501.88,1,3,4,8,Regulars
47815,245,6,623.22,3,1,1,5,Regulars
47816,32,12,1547.96,5,4,3,12,Loyal
47817,251,13,2852.72,2,4,5,11,At Risk
47818,184,10,2054.35,3,3,4,10,Big Spenders
47819,502,13,3332.37,1,4,5,10,At Risk
47820,437,8,506.78999999999996,2,2,1,5,Hibernating
47821,176,14,1730.61,3,5,4,12,Big Spenders
47822,385,9,2813.43,2,2,5,9,Regulars
47823,330,8,2528.23,2,2,4,8,Regulars
47824,123,10,3269.97,4,3,5,12,Loyal
47825,261,9,2676.17,2,2,5,9,Regulars
47826,49,7,878.28,5,1,2,8,Regulars
47827,5,13,3222.5,5,4,5,14,Champions
47828,431,12,3301.86,2,4,5,11,At Risk
47829,892,4,1077.7600000000002,1,1,2,4,Hibernating
47830,1274,8,1632.82,1,2,3,6,Regulars
47831,103,8,358.31,4,2,1,7,Regulars
47832,502,10,584.39,1,3,1,5,Regulars
47833,103,8,2509.27,4,2,4,10,Big Spenders
47834,176,9,690.32,3,2,1,6,Regulars
47835,110,10,985.82,4,3,2,9,Loyal
47836,149,14,2157.08,3,5,4,12,Big Spenders
47837,1599,7,619.21,1,1,1,3,Hibernating
47838,180,9,908.05,3,2,2,7,Regulars
47839,459,11,3672.6200000000003,2,3,5,10,Regulars
47840,108,12,1528.61,4,4,3,11,Loyal
47841,27,11,1702.13,5,3,3,11,Loyal
47842,72,13,784.59,4,4,1,9,Loyal
47843,333,8,858.6,2,2,2,6,Hibernating
47844,144,6,2509.08,4,1,4,9,Big Spenders
47845,172,10,1484.72,3,3,3,9,Regulars
47846,428,14,984.4200000000001,2,5,2,9,At Risk
47847,442,10,1409.7,2,3,3,8,Regulars
47848,1028,5,545.34,1,1,1,3,Hibernating
47849,109,7,825.95,4,1,1,6,Regulars
47850,141,12,2645.9300000000003,4,4,5,13,Champions
47851,70,15,2206.39,4,5,4,13,Champions
47852,72,14,2402.08,4,5,4,13,Champions
47853,558,8,871.13,1,2,2,5,Hibernating
47854,327,6,348.33,2,1,1,4,Hibernating
47855,582,7,562.36,1,1,1,3,Hibernating
47856,234,8,2221.17,3,2,4,9,Big Spenders
47857,27,6,2880.9500000000003,5,1,5,11,Big Spenders
47858,68,12,1279.18,4,4,3,11,Loyal
47859,149,7,2352.83,3,1,4,8,Big Spenders
47860,384,10,964.85,2,3,2,7,Regulars
47861,124,12,3439.0,4,4,5,13,Champions
47862,816,4,1865.6799999999998,1,1,4,6,Regulars
47863,126,8,2316.55,4,2,4,10,Big Spenders
47864,463,8,1116.38,1,2,2,5,Hibernating
47865,202,14,2224.5499999999997,3,5,4,12,Big Spenders
47866,218,6,1938.53,3,1,4,8,Big Spenders
47867,103,14,1636.82,4,5,3,12,Loyal
47868,153,13,1169.99,3,4,2,9,Regulars
47869,261,11,2417.37,2,3,4,9,Regulars
47870,165,7,422.91,3,1,1,5,Regulars
47871,12,6,1296.97,5,1,3,9,Regulars
47872,278,10,891.8,2,3,2,7,Regulars
47873,276,13,1863.59,2,4,4,10,At Risk
47874,682,7,1487.83,1,1,3,5,Regulars
47875,176,11,5267.89,3,3,5,11,Big Spenders
47876,6,8,1114.19,5,2,2,9,Regulars
47877,298,8,823.25,2,2,1,5,Hibernating
47878,312,10,2017.8600000000001,2,3,4,9,Regulars
47879,164,5,1099.59,3,1,2,6,Regulars
47880,87,11,1687.74,4,3,3,10,Loyal
47881,592,10,3124.43,1,3,5,9,Regulars
47882,220,10,665.5,3,3,1,7,Regulars
47883,243,7,952.05,3,1,2,6,Regulars
47884,191,12,712.4399999999999,3,4,1,8,Regulars
47885,4,11,1588.27,5,3,3,11,Loyal
47886,586,8,603.5,1,2,1,4,Hibernating
47887,106,9,1678.38,4,2,3,9,Regulars
47888,81,10,2092.34,4,3,4,11,Loyal
47889,400,14,3615.97,2,5,5,12,At Risk
47890,391,8,2071.85,2,2,4,8,Regulars
47891,685,12,1532.05,1,4,3,8,At Risk
47892,27,15,1734.1,5,5,4,14,Champions
47893,1219,9,550.47,1,2,1,4,Hibernating
47894,1362,14,3894.2799999999997,1,5,5,11,At Risk
47895,111,9,882.9399999999999,4,2,2,8,Regulars
47896,393,12,1375.18,2,4,3,9,At Risk
47897,139,11,2366.42,4,3,4,11,Loyal
47898,558,15,1626.61,1,5,3,9,At Risk
47899,485,8,1111.46,1,2,2,5,Hibernating
47900,348,8,1605.99,2,2,3,7,Regulars
47901,319,14,2698.8199999999997,2,5,5,12,At Risk
47902,264,10,1941.47,2,3,4,9,Regulars
47903,189,5,348.04999999999995,3,1,1,5,Regulars
47904,30,15,2110.38,5,5,4,14,Champions
47905,274,12,1907.6599999999999,2,4,4,10,At Risk
47906,345,10,1100.37,2,3,2,7,Regulars
47907,129,9,1824.88,4,2,4,10,Big Spenders
47908,122,11,1137.32,4,3,2,9,Loyal
47909,389,7,1261.2,2,1,3,6,Regulars
47910,177,16,1743.26,3,5,4,12,Big Spenders
47911,943,13,1959.0,1,4,4,9,At Risk
47912,661,6,3824.4999999999995,1,1,5,7,Regulars
47913,422,4,652.44,2,1,1,4,Hibernating
47914,399,11,651.6899999999999,2,3,1,6,Regulars
47915,153,9,1428.72,3,2,3,8,Regulars
47916,133,6,1781.2199999999998,4,1,4,9,Big Spenders
47917,166,9,3811.5400000000004,3,2,5,10,Big Spenders
47918,439,12,1545.76,2,4,3,9,At Risk
47919,165,11,2432.19,3,3,4,10,Big Spenders
47920,225,11,1301.03,3,3,3,9,Regulars
47921,513,9,976.01,1,2,2,5,Hibernating
47922,138,8,517.19,4,2,1,7,Regulars
47923,212,7,849.45,3,1,2,6,Regulars
47924,239,9,1818.7099999999998,3,2,4,9,Big Spenders
47925,379,11,724.6999999999999,2,3,1,6,Regulars
47926,166,15,4930.46,3,5,5,13,Big Spenders
47927,14,11,1387.28,5,3,3,11,Loyal
47928,236,10,732.06,3,3,1,7,Regulars
47929,11,17,3859.64,5,5,5,15,Champions
47930,420,10,1121.14,2,3,2,7,Regulars
47931,74,9,1946.13,4,2,4,10,Big Spenders
47932,199,12,2255.0299999999997,3,4,4,11,Big Spenders
47933,161,5,518.56,3,1,1,5,Regulars
47934,550,12,2349.78,1,4,4,9,At Risk
47935,2145,2,212.65,1,1,1,3,Hibernating
47936,24,15,2058.98,5,5,4,14,Champions
47937,35,12,1423.05,5,4,3,12,Loyal
47938,221,10,1484.89,3,3,3,9,Regulars
47939,390,8,1567.7,2,2,3,7,Regulars
47940,491,8,718.42,1,2,1,4,Hibernating
47941,67,14,2850.8299999999995,4,5,5,14,Champions
47942,121,10,531.43,4,3,1,8,Loyal
47943,288,10,684.1700000000001,2,3,1,6,Regulars
47944,473,7,642.1600000000001,1,1,1,3,Hibernating
47945,71,17,2732.91,4,5,5,14,Champions
47946,186,9,711.53,3,2,1,6,Regulars
47947,136,10,1062.68,4,3,2,9,Loyal
47948,173,11,756.35,3,3,1,7,Regulars
47949,155,14,4366.7699999999995,3,5,5,13,Big Spenders
47950,189,8,734.9,3,2,1,6,Regulars
47951,187,12,1984.82,3,4,4,11,Big Spenders
47952,252,15,3823.97,2,5,5,12,At Risk
47953,482,6,2122.9,1,1,4,6,Regulars
47954,894,5,648.9399999999999,1,1,1,3,Hibernating
47955,496,9,1185.68,1,2,2,5,Hibernating
47956,824,6,1568.93,1,1,3,5,Regulars
47957,50,10,1501.29,5,3,3,11,Loyal
47958,267,6,521.77,2,1,1,4,Hibernating
47959,233,12,1062.53,3,4,2,9,Regulars
47960,55,12,1320.1200000000001,5,4,3,12,Loyal
47961,2,7,444.06,5,1,1,7,Regulars
47962,9,8,1478.04,5,2,3,10,Regulars
47963,705,6,987.75,1,1,2,4,Hibernating
47964,227,12,971.69,3,4,2,9,Regulars
47965,110,13,2164.04,4,4,4,12,Champions
47966,16,9,1506.3600000000001,5,2,3,10,Regulars
47967,34,13,1509.05,5,4,3,12,Loyal
47968,31,15,3430.6800000000003,5,5,5,15,Champions
47969,164,9,964.5899999999999,3,2,2,7,Regulars
47970,841,6,774.25,1,1,1,3,Hibernating
47971,863,12,1613.19,1,4,3,8,At Risk
47972,68,12,3867.1000000000004,4,4,5,13,Champions
47973,240,8,1215.1399999999999,3,2,2,7,Regulars
47974,231,6,1303.42,3,1,3,7,Regulars
47975,135,15,1554.95,4,5,3,12,Loyal
47976,64,7,1514.6799999999998,5,1,3,9,Regulars
47977,220,8,642.19,3,2,1,6,Regulars
47978,611,6,738.96,1,1,1,3,Hibernating
47979,234,13,1311.65,3,4,3,10,Regulars
47980,49,14,1700.02,5,5,3,13,Loyal
47981,1043,7,1195.4,1,1,2,4,Hibernating
47982,414,6,2753.17,2,1,5,8,Regulars
47983,569,3,188.75,1,1,1,3,Hibernating
47984,170,15,5253.69,3,5,5,13,Big Spenders
47985,15,8,1005.4499999999999,5,2,2,9,Regulars
47986,195,9,1115.4299999999998,3,2,2,7,Regulars
47987,1699,7,733.7800000000001,1,1,1,3,Hibernating
47988,761,16,1705.01,1,5,3,9,At Risk
47989,146,11,4007.22,4,3,5,12,Loyal
47990,225,12,2499.83,3,4,4,11,Big Spenders
47991,134,15,1400.15,4,5,3,12,Loyal
47992,37,10,991.1800000000001,5,3,2,10,Loyal
47993,67,10,1398.02,4,3,3,10,Loyal
47994,164,7,649.49,3,1,1,5,Regulars
47995,60,12,1027.63,5,4,2,11,Loyal
47996,285,6,477.78,2,1,1,4,Hibernating
47997,219,3,1006.6499999999999,3,1,2,6,Regulars
47998,62,13,2787.1,5,4,5,14,Champions
47999,521,5,198.57,1,1,1,3,Hibernating
48000,68,13,2343.04,4,4,4,12,Champions
48001,245,8,719.59,3,2,1,6,Regulars
48002,176,4,448.5199999999999,3,1,1,5,Regulars
48003,98,10,3332.55,4,3,5,12,Loyal
48004,162,10,1718.27,3,3,3,9,Regulars
48005,97,10,1398.31,4,3,3,10,Loyal
48006,169,7,1583.28,3,1,3,7,Regulars
48007,200,10,1739.1599999999999,3,3,4,10,Big Spenders
48008,136,11,3650.19,4,3,5,12,Loyal
48009,161,8,3270.37,3,2,5,10,Big Spenders
48010,125,12,1820.81,4,4,4,12,Champions
48011,314,6,666.86,2,1,1,4,Hibernating
48012,131,9,1558.74,4,2,3,9,Regulars
48013,1433,9,1113.88,1,2,2,5,Hibernating
48014,149,10,2328.39,3,3,4,10,Big Spenders
48015,138,11,764.26,4,3,1,8,Loyal
48016,148,11,1881.64,3,3,4,10,Big Spenders
48017,28,7,617.14,5,1,1,7,Regulars
48018,1619,5,1422.03,1,1,3,5,Regulars
48019,40,12,1515.31,5,4,3,12,Loyal
48020,229,6,568.26,3,1,1,5,Regulars
48021,297,10,1836.6,2,3,4,9,Regulars
48022,196,6,828.76,3,1,1,5,Regulars
48023,51,11,977.85,5,3,2,10,Loyal
48024,135,11,1671.96,4,3,3,10,Loyal
48025,402,15,4869.86,2,5,5,12,At Risk
48026,252,10,1501.44,2,3,3,8,Regulars
48027,489,14,1588.0500000000002,1,5,3,9,At Risk
48028,685,6,682.54,1,1,1,3,Hibernating
48029,61,5,1132.67,5,1,2,8,Regulars
48030,60,16,1412.2,5,5,3,13,Loyal
48031,725,8,1337.9,1,2,3,6,Regulars
48032,231,13,1204.86,3,4,2,9,Regulars
48033,554,6,2334.34,1,1,4,6,Regulars
48034,237,20,1917.8799999999999,3,5,4,12,Big Spenders
48035,231,8,3657.04,3,2,5,10,Big Spenders
48036,718,8,1271.38,1,2,3,6,Regulars
48037,66,12,1265.01,4,4,3,11,Loyal
48038,82,11,2128.88,4,3,4,11,Loyal
48039,434,6,505.4,2,1,1,4,Hibernating
48040,755,9,2357.65,1,2,4,7,Regulars
48041,820,13,4143.5,1,4,5,10,At Risk
48042,298,14,1320.64,2,5,3,10,At Risk
48043,39,16,1850.0500000000002,5,5,4,14,Champions
48044,881,8,1256.67,1,2,3,6,Regulars
48045,136,11,1098.2,4,3,2,9,Loyal
48046,896,12,1557.4099999999999,1,4,3,8,At Risk
48047,123,11,1100.48,4,3,2,9,Loyal
48048,174,11,1167.11,3,3,2,8,Regulars
48049,14,10,2662.83,5,3,5,13,Loyal
48050,1145,7,1227.98,1,1,2,4,Hibernating
48051,96,10,1978.35,4,3,4,11,Loyal
48052,41,10,3066.19,5,3,5,13,Loyal
48053,101,7,2692.5299999999997,4,1,5,10,Big Spenders
48054,80,11,1394.3300000000002,4,3,3,10,Loyal
48055,21,10,2534.24,5,3,4,12,Loyal
48056,38,11,2679.33,5,3,5,13,Loyal
48057,301,9,722.5699999999999,2,2,1,5,Hibernating
48058,482,8,1135.67,1,2,2,5,Hibernating
48059,87,10,3226.3500000000004,4,3,5,12,Loyal
48060,21,8,625.06,5,2,1,8,Regulars
48061,14,9,2789.9500000000003,5,2,5,12,Big Spenders
48062,499,8,1208.26,1,2,2,5,Hibernating
48063,223,14,1866.35,3,5,4,12,Big Spenders
48064,513,14,1533.37,1,5,3,9,At Risk
48065,78,8,897.29,4,2,2,8,Regulars
48066,447,8,801.68,2,2,1,5,Hibernating
48067,68,12,2483.88,4,4,4,12,Champions
48068,216,11,926.62,3,3,2,8,Regulars
48069,100,11,1333.0,4,3,3,10,Loyal
48070,322,6,532.8199999999999,2,1,1,4,Hibernating
48071,1001,7,845.9699999999999,1,1,2,4,Hibernating
48072,114,5,337.65,4,1,1,6,Regulars
48073,198,10,860.36,3,3,2,8,Regulars
48074,309,10,3508.6399999999994,2,3,5,10,Regulars
48075,197,10,835.1600000000001,3,3,1,7,Regulars
48076,225,11,2878.09,3,3,5,11,Big Spenders
48077,45,17,1673.33,5,5,3,13,Loyal
48078,557,5,720.08,1,1,1,3,Hibernating
48079,62,12,2860.81,5,4,5,14,Champions
48080,148,5,326.9,3,1,1,5,Regulars
48081,482,11,1214.1200000000001,1,3,2,6,Regulars
48082,558,11,2234.81,1,3,4,8,Regulars
48083,589,4,634.74,1,1,1,3,Hibernating
48084,172,13,1999.55,3,4,4,11,Big Spenders
48085,115,10,2348.44,4,3,4,11,Loyal
48086,296,8,450.57,2,2,1,5,Hibernating
48087,307,12,1019.95,2,4,2,8,At Risk
48088,70,11,1285.77,4,3,3,10,Loyal
48089,98,11,1667.09,4,3,3,10,Loyal
48090,57,17,4033.82,5,5,5,15,Champions
48091,50,10,3421.6500000000005,5,3,5,13,Loyal
48092,253,9,785.14,2,2,1,5,Hibernating
48093,362,3,207.76,2,1,1,4,Hibernating
48094,217,7,1092.11,3,1,2,6,Regulars
48095,351,9,1248.25,2,2,3,7,Regulars
48096,135,9,2569.21,4,2,4,10,Big Spenders
48097,369,10,968.86,2,3,2,7,Regulars
48098,43,8,1779.41,5,2,4,11,Big Spenders
48099,33,15,1182.13,5,5,2,12,Loyal
48100,369,8,827.13,2,2,1,5,Hibernating
48101,234,15,3676.4000000000005,3,5,5,13,Big Spenders
48102,22,8,725.03,5,2,1,8,Regulars
48103,12,12,1019.0799999999999,5,4,2,11,Loyal
48104,28,17,4678.34,5,5,5,15,Champions
48105,156,14,1617.22,3,5,3,11,Regulars
48106,889,7,1121.6499999999999,1,1,2,4,Hibernating
48107,101,10,1329.88,4,3,3,10,Loyal
48108,38,15,4182.99,5,5,5,15,Champions
48109,238,11,1116.71,3,3,2,8,Regulars
48110,31,10,1841.32,5,3,4,12,Loyal
48111,171,13,1390.28,3,4,3,10,Regulars
48112,461,13,2128.42,1,4,4,9,At Risk
48113,1308,5,1857.9199999999998,1,1,4,6,Regulars
48114,55,12,1705.8,5,4,3,12,Loyal
48115,188,8,1798.21,3,2,4,9,Big Spenders
48116,187,13,1767.8,3,4,4,11,Big Spenders
48117,139,10,1353.52,4,3,3,10,Loyal
48118,132,10,751.12,4,3,1,8,Loyal
48119,37,12,973.09,5,4,2,11,Loyal
48120,14,13,1331.89,5,4,3,12,Loyal
48121,54,10,1261.59,5,3,3,11,Loyal
48122,378,9,777.7,2,2,1,5,Hibernating
48123,497,10,644.74,1,3,1,5,Regulars
48124,403,15,2595.18,2,5,5,12,At Risk
48125,77,11,2150.13,4,3,4,11,Loyal
48126,10,11,1632.92,5,3,3,11,Loyal
48127,469,12,2114.28,1,4,4,9,At Risk
48128,524,13,1317.03,1,4,3,8,At Risk
48129,242,4,671.25,3,1,1,5,Regulars
48130,13,9,3042.54,5,2,5,12,Big Spenders
48131,65,9,779.52,5,2,1,8,Regulars
48132,272,10,1200.51,2,3,2,7,Regulars
48133,499,10,2442.6699999999996,1,3,4,8,Regulars
48134,350,8,2321.18,2,2,4,8,Regulars
48135,585,9,1281.01,1,2,3,6,Regulars
48136,31,11,585.74,5,3,1,9,Loyal
48137,261,17,2304.56,2,5,4,11,At Risk
48138,113,14,1951.9,4,5,4,13,Champions
48139,313,7,1187.9399999999998,2,1,2,5,Hibernating
48140,116,10,643.51,4,3,1,8,Loyal
48141,75,7,351.0,4,1,1,6,Regulars
48142,14,11,1806.52,5,3,4,12,Loyal
48143,605,13,1646.57,1,4,3,8,At Risk
48144,388,6,525.61,2,1,1,4,Hibernating
48145,92,10,1166.61,4,3,2,9,Loyal
48146,44,12,1740.27,5,4,4,13,Champions
48147,90,13,3559.72,4,4,5,13,Champions
48148,83,6,482.99,4,1,1,6,Regulars
48149,227,12,2988.0,3,4,5,12,Big Spenders
48150,316,9,2850.29,2,2,5,9,Regulars
48151,104,13,1814.98,4,4,4,12,Champions
48152,1155,6,1120.8600000000001,1,1,2,4,Hibernating
48153,233,7,1844.2900000000002,3,1,4,8,Big Spenders
48154,245,13,1750.71,3,4,4,11,Big Spenders
48155,223,12,1222.32,3,4,2,9,Regulars
48156,86,5,906.1500000000001,4,1,2,7,Regulars
48157,185,6,3859.1499999999996,3,1,5,9,Big Spenders
48158,14,11,1588.16,5,3,3,11,Loyal
48159,118,14,1774.4299999999998,4,5,4,13,Champions
48160,156,12,3558.55,3,4,5,12,Big Spenders
48161,64,7,554.98,5,1,1,7,Regulars
48162,900,8,2216.81,1,2,4,7,Regulars
48163,43,15,1866.32,5,5,4,14,Champions
48164,259,15,2084.45,2,5,4,11,At Risk
48165,456,8,642.71,2,2,1,5,Hibernating
48166,100,8,1134.17,4,2,2,8,Regulars
48167,47,11,1360.35,5,3,3,11,Loyal
48168,230,9,3359.58,3,2,5,10,Big Spenders
48169,413,8,1155.24,2,2,2,6,Hibernating
48170,652,4,629.21,1,1,1,3,Hibernating
48171,211,10,2909.75,3,3,5,11,Big Spenders
48172,336,10,1952.5200000000002,2,3,4,9,Regulars
48173,41,10,3812.4500000000003,5,3,5,13,Loyal
48174,141,5,423.39,4,1,1,6,Regulars
48175,16,7,1468.36,5,1,3,9,Regulars
48176,144,11,1862.01,4,3,4,11,Loyal
48177,552,9,1449.85,1,2,3,6,Regulars
48178,531,7,822.99,1,1,1,3,Hibernating
48179,729,10,1797.17,1,3,4,8,Regulars
48180,1073,5,399.06,1,1,1,3,Hibernating
48181,38,12,2539.69,5,4,4,13,Champions
48182,523,12,1058.94,1,4,2,7,At Risk
48183,373,10,713.66,2,3,1,6,Regulars
48184,125,7,1986.43,4,1,4,9,Big Spenders
48185,701,2,244.06999999999996,1,1,1,3,Hibernating
48186,84,12,1082.42,4,4,2,10,Loyal
48187,3,9,565.25,5,2,1,8,Regulars
48188,41,6,355.46999999999997,5,1,1,7,Regulars
48189,132,12,2985.8900000000003,4,4,5,13,Champions
48190,119,19,2720.19,4,5,5,14,Champions
48191,172,12,2764.15,3,4,5,12,Big Spenders
48192,261,13,2844.1,2,4,5,11,At Risk
48193,192,16,3099.59,3,5,5,13,Big Spenders
48194,31,18,2239.36,5,5,4,14,Champions
48195,446,10,2800.15,2,3,5,10,Regulars
48196,224,11,2828.58,3,3,5,11,Big Spenders
48197,1235,3,327.23,1,1,1,3,Hibernating
48198,63,9,953.38,5,2,2,9,Regulars
48199,184,9,670.17,3,2,1,6,Regulars
48200,34,13,1350.06,5,4,3,12,Loyal
48201,93,13,2171.84,4,4,4,12,Champions
48202,67,12,1954.45,4,4,4,12,Champions
48203,726,13,2415.45,1,4,4,9,At Risk
48204,41,14,4261.04,5,5,5,15,Champions
48205,1200,5,370.61,1,1,1,3,Hibernating
48206,82,10,1019.42,4,3,2,9,Loyal
48207,82,5,625.02,4,1,1,6,Regulars
48208,65,9,794.17,5,2,1,8,Regulars
48209,243,13,3025.33,3,4,5,12,Big Spenders
48210,8,12,2236.32,5,4,4,13,Champions
48211,129,15,7198.9800000000005,4,5,5,14,Champions
48212,63,11,2796.42,5,3,5,13,Loyal
48213,802,11,1193.77,1,3,2,6,Regulars
48214,149,12,2405.54,3,4,4,11,Big Spenders
48215,134,9,782.0,4,2,1,7,Regulars
48216,65,3,142.55,5,1,1,7,Regulars
48217,398,5,640.94,2,1,1,4,Hibernating
48218,243,10,2326.75,3,3,4,10,Big Spenders
48219,91,13,947.75,4,4,2,10,Loyal
48220,91,13,2532.33,4,4,4,12,Champions
48221,460,12,845.0,1,4,2,7,At Risk
48222,343,11,1293.3000000000002,2,3,3,8,Regulars
48223,36,14,3346.82,5,5,5,15,Champions
48224,27,16,1380.1399999999999,5,5,3,13,Loyal
48225,44,8,1676.83,5,2,3,10,Regulars
48226,489,16,3345.6299999999997,1,5,5,11,At Risk
48227,128,10,1859.1100000000001,4,3,4,11,Loyal
48228,167,7,1030.9,3,1,2,6,Regulars
48229,760,9,1212.0,1,2,2,5,Hibernating
48230,153,11,991.73,3,3,2,8,Regulars
48231,71,11,2711.37,4,3,5,12,Loyal
48232,234,11,1893.67,3,3,4,10,Big Spenders
48233,725,14,4193.200000000001,1,5,5,11,At Risk
48234,185,8,746.51,3,2,1,6,Regulars
48235,260,10,960.3800000000001,2,3,2,7,Regulars
48236,88,11,1670.28,4,3,3,10,Loyal
48237,7,11,1519.95,5,3,3,11,Loyal
48238,122,11,1508.42,4,3,3,10,Loyal
48239,217,5,360.53,3,1,1,5,Regulars
48240,210,14,1181.97,3,5,2,10,Regulars
48241,31,10,1870.6200000000001,5,3,4,12,Loyal
48242,713,9,2090.11,1,2,4,7,Regulars
48243,4,15,1993.4799999999998,5,5,4,14,Champions
48244,883,8,5576.97,1,2,5,8,Regulars
48245,89,11,827.1999999999999,4,3,1,8,Loyal
48246,555,12,3409.02,1,4,5,10,At Risk
48247,261,14,3768.66,2,5,5,12,At Risk
48248,23,5,879.2500000000001,5,1,2,8,Regulars
48249,526,7,328.51,1,1,1,3,Hibernating
48250,20,8,576.25,5,2,1,8,Regulars
48251,119,13,2965.81,4,4,5,13,Champions
48252,65,15,2749.67,5,5,5,15,Champions
48253,440,12,1416.87,2,4,3,9,At Risk
48254,195,13,1310.4,3,4,3,10,Regulars
48255,159,11,861.85,3,3,2,8,Regulars
48256,533,7,850.45,1,1,2,4,Hibernating
48257,318,11,1251.83,2,3,3,8,Regulars
48258,124,14,1827.56,4,5,4,13,Champions
48259,466,10,1968.34,1,3,4,8,Regulars
48260,296,14,1293.98,2,5,3,10,At Risk
48261,43,11,1877.1399999999999,5,3,4,12,Loyal
48262,260,15,1620.39,2,5,3,10,At Risk
48263,239,11,1612.4299999999998,3,3,3,9,Regulars
48264,318,10,1521.7,2,3,3,8,Regulars
48265,61,10,3567.69,5,3,5,13,Loyal
48266,756,6,2369.1,1,1,4,6,Regulars
48267,223,11,2743.9100000000003,3,3,5,11,Big Spenders
48268,222,15,1158.8899999999999,3,5,2,10,Regulars
48269,26,10,1209.29,5,3,2,10,Loyal
48270,270,11,1275.7,2,3,3,8,Regulars
48271,130,10,580.38,4,3,1,8,Loyal
48272,727,8,636.81,1,2,1,4,Hibernating
48273,91,16,4496.33,4,5,5,14,Champions
48274,699,13,3355.28,1,4,5,10,At Risk
48275,601,8,434.25999999999993,1,2,1,4,Hibernating
48276,3,10,1317.04,5,3,3,11,Loyal
48277,147,7,1018.1,4,1,2,7,Regulars
48278,389,9,982.8799999999999,2,2,2,6,Hibernating
48279,273,8,2387.25,2,2,4,8,Regulars
48280,475,14,911.25,1,5,2,8,At Risk
48281,173,6,746.87,3,1,1,5,Regulars
48282,56,13,1907.27,5,4,4,13,Champions
48283,60,4,537.13,5,1,1,7,Regulars
48284,331,10,903.62,2,3,2,7,Regulars
48285,670,10,1480.8899999999999,1,3,3,7,Regulars
48286,365,7,859.96,2,1,2,5,Hibernating
48287,775,10,980.8,1,3,2,6,Regulars
48288,68,17,2857.26,4,5,5,14,Champions
48289,412,13,4335.55,2,4,5,11,At Risk
48290,2,16,2692.2000000000003,5,5,5,15,Champions
48291,397,10,839.52,2,3,1,6,Regulars
48292,481,10,1852.63,1,3,4,8,Regulars
48293,54,12,5885.35,5,4,5,14,Champions
48294,111,19,1633.0,4,5,3,12,Loyal
48295,118,9,718.01,4,2,1,7,Regulars
48296,85,11,955.05,4,3,2,9,Loyal
48297,316,15,1388.48,2,5,3,10,At Risk
48298,589,12,1585.01,1,4,3,8,At Risk
48299,44,13,664.8,5,4,1,10,Loyal
48300,851,4,316.34000000000003,1,1,1,3,Hibernating
48301,194,8,581.83,3,2,1,6,Regulars
48302,152,9,490.06,3,2,1,6,Regulars
48303,176,17,1930.39,3,5,4,12,Big Spenders
48304,6,11,1950.8799999999999,5,3,4,12,Loyal
48305,271,13,3372.73,2,4,5,11,At Risk
48306,963,9,1330.17,1,2,3,6,Regulars
48307,67,6,1111.8500000000001,4,1,2,7,Regulars
48308,420,6,1055.34,2,1,2,5,Hibernating
48309,315,20,3021.72,2,5,5,12,At Risk
48310,52,7,1273.9299999999998,5,1,3,9,Regulars
48311,295,14,5921.18,2,5,5,12,At Risk
48312,598,10,1891.75,1,3,4,8,Regulars
48313,889,9,1117.54,1,2,2,5,Hibernating
48314,12,12,1985.77,5,4,4,13,Champions
48315,122,12,2988.08,4,4,5,13,Champions
48316,579,8,2012.3200000000002,1,2,4,7,Regulars
48317,67,11,1188.45,4,3,2,9,Loyal
48318,127,11,759.54,4,3,1,8,Loyal
48319,136,5,614.82,4,1,1,6,Regulars
48320,70,16,1883.0900000000001,4,5,4,13,Champions
48321,261,8,651.22,2,2,1,5,Hibernating
48322,42,10,763.7600000000001,5,3,1,9,Loyal
48323,126,7,409.82,4,1,1,6,Regulars
48324,255,8,516.8,2,2,1,5,Hibernating
48325,64,16,2105.25,5,5,4,14,Champions
48326,69,9,2512.71,4,2,4,10,Big Spenders
48327,136,10,856.63,4,3,2,9,Loyal
48328,292,10,1276.67,2,3,3,8,Regulars
48329,24,16,3019.44,5,5,5,15,Champions
48330,389,10,4999.2,2,3,5,10,Regulars
48331,48,12,2478.7200000000003,5,4,4,13,Champions
48332,229,10,1517.52,3,3,3,9,Regulars
48333,86,15,2223.6400000000003,4,5,4,13,Champions
48334,133,14,1445.2,4,5,3,12,Loyal
48335,157,8,1751.78,3,2,4,9,Big Spenders
48336,234,12,1670.68,3,4,3,10,Regulars
48337,1065,15,1397.4099999999999,1,5,3,9,At Risk
48338,426,12,1059.1,2,4,2,8,At Risk
48339,173,11,1244.6000000000001,3,3,3,9,Regulars
48340,143,9,1013.25,4,2,2,8,Regulars
48341,461,10,1263.48,1,3,3,7,Regulars
48342,517,5,1930.74,1,1,4,6,Regulars
48343,501,6,314.94,1,1,1,3,Hibernating
48344,127,13,1526.43,4,4,3,11,Loyal
48345,437,15,2203.33,2,5,4,11,At Risk
48346,523,9,400.13,1,2,1,4,Hibernating
48347,197,9,2165.79,3,2,4,9,Big Spenders
48348,60,10,1676.71,5,3,3,11,Loyal
48349,56,14,1293.05,5,5,3,13,Loyal
48350,161,9,2831.7,3,2,5,10,Big Spenders
48351,33,14,1215.19,5,5,2,12,Loyal
48352,757,7,458.68,1,1,1,3,Hibernating
48353,57,13,2676.87,5,4,5,14,Champions
48354,599,9,1288.9099999999999,1,2,3,6,Regulars
48355,65,10,827.26,5,3,1,9,Loyal
48356,125,11,1785.44,4,3,4,11,Loyal
48357,270,13,1391.23,2,4,3,9,At Risk
48358,697,9,703.3299999999999,1,2,1,4,Hibernating
48359,127,11,3221.67,4,3,5,12,Loyal
48360,283,17,2273.85,2,5,4,11,At Risk
48361,953,7,706.1,1,1,1,3,Hibernating
48362,219,9,1270.88,3,2,3,8,Regulars
48363,976,8,1083.17,1,2,2,5,Hibernating
48364,56,12,1558.53,5,4,3,12,Loyal
48365,375,7,1023.3000000000001,2,1,2,5,Hibernating
48366,218,11,1843.15,3,3,4,10,Big Spenders
48367,45,10,2391.4500000000003,5,3,4,12,Loyal
48368,211,8,935.5899999999999,3,2,2,7,Regulars
48369,438,12,3464.1899999999996,2,4,5,11,At Risk
48370,1135,8,1081.72,1,2,2,5,Hibernating
48371,562,5,169.9,1,1,1,3,Hibernating
48372,133,10,956.89,4,3,2,9,Loyal
48373,28,12,1181.41,5,4,2,11,Loyal
48374,34,6,4751.63,5,1,5,11,Big Spenders
48375,5,15,2727.31,5,5,5,15,Champions
48376,96,9,534.26,4,2,1,7,Regulars
48377,42,10,966.83,5,3,2,10,Loyal
48378,121,16,1417.49,4,5,3,12,Loyal
48379,104,15,1394.86,4,5,3,12,Loyal
48380,1404,3,507.70000000000005,1,1,1,3,Hibernating
48381,395,12,5475.46,2,4,5,11,At Risk
48382,231,10,848.1500000000001,3,3,2,8,Regulars
48383,196,12,1050.52,3,4,2,9,Regulars
48384,232,9,3547.9499999999994,3,2,5,10,Big Spenders
48385,125,11,1319.57,4,3,3,10,Loyal
48386,88,8,2883.84,4,2,5,11,Big Spenders
48387,540,12,958.4899999999999,1,4,2,7,At Risk
48388,253,10,1436.25,2,3,3,8,Regulars
48389,514,13,3384.0299999999997,1,4,5,10,At Risk
48390,142,12,1318.34,4,4,3,11,Loyal
48391,161,10,1296.99,3,3,3,9,Regulars
48392,521,6,439.73,1,1,1,3,Hibernating
48393,120,10,2073.25,4,3,4,11,Loyal
48394,1490,5,1548.0600000000002,1,1,3,5,Regulars
48395,162,17,1123.73,3,5,2,10,Regulars
48396,130,9,976.27,4,2,2,8,Regulars
48397,280,10,2712.52,2,3,5,10,Regulars
48398,45,9,1722.1799999999998,5,2,3,10,Regulars
48399,27,8,884.5300000000001,5,2,2,9,Regulars
48400,231,14,1256.79,3,5,3,11,Regulars
48401,141,12,813.26,4,4,1,9,Loyal
48402,350,14,3689.53,2,5,5,12,At Risk
48403,721,6,2647.1699999999996,1,1,5,7,Regulars
48404,85,15,4482.58,4,5,5,14,Champions
48405,19,10,2549.49,5,3,4,12,Loyal
48406,1324,9,1237.99,1,2,2,5,Hibernating
48407,232,14,2074.72,3,5,4,12,Big Spenders
48408,653,16,3438.92,1,5,5,11,At Risk
48409,189,14,1051.54,3,5,2,10,Regulars
48410,134,8,558.98,4,2,1,7,Regulars
48411,238,8,660.04,3,2,1,6,Regulars
48412,139,13,1152.54,4,4,2,10,Loyal
48413,139,9,1266.75,4,2,3,9,Regulars
48414,79,11,1204.57,4,3,2,9,Loyal
48415,672,9,1185.68,1,2,2,5,Hibernating
48416,124,10,3260.4300000000003,4,3,5,12,Loyal
48417,1161,11,1901.7600000000002,1,3,4,8,Regulars
48418,861,13,2376.91,1,4,4,9,At Risk
48419,919,7,2299.19,1,1,4,6,Regulars
48420,188,15,2936.79,3,5,5,13,Big Spenders
48421,840,6,565.84,1,1,1,3,Hibernating
48422,12,12,2485.96,5,4,4,13,Champions
48423,398,12,1820.41,2,4,4,10,At Risk
48424,298,10,1880.6800000000003,2,3,4,9,Regulars
48425,261,6,838.2,2,1,1,4,Hibernating
48426,156,10,814.3100000000001,3,3,1,7,Regulars
48427,190,21,4931.56,3,5,5,13,Big Spenders
48428,318,11,1974.4699999999998,2,3,4,9,Regulars
48429,762,11,1411.2,1,3,3,7,Regulars
48430,632,7,3437.2899999999995,1,1,5,7,Regulars
48431,166,9,1020.31,3,2,2,7,Regulars
48432,1071,6,484.93,1,1,1,3,Hibernating
48433,60,11,2672.29,5,3,5,13,Loyal
48434,185,7,968.48,3,1,2,6,Regulars
48435,892,8,3119.81,1,2,5,8,Regulars
48436,484,12,4166.56,1,4,5,10,At Risk
48437,90,7,2266.3599999999997,4,1,4,9,Big Spenders
48438,162,8,3533.86,3,2,5,10,Big Spenders
48439,1163,7,1680.8899999999999,1,1,3,5,Regulars
48440,131,5,2548.19,4,1,4,9,Big Spenders
48441,101,6,2326.37,4,1,4,9,Big Spenders
48442,174,14,1728.95,3,5,4,12,Big Spenders
48443,24,12,881.85,5,4,2,11,Loyal
48444,208,8,1508.57,3,2,3,8,Regulars
48445,157,12,1999.25,3,4,4,11,Big Spenders
48446,6,10,1205.5,5,3,2,10,Loyal
48447,84,16,5674.49,4,5,5,14,Champions
48448,402,12,1811.1000000000001,2,4,4,10,At Risk
48449,396,7,2382.14,2,1,4,7,Regulars
48450,745,4,196.62,1,1,1,3,Hibernating
48451,57,13,4048.8199999999997,5,4,5,14,Champions
48452,287,10,2645.1600000000003,2,3,5,10,Regulars
48453,34,10,1625.75,5,3,3,11,Loyal
48454,278,6,2531.91,2,1,4,7,Regulars
48455,966,8,836.47,1,2,1,4,Hibernating
48456,177,12,1188.69,3,4,2,9,Regulars
48457,1303,5,221.54999999999998,1,1,1,3,Hibernating
48458,142,15,3373.97,4,5,5,14,Champions
48459,28,17,3037.4,5,5,5,15,Champions
48460,77,11,1434.67,4,3,3,10,Loyal
48461,339,11,2114.69,2,3,4,9,Regulars
48462,39,10,3675.5499999999997,5,3,5,13,Loyal
48463,5,10,808.95,5,3,1,9,Loyal
48464,111,10,996.64,4,3,2,9,Loyal
48465,16,15,1666.56,5,5,3,13,Loyal
48466,94,13,1245.59,4,4,3,11,Loyal
48467,216,9,1107.37,3,2,2,7,Regulars
48468,72,10,1108.6100000000001,4,3,2,9,Loyal
48469,99,20,3058.0099999999998,4,5,5,14,Champions
48470,961,5,422.84000000000003,1,1,1,3,Hibernating
48471,548,9,1293.07,1,2,3,6,Regulars
48472,109,14,3024.34,4,5,5,14,Champions
48473,266,7,869.12,2,1,2,5,Hibernating
48474,67,11,927.47,4,3,2,9,Loyal
48475,116,10,1034.11,4,3,2,9,Loyal
48476,141,14,971.15,4,5,2,11,Loyal
48477,81,9,1756.8200000000002,4,2,4,10,Big Spenders
48478,482,7,1726.15,1,1,4,6,Regulars
48479,213,8,1343.17,3,2,3,8,Regulars
48480,583,9,1350.8,1,2,3,6,Regulars
48481,195,8,617.6,3,2,1,6,Regulars
48482,497,7,896.37,1,1,2,4,Hibernating
48483,9,8,489.09,5,2,1,8,Regulars
48484,97,9,2222.72,4,2,4,10,Big Spenders
48485,1419,8,2055.8199999999997,1,2,4,7,Regulars
48486,3,10,3490.99,5,3,5,13,Loyal
48487,568,9,1573.51,1,2,3,6,Regulars
48488,526,6,1177.94,1,1,2,4,Hibernating
48489,906,10,1733.5,1,3,4,8,Regulars
48490,136,12,837.5600000000001,4,4,1,9,Loyal
48491,27,8,636.93,5,2,1,8,Regulars
48492,646,11,1722.87,1,3,3,7,Regulars
48493,410,7,508.69,2,1,1,4,Hibernating
48494,638,10,979.73,1,3,2,6,Regulars
48495,176,9,1564.89,3,2,3,8,Regulars
48496,664,4,702.08,1,1,1,3,Hibernating
48497,102,12,1237.9299999999998,4,4,2,10,Loyal
48498,121,11,990.12,4,3,2,9,Loyal
48499,322,13,1768.54,2,4,4,10,At Risk
48500,192,14,1044.73,3,5,2,10,Regulars
48501,692,10,1139.15,1,3,2,6,Regulars
48502,482,11,945.54,1,3,2,6,Regulars
48503,90,6,625.96,4,1,1,6,Regulars
48504,29,12,3096.2,5,4,5,14,Champions
48505,757,7,669.1700000000001,1,1,1,3,Hibernating
48506,261,12,831.54,2,4,1,7,At Risk
48507,123,10,1067.67,4,3,2,9,Loyal
48508,47,16,3296.6499999999996,5,5,5,15,Champions
48509,52,10,1167.68,5,3,2,10,Loyal
48510,162,11,4647.639999999999,3,3,5,11,Big Spenders
48511,138,8,542.86,4,2,1,7,Regulars
48512,91,8,468.84000000000003,4,2,1,7,Regulars
48513,185,10,1235.66,3,3,2,8,Regulars
48514,103,5,1355.92,4,1,3,8,Regulars
48515,101,9,850.34,4,2,2,8,Regulars
48516,1435,5,412.15999999999997,1,1,1,3,Hibernating
48517,123,8,3046.8199999999997,4,2,5,11,Big Spenders
48518,253,8,697.2,2,2,1,5,Hibernating
48519,39,13,2911.22,5,4,5,14,Champions
48520,295,12,2921.64,2,4,5,11,At Risk
48521,113,16,4488.65,4,5,5,14,Champions
48522,33,10,851.05,5,3,2,10,Loyal
48523,935,4,292.0,1,1,1,3,Hibernating
48524,311,12,1124.19,2,4,2,8,At Risk
48525,162,9,4131.06,3,2,5,10,Big Spenders
48526,42,16,1853.8600000000001,5,5,4,14,Champions
48527,142,14,3876.78,4,5,5,14,Champions
48528,37,15,2338.75,5,5,4,14,Champions
48529,479,8,1068.18,1,2,2,5,Hibernating
48530,11,15,4213.71,5,5,5,15,Champions
48531,118,10,1255.47,4,3,3,10,Loyal
48532,7,12,2558.45,5,4,4,13,Champions
48533,704,6,615.45,1,1,1,3,Hibernating
48534,22,16,2096.52,5,5,4,14,Champions
48535,662,6,731.86,1,1,1,3,Hibernating
48536,244,11,1764.3899999999999,3,3,4,10,Big Spenders
48537,56,11,877.41,5,3,2,10,Loyal
48538,266,10,4553.03,2,3,5,10,Regulars
48539,742,9,1296.46,1,2,3,6,Regulars
48540,464,8,1474.08,1,2,3,6,Regulars
48541,392,9,1895.87,2,2,4,8,Regulars
48542,161,10,3149.8,3,3,5,11,Big Spenders
48543,190,19,2923.83,3,5,5,13,Big Spenders
48544,228,15,3639.2000000000003,3,5,5,13,Big Spenders
48545,75,9,822.82,4,2,1,7,Regulars
48546,643,9,1288.3400000000001,1,2,3,6,Regulars
48547,387,11,1276.51,2,3,3,8,Regulars
48548,247,11,1350.03,3,3,3,9,Regulars
48549,48,9,1296.02,5,2,3,10,Regulars
48550,145,6,1589.23,4,1,3,8,Regulars
48551,5,5,1168.5700000000002,5,1,2,8,Regulars
48552,526,11,1198.52,1,3,2,6,Regulars
48553,415,4,1137.64,2,1,2,5,Hibernating
48554,52,8,1290.56,5,2,3,10,Regulars
48555,113,12,1754.62,4,4,4,12,Champions
48556,201,10,1018.0,3,3,2,8,Regulars
48557,190,7,748.65,3,1,1,5,Regulars
48558,104,12,828.0500000000001,4,4,1,9,Loyal
48559,316,16,6236.96,2,5,5,12,At Risk
48560,302,12,1716.3899999999999,2,4,3,9,At Risk
48561,29,9,854.47,5,2,2,9,Regulars
48562,257,12,1009.64,2,4,2,8,At Risk
48563,411,12,2076.77,2,4,4,10,At Risk
48564,85,11,811.06,4,3,1,8,Loyal
48565,85,9,1564.84,4,2,3,9,Regulars
48566,129,8,1456.7,4,2,3,9,Regulars
48567,59,17,1509.84,5,5,3,13,Loyal
48568,456,10,1910.8400000000001,2,3,4,9,Regulars
48569,231,17,2221.08,3,5,4,12,Big Spenders
48570,241,9,1233.79,3,2,2,7,Regulars
48571,13,8,1213.94,5,2,2,9,Regulars
48572,192,13,1208.58,3,4,2,9,Regulars
48573,283,10,2381.57,2,3,4,9,Regulars
48574,172,14,2566.71,3,5,4,12,Big Spenders
48575,591,9,955.76,1,2,2,5,Hibernating
48576,122,11,1412.96,4,3,3,10,Loyal
48577,28,12,1779.49,5,4,4,13,Champions
48578,120,11,1245.9,4,3,3,10,Loyal
48579,26,15,2370.3999999999996,5,5,4,14,Champions
48580,30,7,1762.1,5,1,4,10,Big Spenders
48581,535,7,727.9499999999999,1,1,1,3,Hibernating
48582,211,11,1423.18,3,3,3,9,Regulars
48583,212,9,640.66,3,2,1,6,Regulars
48584,198,8,464.28000000000003,3,2,1,6,Regulars
48585,230,5,398.07,3,1,1,5,Regulars
48586,27,14,2832.68,5,5,5,15,Champions
48587,348,9,1499.1999999999998,2,2,3,7,Regulars
48588,73,12,2241.11,4,4,4,12,Champions
48589,291,13,3275.45,2,4,5,11,At Risk
48590,28,11,2797.45,5,3,5,13,Loyal
48591,254,10,1025.61,2,3,2,7,Regulars
48592,234,17,3200.29,3,5,5,13,Big Spenders
48593,323,6,348.95,2,1,1,4,Hibernating
48594,39,8,502.91999999999996,5,2,1,8,Regulars
48595,99,8,471.61,4,2,1,7,Regulars
48596,131,18,4100.06,4,5,5,14,Champions
48597,229,11,932.48,3,3,2,8,Regulars
48598,338,11,1636.37,2,3,3,8,Regulars
48599,143,9,655.54,4,2,1,7,Regulars
48600,211,10,2629.5,3,3,5,11,Big Spenders
48601,5,16,3331.33,5,5,5,15,Champions
48602,142,14,2719.03,4,5,5,14,Champions
48603,50,12,2969.01,5,4,5,14,Champions
48604,718,10,4906.75,1,3,5,9,Regulars
48605,57,5,363.35,5,1,1,7,Regulars
48606,360,13,1553.78,2,4,3,9,At Risk
48607,326,5,1012.3399999999999,2,1,2,5,Hibernating
48608,259,9,2170.12,2,2,4,8,Regulars
48609,307,12,1888.5700000000002,2,4,4,10,At Risk
48610,170,14,1666.09,3,5,3,11,Regulars
48611,47,10,1448.88,5,3,3,11,Loyal
48612,399,15,2539.22,2,5,4,11,At Risk
48613,55,10,541.62,5,3,1,9,Loyal
48614,237,13,864.76,3,4,2,9,Regulars
48615,1062,7,1006.95,1,1,2,4,Hibernating
48616,327,12,3561.99,2,4,5,11,At Risk
48617,278,8,1448.32,2,2,3,7,Regulars
48618,19,10,3978.5299999999997,5,3,5,13,Loyal
48619,149,11,794.39,3,3,1,7,Regulars
48620,307,12,4300.18,2,4,5,11,At Risk
48621,84,7,835.3299999999999,4,1,1,6,Regulars
48622,669,8,623.81,1,2,1,4,Hibernating
48623,1322,6,460.34000000000003,1,1,1,3,Hibernating
48624,73,12,2865.06,4,4,5,13,Champions
48625,28,13,1443.93,5,4,3,12,Loyal
48626,536,12,902.09,1,4,2,7,At Risk
48627,438,9,923.4,2,2,2,6,Hibernating
48628,552,10,813.38,1,3,1,5,Regulars
48629,214,8,1532.84,3,2,3,8,Regulars
48630,777,7,882.47,1,1,2,4,Hibernating
48631,54,8,1036.13,5,2,2,9,Regulars
48632,124,7,3150.7599999999998,4,1,5,10,Big Spenders
48633,258,12,1284.42,2,4,3,9,At Risk
48634,254,12,2203.74,2,4,4,10,At Risk
48635,218,11,3148.21,3,3,5,11,Big Spenders
48636,508,12,3612.9900000000002,1,4,5,10,At Risk
48637,473,6,442.13,1,1,1,3,Hibernating
48638,138,15,2834.44,4,5,5,14,Champions
48639,586,7,668.27,1,1,1,3,Hibernating
48640,29,10,1399.83,5,3,3,11,Loyal
48641,27,9,2767.75,5,2,5,12,Big Spenders
48642,350,7,775.97,2,1,1,4,Hibernating
48643,585,6,693.55,1,1,1,3,Hibernating
48644,283,12,3933.86,2,4,5,11,At Risk
48645,122,8,1639.1299999999999,4,2,3,9,Regulars
48646,283,8,1351.3899999999999,2,2,3,7,Regulars
48647,284,9,1386.34,2,2,3,7,Regulars
48648,5,12,2531.12,5,4,4,13,Champions
48649,40,8,2160.27,5,2,4,11,Big Spenders
48650,1,12,5380.7300000000005,5,4,5,14,Champions
48651,2,11,1681.47,5,3,3,11,Loyal
48652,379,14,1669.9099999999999,2,5,3,10,At Risk
48653,225,8,1245.3500000000001,3,2,3,8,Regulars
48654,208,9,1164.13,3,2,2,7,Regulars
48655,169,6,608.52,3,1,1,5,Regulars
48656,680,10,1626.0,1,3,3,7,Regulars
48657,183,12,2970.95,3,4,5,12,Big Spenders
48658,197,15,1257.22,3,5,3,11,Regulars
48659,222,8,710.8100000000001,3,2,1,6,Regulars
48660,331,9,855.4300000000001,2,2,2,6,Hibernating
48661,959,6,623.56,1,1,1,3,Hibernating
48662,108,12,1428.41,4,4,3,11,Loyal
48663,192,7,1343.63,3,1,3,7,Regulars
48664,174,10,726.47,3,3,1,7,Regulars
48665,39,9,902.0500000000001,5,2,2,9,Regulars
48666,29,9,903.0500000000001,5,2,2,9,Regulars
48667,212,7,570.73,3,1,1,5,Regulars
48668,182,6,619.89,3,1,1,5,Regulars
48669,43,11,1207.33,5,3,2,10,Loyal
48670,216,12,1997.2399999999998,3,4,4,11,Big Spenders
48671,664,4,507.81000000000006,1,1,1,3,Hibernating
48672,232,8,911.29,3,2,2,7,Regulars
48673,87,16,1916.0,4,5,4,13,Champions
48674,44,11,3985.76,5,3,5,13,Loyal
48675,52,11,2105.02,5,3,4,12,Loyal
48676,270,15,1941.5,2,5,4,11,At Risk
48677,4,14,2846.5699999999997,5,5,5,15,Champions
48678,293,4,601.58,2,1,1,4,Hibernating
48679,643,12,607.21,1,4,1,6,At Risk
48680,10,16,3677.48,5,5,5,15,Champions
48681,736,7,3894.99,1,1,5,7,Regulars
48682,154,12,3135.82,3,4,5,12,Big Spenders
48683,249,6,1572.56,2,1,3,6,Regulars
48684,557,10,1046.32,1,3,2,6,Regulars
48685,170,9,1400.3700000000001,3,2,3,8,Regulars
48686,416,10,568.1600000000001,2,3,1,6,Regulars
48687,349,12,1376.89,2,4,3,9,At Risk
48688,224,7,519.75,3,1,1,5,Regulars
48689,67,17,1933.52,4,5,4,13,Champions
48690,392,14,1258.54,2,5,3,10,At Risk
48691,55,11,1676.0900000000001,5,3,3,11,Loyal
48692,4,13,4379.24,5,4,5,14,Champions
48693,42,10,2518.7,5,3,4,12,Loyal
48694,477,8,3210.9799999999996,1,2,5,8,Regulars
48695,15,13,3102.9300000000003,5,4,5,14,Champions
48696,54,15,1555.13,5,5,3,13,Loyal
48697,172,12,809.14,3,4,1,8,Regulars
48698,78,13,2194.85,4,4,4,12,Champions
48699,144,11,1103.6,4,3,2,9,Loyal
48700,28,11,1631.04,5,3,3,11,Loyal
48701,2,16,2495.57,5,5,4,14,Champions
48702,119,13,1608.88,4,4,3,11,Loyal
48703,5,13,2033.05,5,4,4,13,Champions
48704,168,4,865.96,3,1,2,6,Regulars
48705,28,9,3279.26,5,2,5,12,Big Spenders
48706,583,6,579.93,1,1,1,3,Hibernating
48707,272,11,1285.03,2,3,3,8,Regulars
48708,66,13,1510.6999999999998,4,4,3,11,Loyal
48709,449,14,2785.0,2,5,5,12,At Risk
48710,89,18,4679.42,4,5,5,14,Champions
48711,265,13,3966.81,2,4,5,11,At Risk
48712,175,8,1012.69,3,2,2,7,Regulars
48713,798,9,532.11,1,2,1,4,Hibernating
48714,605,7,1423.3700000000001,1,1,3,5,Regulars
48715,61,16,2920.36,5,5,5,15,Champions
48716,502,7,1277.25,1,1,3,5,Regulars
48717,555,13,2192.33,1,4,4,9,At Risk
48718,209,6,739.32,3,1,1,5,Regulars
48719,6,8,1892.0,5,2,4,11,Big Spenders
48720,337,10,1238.27,2,3,2,7,Regulars
48721,5,8,1186.5900000000001,5,2,2,9,Regulars
48722,139,11,1194.25,4,3,2,9,Loyal
48723,246,10,1774.27,3,3,4,10,Big Spenders
48724,1837,1,45.769999999999996,1,1,1,3,Hibernating
48725,177,10,1174.41,3,3,2,8,Regulars
48726,117,6,829.45,4,1,1,6,Regulars
48727,172,9,1949.07,3,2,4,9,Big Spenders
48728,8,11,1433.3600000000001,5,3,3,11,Loyal
48729,318,9,1743.0000000000002,2,2,4,8,Regulars
48730,103,8,869.51,4,2,2,8,Regulars
48731,77,11,1159.1,4,3,2,9,Loyal
48732,376,7,1674.1799999999998,2,1,3,6,Regulars
48733,40,16,1373.96,5,5,3,13,Loyal
48734,438,9,3975.67,2,2,5,9,Regulars
48735,322,10,704.34,2,3,1,6,Regulars
48736,117,6,211.84,4,1,1,6,Regulars
48737,221,13,2564.18,3,4,4,11,Big Spenders
48738,519,18,5123.83,1,5,5,11,At Risk
48739,552,11,1158.21,1,3,2,6,Regulars
48740,767,8,758.69,1,2,1,4,Hibernating
48741,104,13,4576.740000000001,4,4,5,13,Champions
48742,11,14,1812.57,5,5,4,14,Champions
48743,239,12,1536.6499999999999,3,4,3,10,Regulars
48744,236,7,886.64,3,1,2,6,Regulars
48745,331,7,6268.04,2,1,5,8,Regulars
48746,534,13,1503.1100000000001,1,4,3,8,At Risk
48747,223,9,991.15,3,2,2,7,Regulars
48748,603,9,4444.57,1,2,5,8,Regulars
48749,494,10,987.12,1,3,2,6,Regulars
48750,298,17,3981.6800000000003,2,5,5,12,At Risk
48751,150,11,2990.85,3,3,5,11,Big Spenders
48752,464,10,3540.3600000000006,1,3,5,9,Regulars
48753,249,10,1102.19,2,3,2,7,Regulars
48754,245,15,4502.7300000000005,3,5,5,13,Big Spenders
48755,38,8,890.32,5,2,2,9,Regulars
48756,142,9,837.22,4,2,1,7,Regulars
48757,204,10,1100.95,3,3,2,8,Regulars
48758,268,4,651.57,2,1,1,4,Hibernating
48759,4,16,4158.860000000001,5,5,5,15,Champions
48760,341,9,4337.910000000001,2,2,5,9,Regulars
48761,124,9,1166.88,4,2,2,8,Regulars
48762,597,9,1178.4,1,2,2,5,Hibernating
48763,2,15,3479.21,5,5,5,15,Champions
48764,138,8,518.55,4,2,1,7,Regulars
48765,286,10,1982.1599999999999,2,3,4,9,Regulars
48766,618,9,3270.67,1,2,5,8,Regulars
48767,144,8,1018.14,4,2,2,8,Regulars
48768,158,14,1213.48,3,5,2,10,Regulars
48769,167,15,2298.8,3,5,4,12,Big Spenders
48770,241,9,965.0000000000001,3,2,2,7,Regulars
48771,161,10,1098.05,3,3,2,8,Regulars
48772,138,11,1474.46,4,3,3,10,Loyal
48773,167,15,1789.51,3,5,4,12,Big Spenders
48774,530,9,1368.0,1,2,3,6,Regulars
48775,217,8,778.49,3,2,1,6,Regulars
48776,239,17,1919.6200000000001,3,5,4,12,Big Spenders
48777,313,14,1988.75,2,5,4,11,At Risk
48778,79,15,1898.43,4,5,4,13,Champions
48779,5,11,1694.28,5,3,3,11,Loyal
48780,454,13,2917.35,2,4,5,11,At Risk
48781,74,12,1997.74,4,4,4,12,Champions
48782,104,10,1068.6,4,3,2,9,Loyal
48783,145,11,2114.64,4,3,4,11,Loyal
48784,142,10,2272.13,4,3,4,11,Loyal
48785,161,6,1723.16,3,1,3,7,Regulars
48786,490,7,1376.47,1,1,3,5,Regulars
48787,214,10,542.36,3,3,1,7,Regulars
48788,1347,4,1034.06,1,1,2,4,Hibernating
48789,25,14,2686.04,5,5,5,15,Champions
48790,1712,4,1697.13,1,1,3,5,Regulars
48791,193,6,1156.17,3,1,2,6,Regulars
48792,135,10,682.34,4,3,1,8,Loyal
48793,240,9,797.4100000000001,3,2,1,6,Regulars
48794,104,8,1529.76,4,2,3,9,Regulars
48795,1115,11,1564.18,1,3,3,7,Regulars
48796,614,6,2034.0900000000001,1,1,4,6,Regulars
48797,152,9,714.49,3,2,1,6,Regulars
48798,301,15,1570.87,2,5,3,10,At Risk
48799,134,12,2078.44,4,4,4,12,Champions
48800,61,16,1678.89,5,5,3,13,Loyal
48801,628,8,1342.2,1,2,3,6,Regulars
48802,170,13,2391.79,3,4,4,11,Big Spenders
48803,23,16,2206.03,5,5,4,14,Champions
48804,96,10,1056.12,4,3,2,9,Loyal
48805,54,12,2629.9100000000003,5,4,5,14,Champions
48806,293,9,981.6,2,2,2,6,Hibernating
48807,297,12,1625.8600000000001,2,4,3,9,At Risk
48808,31,18,5374.3099999999995,5,5,5,15,Champions
48809,642,7,535.24,1,1,1,3,Hibernating
48810,69,9,2051.95,4,2,4,10,Big Spenders
48811,1179,8,716.98,1,2,1,4,Hibernating
48812,362,16,3276.89,2,5,5,12,At Risk
48813,220,8,943.24,3,2,2,7,Regulars
48814,320,11,1177.06,2,3,2,7,Regulars
48815,38,11,1613.8899999999999,5,3,3,11,Loyal
48816,265,9,2141.98,2,2,4,8,Regulars
48817,124,9,2781.91,4,2,5,11,Big Spenders
48818,629,5,361.59,1,1,1,3,Hibernating
48819,391,15,1151.47,2,5,2,9,At Risk
48820,64,16,3228.9700000000003,5,5,5,15,Champions
48821,129,8,1047.36,4,2,2,8,Regulars
48822,550,7,1198.8999999999999,1,1,2,4,Hibernating
48823,144,7,428.29,4,1,1,6,Regulars
48824,195,14,2001.05,3,5,4,12,Big Spenders
48825,130,10,1030.59,4,3,2,9,Loyal
48826,300,13,1628.89,2,4,3,9,At Risk
48827,0,13,1606.03,5,4,3,12,Loyal
48828,40,14,2334.53,5,5,4,14,Champions
48829,36,11,1561.6499999999999,5,3,3,11,Loyal
48830,31,12,5482.52,5,4,5,14,Champions
48831,152,14,2102.2,3,5,4,12,Big Spenders
48832,33,9,1861.43,5,2,4,11,Big Spenders
48833,152,9,602.72,3,2,1,6,Regulars
48834,499,12,2418.27,1,4,4,9,At Risk
48835,192,9,1053.43,3,2,2,7,Regulars
48836,145,14,2616.55,4,5,5,14,Champions
48837,35,9,789.87,5,2,1,8,Regulars
48838,60,14,1279.16,5,5,3,13,Loyal
48839,40,16,4595.56,5,5,5,15,Champions
48840,41,13,2008.94,5,4,4,13,Champions
48841,99,8,992.84,4,2,2,8,Regulars
48842,297,8,1415.8700000000001,2,2,3,7,Regulars
48843,146,7,379.84000000000003,4,1,1,6,Regulars
48844,133,18,2615.22,4,5,5,14,Champions
48845,156,9,4444.280000000001,3,2,5,10,Big Spenders
48846,315,9,2724.6600000000003,2,2,5,9,Regulars
48847,551,11,2242.29,1,3,4,8,Regulars
48848,801,7,822.43,1,1,1,3,Hibernating
48849,567,16,4918.75,1,5,5,11,At Risk
48850,508,11,1502.0,1,3,3,7,Regulars
48851,247,8,3629.23,3,2,5,10,Big Spenders
48852,77,6,456.74,4,1,1,6,Regulars
48853,260,9,2168.98,2,2,4,8,Regulars
48854,285,13,3177.94,2,4,5,11,At Risk
48855,154,11,980.0799999999999,3,3,2,8,Regulars
48856,522,8,1826.85,1,2,4,7,Regulars
48857,314,8,335.31,2,2,1,5,Hibernating
48858,404,14,3003.89,2,5,5,12,At Risk
48859,328,11,1153.07,2,3,2,7,Regulars
48860,524,7,1579.92,1,1,3,5,Regulars
48861,219,8,818.11,3,2,1,6,Regulars
48862,1080,9,1551.64,1,2,3,6,Regulars
48863,272,12,1372.85,2,4,3,9,At Risk
48864,366,10,695.58,2,3,1,6,Regulars
48865,293,6,335.62,2,1,1,4,Hibernating
48866,486,10,1222.96,1,3,2,6,Regulars
48867,50,9,2966.58,5,2,5,12,Big Spenders
48868,759,9,595.56,1,2,1,4,Hibernating
48869,192,7,1178.48,3,1,2,6,Regulars
48870,179,9,1668.17,3,2,3,8,Regulars
48871,74,11,944.5899999999999,4,3,2,9,Loyal
48872,173,14,1469.99,3,5,3,11,Regulars
48873,1063,6,487.81000000000006,1,1,1,3,Hibernating
48874,0,11,4050.4799999999996,5,3,5,13,Loyal
48875,44,12,4092.9399999999996,5,4,5,14,Champions
48876,67,13,2395.65,4,4,4,12,Champions
48877,66,8,2196.7999999999997,4,2,4,10,Big Spenders
48878,153,15,2057.29,3,5,4,12,Big Spenders
48879,661,11,2196.21,1,3,4,8,Regulars
48880,921,6,1405.96,1,1,3,5,Regulars
48881,208,6,567.3,3,1,1,5,Regulars
48882,70,8,2859.36,4,2,5,11,Big Spenders
48883,71,6,236.76,4,1,1,6,Regulars
48884,799,8,559.99,1,2,1,4,Hibernating
48885,1253,7,1296.19,1,1,3,5,Regulars
48886,197,10,2214.01,3,3,4,10,Big Spenders
48887,310,9,2292.04,2,2,4,8,Regulars
48888,55,12,2106.17,5,4,4,13,Champions
48889,588,8,1504.3899999999999,1,2,3,6,Regulars
48890,1087,6,554.29,1,1,1,3,Hibernating
48891,219,6,1002.1899999999999,3,1,2,6,Regulars
48892,61,9,862.71,5,2,2,9,Regulars
48893,99,8,573.46,4,2,1,7,Regulars
48894,82,7,543.91,4,1,1,6,Regulars
48895,90,14,1764.88,4,5,4,13,Champions
48896,170,12,2182.34,3,4,4,11,Big Spenders
48897,288,6,342.25,2,1,1,4,Hibernating
48898,75,8,556.58,4,2,1,7,Regulars
48899,84,7,296.28000000000003,4,1,1,6,Regulars
48900,27,14,1972.81,5,5,4,14,Champions
48901,61,13,3223.06,5,4,5,14,Champions
48902,71,6,606.76,4,1,1,6,Regulars
48903,18,20,6283.17,5,5,5,15,Champions
48904,26,9,1042.62,5,2,2,9,Regulars
48905,281,13,1218.07,2,4,2,8,At Risk
48906,693,4,229.68,1,1,1,3,Hibernating
48907,1256,3,197.42999999999998,1,1,1,3,Hibernating
48908,284,10,1318.03,2,3,3,8,Regulars
48909,60,12,1524.5,5,4,3,12,Loyal
48910,96,11,2047.87,4,3,4,11,Loyal
48911,191,7,797.27,3,1,1,5,Regulars
48912,90,10,1253.83,4,3,3,10,Loyal
48913,630,9,2307.46,1,2,4,7,Regulars
48914,594,11,6932.08,1,3,5,9,Regulars
48915,292,14,1679.8,2,5,3,10,At Risk
48916,43,12,2754.0,5,4,5,14,Champions
48917,227,12,849.77,3,4,2,9,Regulars
48918,929,9,1321.21,1,2,3,6,Regulars
48919,168,12,1323.86,3,4,3,10,Regulars
48920,668,9,563.2,1,2,1,4,Hibernating
48921,28,9,474.56,5,2,1,8,Regulars
48922,168,8,1807.4099999999999,3,2,4,9,Big Spenders
48923,180,12,4122.18,3,4,5,12,Big Spenders
48924,241,11,2127.83,3,3,4,10,Big Spenders
48925,267,9,509.6,2,2,1,5,Hibernating
48926,124,12,1496.82,4,4,3,11,Loyal
48927,124,16,1563.92,4,5,3,12,Loyal
48928,519,10,802.83,1,3,1,5,Regulars
48929,147,12,2415.42,4,4,4,12,Champions
48930,152,13,1328.23,3,4,3,10,Regulars
48931,243,9,786.0699999999999,3,2,1,6,Regulars
48932,721,6,563.16,1,1,1,3,Hibernating
48933,408,7,1536.97,2,1,3,6,Regulars
48934,138,10,1012.6299999999999,4,3,2,9,Loyal
48935,287,13,2092.38,2,4,4,10,At Risk
48936,463,15,2034.48,1,5,4,10,At Risk
48937,90,13,1232.8,4,4,2,10,Loyal
48938,646,9,5736.91,1,2,5,8,Regulars
48939,846,8,2374.3799999999997,1,2,4,7,Regulars
48940,12,14,1557.25,5,5,3,13,Loyal
48941,41,9,627.0,5,2,1,8,Regulars
48942,366,11,956.39,2,3,2,7,Regulars
48943,268,9,2611.87,2,2,5,9,Regulars
48944,30,12,3762.2000000000003,5,4,5,14,Champions
48945,27,9,1221.11,5,2,2,9,Regulars
48946,48,12,1778.68,5,4,4,13,Champions
48947,333,4,311.67,2,1,1,4,Hibernating
48948,487,6,818.08,1,1,1,3,Hibernating
48949,270,8,2708.5899999999997,2,2,5,9,Regulars
48950,77,13,3113.37,4,4,5,13,Champions
48951,21,7,836.77,5,1,1,7,Regulars
48952,784,10,3166.54,1,3,5,9,Regulars
48953,38,6,1489.25,5,1,3,9,Regulars
48954,83,17,2047.25,4,5,4,13,Champions
48955,489,11,1023.8799999999999,1,3,2,6,Regulars
48956,631,12,3243.04,1,4,5,10,At Risk
48957,209,11,3226.86,3,3,5,11,Big Spenders
48958,99,11,2046.98,4,3,4,11,Loyal
48959,400,14,2609.59,2,5,5,12,At Risk
48960,583,11,3389.9,1,3,5,9,Regulars
48961,326,6,861.19,2,1,2,5,Hibernating
48962,13,13,2933.73,5,4,5,14,Champions
48963,87,13,1930.4,4,4,4,12,Champions
48964,553,8,1064.9599999999998,1,2,2,5,Hibernating
48965,577,4,565.78,1,1,1,3,Hibernating
48966,199,8,993.66,3,2,2,7,Regulars
48967,125,8,581.44,4,2,1,7,Regulars
48968,323,10,1272.0,2,3,3,8,Regulars
48969,277,8,629.71,2,2,1,5,Hibernating
48970,12,14,1270.66,5,5,3,13,Loyal
48971,126,10,3816.2700000000004,4,3,5,12,Loyal
48972,888,11,1037.28,1,3,2,6,Regulars
48973,198,10,1329.6100000000001,3,3,3,9,Regulars
48974,173,13,1537.3,3,4,3,10,Regulars
48975,217,16,2040.3600000000001,3,5,4,12,Big Spenders
48976,191,13,3255.09,3,4,5,12,Big Spenders
48977,101,11,1078.85,4,3,2,9,Loyal
48978,162,8,1010.02,3,2,2,7,Regulars
48979,65,17,1830.85,5,5,4,14,Champions
48980,807,8,2641.1699999999996,1,2,5,8,Regulars
48981,21,6,857.84,5,1,2,8,Regulars
48982,318,6,306.02,2,1,1,4,Hibernating
48983,97,14,3232.0,4,5,5,14,Champions
48984,475,12,3235.0,1,4,5,10,At Risk
48985,172,14,2041.92,3,5,4,12,Big Spenders
48986,64,4,517.89,5,1,1,7,Regulars
48987,522,7,1117.5,1,1,2,4,Hibernating
48988,267,15,3082.2300000000005,2,5,5,12,At Risk
48989,501,11,1612.37,1,3,3,7,Regulars
48990,258,10,3179.2499999999995,2,3,5,10,Regulars
48991,38,11,1129.46,5,3,2,10,Loyal
48992,224,16,1894.11,3,5,4,12,Big Spenders
48993,314,10,1723.6200000000001,2,3,3,8,Regulars
48994,401,11,1082.23,2,3,2,7,Regulars
48995,1287,6,1061.12,1,1,2,4,Hibernating
48996,307,10,621.83,2,3,1,6,Regulars
48997,20,10,1060.24,5,3,2,10,Loyal
48998,175,9,892.5,3,2,2,7,Regulars
48999,244,11,2671.04,3,3,5,11,Big Spenders
49000,85,10,2420.1,4,3,4,11,Loyal
49001,140,8,768.6200000000001,4,2,1,7,Regulars
49002,261,10,984.42,2,3,2,7,Regulars
49003,889,5,1003.47,1,1,2,4,Hibernating
49004,376,9,1066.53,2,2,2,6,Hibernating
49005,148,10,1096.13,3,3,2,8,Regulars
49006,274,14,4809.33,2,5,5,12,At Risk
49007,583,4,709.88,1,1,1,3,Hibernating
49008,187,12,7054.279999999999,3,4,5,12,Big Spenders
49009,25,11,3035.94,5,3,5,13,Loyal
49010,243,12,3840.34,3,4,5,12,Big Spenders
49011,125,13,2952.87,4,4,5,13,Champions
49012,63,9,2455.89,5,2,4,11,Big Spenders
49013,179,8,556.86,3,2,1,6,Regulars
49014,251,15,1419.59,2,5,3,10,At Risk
49015,225,10,1097.8799999999999,3,3,2,8,Regulars
49016,4,12,2273.54,5,4,4,13,Champions
49017,173,9,2232.14,3,2,4,9,Big Spenders
49018,7,7,3552.78,5,1,5,11,Big Spenders
49019,584,7,711.5699999999999,1,1,1,3,Hibernating
49020,439,10,732.64,2,3,1,6,Regulars
49021,67,11,1215.29,4,3,2,9,Loyal
49022,697,7,1194.8600000000001,1,1,2,4,Hibernating
49023,181,7,942.44,3,1,2,6,Regulars
49024,166,8,1577.1000000000001,3,2,3,8,Regulars
49025,534,11,1361.56,1,3,3,7,Regulars
49026,994,8,1671.45,1,2,3,6,Regulars
49027,242,6,2217.99,3,1,4,8,Big Spenders
49028,257,10,1047.63,2,3,2,7,Regulars
49029,66,11,814.5799999999999,4,3,1,8,Loyal
49030,457,8,2204.15,2,2,4,8,Regulars
49031,50,12,1300.8100000000002,5,4,3,12,Loyal
49032,22,13,2471.96,5,4,4,13,Champions
49033,276,10,2365.06,2,3,4,9,Regulars
49034,561,9,614.14,1,2,1,4,Hibernating
49035,30,9,816.0,5,2,1,8,Regulars
49036,242,6,600.02,3,1,1,5,Regulars
49037,223,10,617.58,3,3,1,7,Regulars
49038,213,7,624.06,3,1,1,5,Regulars
49039,73,10,738.35,4,3,1,8,Loyal
49040,772,11,1460.24,1,3,3,7,Regulars
49041,1,9,2508.22,5,2,4,11,Big Spenders
49042,31,13,956.61,5,4,2,11,Loyal
49043,1033,7,372.02,1,1,1,3,Hibernating
49044,156,15,2181.84,3,5,4,12,Big Spenders
49045,181,14,5135.53,3,5,5,13,Big Spenders
49046,573,12,1018.81,1,4,2,7,At Risk
49047,89,8,2672.57,4,2,5,11,Big Spenders
49048,515,8,870.35,1,2,2,5,Hibernating
49049,297,12,3496.5,2,4,5,11,At Risk
49050,104,11,634.01,4,3,1,8,Loyal
49051,74,21,3538.83,4,5,5,14,Champions
49052,468,11,4072.1600000000003,1,3,5,9,Regulars
49053,264,9,829.7,2,2,1,5,Hibernating
49054,93,14,1228.3899999999999,4,5,2,11,Loyal
49055,831,7,658.95,1,1,1,3,Hibernating
49056,854,7,969.11,1,1,2,4,Hibernating
49057,666,6,576.52,1,1,1,3,Hibernating
49058,17,17,1984.74,5,5,4,14,Champions
49059,877,8,1801.22,1,2,4,7,Regulars
49060,197,16,3318.28,3,5,5,13,Big Spenders
49061,60,9,469.65,5,2,1,8,Regulars
49062,615,5,2596.09,1,1,5,7,Regulars
49063,127,11,4426.9,4,3,5,12,Loyal
49064,509,10,782.57,1,3,1,5,Regulars
49065,1095,9,1626.99,1,2,3,6,Regulars
49066,412,7,2171.24,2,1,4,7,Regulars
49067,1902,5,506.2,1,1,1,3,Hibernating
49068,37,17,2384.7799999999997,5,5,4,14,Champions
49069,244,10,1273.06,3,3,3,9,Regulars
49070,56,7,1950.6799999999998,5,1,4,10,Big Spenders
49071,187,10,1124.26,3,3,2,8,Regulars
49072,352,14,3891.9900000000002,2,5,5,12,At Risk
49073,266,17,2383.71,2,5,4,11,At Risk
49074,186,9,2610.59,3,2,5,10,Big Spenders
49075,218,10,1912.51,3,3,4,10,Big Spenders
49076,542,9,1472.59,1,2,3,6,Regulars
49077,834,10,689.6600000000001,1,3,1,5,Regulars
49078,137,22,2529.0699999999997,4,5,4,13,Champions
49079,585,9,3656.5,1,2,5,8,Regulars
49080,1347,8,1918.19,1,2,4,7,Regulars
49081,681,9,645.9200000000001,1,2,1,4,Hibernating
49082,486,15,3769.01,1,5,5,11,At Risk
49083,42,11,2564.85,5,3,4,12,Loyal
49084,432,17,3850.01,2,5,5,12,At Risk
49085,300,11,681.96,2,3,1,6,Regulars
49086,318,12,1328.78,2,4,3,9,At Risk
49087,235,12,1602.18,3,4,3,10,Regulars
49088,108,11,1327.42,4,3,3,10,Loyal
49089,599,5,300.83,1,1,1,3,Hibernating
49090,74,14,1991.63,4,5,4,13,Champions
49091,56,8,829.9300000000001,5,2,1,8,Regulars
49092,273,14,1474.07,2,5,3,10,At Risk
49093,22,9,4009.98,5,2,5,12,Big Spenders
49094,523,10,2231.69,1,3,4,8,Regulars
49095,91,8,351.28,4,2,1,7,Regulars
49096,32,5,2405.9500000000003,5,1,4,10,Big Spenders
49097,61,9,961.0,5,2,2,9,Regulars
49098,164,9,1098.26,3,2,2,7,Regulars
49099,84,11,1433.94,4,3,3,10,Loyal
49100,613,11,2062.57,1,3,4,8,Regulars
49101,45,9,1067.51,5,2,2,9,Regulars
49102,10,18,1758.9,5,5,4,14,Champions
49103,104,13,717.3100000000001,4,4,1,9,Loyal
49104,99,10,713.8699999999999,4,3,1,8,Loyal
49105,141,7,662.38,4,1,1,6,Regulars
49106,307,9,1264.28,2,2,3,7,Regulars
49107,192,12,2170.66,3,4,4,11,Big Spenders
49108,164,11,4393.67,3,3,5,11,Big Spenders
49109,129,11,1469.91,4,3,3,10,Loyal
49110,189,7,1373.17,3,1,3,7,Regulars
49111,154,8,687.6,3,2,1,6,Regulars
49112,493,12,1186.6,1,4,2,7,At Risk
49113,484,11,1440.11,1,3,3,7,Regulars
49114,245,13,1172.25,3,4,2,9,Regulars
49115,96,7,4576.75,4,1,5,10,Big Spenders
49116,420,18,4379.99,2,5,5,12,At Risk
49117,298,9,3150.8199999999997,2,2,5,9,Regulars
49118,518,8,1614.99,1,2,3,6,Regulars
49119,531,8,1073.26,1,2,2,5,Hibernating
49120,83,16,2158.91,4,5,4,13,Champions
49121,168,8,660.8000000000001,3,2,1,6,Regulars
49122,22,13,1751.9,5,4,4,13,Champions
49123,677,4,346.67,1,1,1,3,Hibernating
49124,54,11,931.63,5,3,2,10,Loyal
49125,182,8,948.95,3,2,2,7,Regulars
49126,526,10,1239.17,1,3,2,6,Regulars
49127,620,7,709.8199999999999,1,1,1,3,Hibernating
49128,58,8,1307.86,5,2,3,10,Regulars
49129,144,13,1124.07,4,4,2,10,Loyal
49130,54,12,1119.26,5,4,2,11,Loyal
49131,174,7,657.74,3,1,1,5,Regulars
49132,554,8,900.41,1,2,2,5,Hibernating
49133,235,10,1277.72,3,3,3,9,Regulars
49134,93,9,5325.8,4,2,5,11,Big Spenders
49135,95,7,1152.5600000000002,4,1,2,7,Regulars
49136,484,8,911.33,1,2,2,5,Hibernating
49137,764,13,2880.39,1,4,5,10,At Risk
49138,239,9,1003.33,3,2,2,7,Regulars
49139,72,11,3609.17,4,3,5,12,Loyal
49140,121,15,1545.1100000000001,4,5,3,12,Loyal
49141,494,9,1631.86,1,2,3,6,Regulars
49142,117,5,576.1800000000001,4,1,1,6,Regulars
49143,153,5,564.67,3,1,1,5,Regulars
49144,747,7,591.96,1,1,1,3,Hibernating
49145,288,11,3191.0899999999992,2,3,5,10,Regulars
49146,7,12,1392.94,5,4,3,12,Loyal
49147,119,14,1358.54,4,5,3,12,Loyal
49148,445,6,2045.2,2,1,4,7,Regulars
49149,287,9,1191.8,2,2,2,6,Hibernating
49150,0,12,2622.23,5,4,5,14,Champions
49151,94,13,1724.15,4,4,3,11,Loyal
49152,10,11,3177.13,5,3,5,13,Loyal
49153,65,11,1285.9,5,3,3,11,Loyal
49154,217,5,2031.2199999999998,3,1,4,8,Big Spenders
49155,173,13,1356.55,3,4,3,10,Regulars
49156,213,13,2918.8399999999997,3,4,5,12,Big Spenders
49157,713,11,1517.91,1,3,3,7,Regulars
49158,128,8,1402.69,4,2,3,9,Regulars
49159,38,11,886.35,5,3,2,10,Loyal
49160,49,10,1987.06,5,3,4,12,Loyal
49161,301,8,813.9,2,2,1,5,Hibernating
49162,284,8,426.2,2,2,1,5,Hibernating
49163,279,11,627.4200000000001,2,3,1,6,Regulars
49164,264,10,1685.9,2,3,3,8,Regulars
49165,156,11,2201.58,3,3,4,10,Big Spenders
49166,95,10,1437.71,4,3,3,10,Loyal
49167,881,8,856.05,1,2,2,5,Hibernating
49168,141,8,2334.58,4,2,4,10,Big Spenders
49169,79,13,1208.7,4,4,2,10,Loyal
49170,267,5,398.4,2,1,1,4,Hibernating
49171,215,13,1969.1799999999998,3,4,4,11,Big Spenders
49172,644,13,2708.52,1,4,5,10,At Risk
49173,761,7,1596.28,1,1,3,5,Regulars
49174,820,12,1587.1,1,4,3,8,At Risk
49175,584,12,941.21,1,4,2,7,At Risk
49176,573,4,1114.8799999999999,1,1,2,4,Hibernating
49177,63,7,330.51,5,1,1,7,Regulars
49178,394,11,1596.6299999999999,2,3,3,8,Regulars
49179,92,9,987.03,4,2,2,8,Regulars
49180,740,10,1611.07,1,3,3,7,Regulars
49181,235,11,1683.95,3,3,3,9,Regulars
49182,186,7,634.1700000000001,3,1,1,5,Regulars
49183,247,14,851.61,3,5,2,10,Regulars
49184,7,5,220.67000000000002,5,1,1,7,Regulars
49185,502,10,4292.66,1,3,5,9,Regulars
49186,92,7,711.63,4,1,1,6,Regulars
49187,134,10,1249.33,4,3,3,10,Loyal
49188,33,12,764.33,5,4,1,10,Loyal
49189,598,7,1430.77,1,1,3,5,Regulars
49190,30,17,1997.34,5,5,4,14,Champions
49191,65,13,1821.43,5,4,4,13,Champions
49192,207,11,744.5699999999999,3,3,1,7,Regulars
49193,839,7,2824.66,1,1,5,7,Regulars
49194,50,12,1599.16,5,4,3,12,Loyal
49195,726,10,1040.6000000000001,1,3,2,6,Regulars
49196,17,8,902.21,5,2,2,9,Regulars
49197,933,8,937.6,1,2,2,5,Hibernating
49198,41,8,1431.16,5,2,3,10,Regulars
49199,132,11,1296.22,4,3,3,10,Loyal
49200,582,11,1879.31,1,3,4,8,Regulars
49201,100,10,1391.29,4,3,3,10,Loyal
49202,936,3,150.65,1,1,1,3,Hibernating
49203,570,10,1115.99,1,3,2,6,Regulars
49204,89,8,2878.54,4,2,5,11,Big Spenders
49205,179,8,1322.1000000000001,3,2,3,8,Regulars
49206,16,8,1532.7,5,2,3,10,Regulars
49207,84,9,1577.1399999999999,4,2,3,9,Regulars
49208,250,9,1166.44,2,2,2,6,Hibernating
49209,73,12,1515.83,4,4,3,11,Loyal
49210,124,6,536.16,4,1,1,6,Regulars
49211,52,7,1345.11,5,1,3,9,Regulars
49212,202,10,1243.04,3,3,3,9,Regulars
49213,1057,5,242.23,1,1,1,3,Hibernating
49214,15,9,623.5999999999999,5,2,1,8,Regulars
49215,146,10,3058.0,4,3,5,12,Loyal
49216,248,9,1813.64,2,2,4,8,Regulars
49217,285,12,1814.23,2,4,4,10,At Risk
49218,129,12,1767.49,4,4,4,12,Champions
49219,241,17,2379.44,3,5,4,12,Big Spenders
49220,71,12,3135.56,4,4,5,13,Champions
49221,674,10,2253.2799999999997,1,3,4,8,Regulars
49222,349,9,1025.47,2,2,2,6,Hibernating
49223,110,20,4139.59,4,5,5,14,Champions
49224,232,19,3068.67,3,5,5,13,Big Spenders
49225,81,14,5461.99,4,5,5,14,Champions
49226,384,9,844.11,2,2,1,5,Hibernating
49227,329,10,899.15,2,3,2,7,Regulars
49228,1217,6,1365.82,1,1,3,5,Regulars
49229,588,14,2396.96,1,5,4,10,At Risk
49230,652,7,3663.93,1,1,5,7,Regulars
49231,80,10,860.77,4,3,2,9,Loyal
49232,84,6,1123.3100000000002,4,1,2,7,Regulars
49233,1039,12,1550.44,1,4,3,8,At Risk
49234,193,9,1225.52,3,2,2,7,Regulars
49235,231,8,2035.6,3,2,4,9,Big Spenders
49236,188,9,1117.25,3,2,2,7,Regulars
49237,186,11,4583.97,3,3,5,11,Big Spenders
49238,46,11,925.69,5,3,2,10,Loyal
49239,197,8,1219.6200000000001,3,2,2,7,Regulars
49240,672,10,676.13,1,3,1,5,Regulars
49241,175,14,2500.61,3,5,4,12,Big Spenders
49242,756,5,372.3000000000005,1,1,1,3,Hibernating
49243,166,9,830.02,3,2,1,6,Regulars
49244,508,14,2475.91,1,5,4,10,At Risk
49245,76,11,3385.88,4,3,5,12,Loyal
49246,31,12,1220.22,5,4,2,11,Loyal
49247,153,15,3468.81,3,5,5,13,Big Spenders
49248,173,12,1754.04,3,4,4,11,Big Spenders
49249,222,9,1364.9899999999998,3,2,3,8,Regulars
49250,217,11,2700.49,3,3,5,11,Big Spenders
49251,193,13,1457.1299999999999,3,4,3,10,Regulars
49252,99,5,697.36,4,1,1,6,Regulars
49253,0,12,4327.86,5,4,5,14,Champions
49254,789,10,1249.77,1,3,3,7,Regulars
49255,621,6,2853.97,1,1,5,7,Regulars
49256,332,7,742.99,2,1,1,4,Hibernating
49257,299,9,1346.04,2,2,3,7,Regulars
49258,120,10,1356.53,4,3,3,10,Loyal
49259,158,15,2564.58,3,5,4,12,Big Spenders
49260,536,9,983.77,1,2,2,5,Hibernating
49261,289,14,4905.68,2,5,5,12,At Risk
49262,139,11,1479.6499999999999,4,3,3,10,Loyal
49263,177,12,2418.5,3,4,4,11,Big Spenders
49264,254,6,606.45,2,1,1,4,Hibernating
49265,56,14,4040.0,5,5,5,15,Champions
49266,53,7,965.0600000000001,5,1,2,8,Regulars
49267,87,19,2358.75,4,5,4,13,Champions
49268,12,15,3328.2,5,5,5,15,Champions
49269,491,12,1394.16,1,4,3,8,At Risk
49270,163,9,1186.49,3,2,2,7,Regulars
49271,837,8,1259.1299999999999,1,2,3,6,Regulars
49272,289,13,2263.65,2,4,4,10,At Risk
49273,576,7,791.43,1,1,1,3,Hibernating
49274,8,12,1524.2,5,4,3,12,Loyal
49275,551,7,560.87,1,1,1,3,Hibernating
49276,419,10,1321.1599999999999,2,3,3,8,Regulars
49277,133,11,1465.13,4,3,3,10,Loyal
49278,152,13,1979.29,3,4,4,11,Big Spenders
49279,50,15,1234.23,5,5,2,12,Loyal
49280,844,6,944.58,1,1,2,4,Hibernating
49281,338,12,1674.96,2,4,3,9,At Risk
49282,321,19,2877.47,2,5,5,12,At Risk
49283,90,16,1093.48,4,5,2,11,Loyal
49284,308,12,1730.54,2,4,4,10,At Risk
49285,156,9,896.02,3,2,2,7,Regulars
49286,106,14,2166.61,4,5,4,13,Champions
49287,261,8,608.5699999999999,2,2,1,5,Hibernating
49288,78,11,2525.33,4,3,4,11,Loyal
49289,68,12,1373.65,4,4,3,11,Loyal
49290,233,8,2429.33,3,2,4,9,Big Spenders
49291,25,9,1005.48,5,2,2,9,Regulars
49292,365,8,787.5799999999999,2,2,1,5,Hibernating
49293,179,9,2263.9100000000003,3,2,4,9,Big Spenders
49294,86,10,2132.15,4,3,4,11,Loyal
49295,98,16,2201.1800000000003,4,5,4,13,Champions
49296,504,6,378.11,1,1,1,3,Hibernating
49297,83,11,961.16,4,3,2,9,Loyal
49298,308,13,1800.4499999999998,2,4,4,10,At Risk
49299,1128,4,703.8199999999999,1,1,1,3,Hibernating
49300,168,11,2047.12,3,3,4,10,Big Spenders
49301,79,11,1486.52,4,3,3,10,Loyal
49302,0,10,474.46000000000004,5,3,1,9,Loyal
49303,54,4,355.37,5,1,1,7,Regulars
49304,453,13,1877.79,2,4,4,10,At Risk
49305,606,12,995.26,1,4,2,7,At Risk
49306,343,3,603.28,2,1,1,4,Hibernating
49307,54,9,1858.05,5,2,4,11,Big Spenders
49308,489,7,1329.17,1,1,3,5,Regulars
49309,782,10,745.94,1,3,1,5,Regulars
49310,439,13,4537.1900000000005,2,4,5,11,At Risk
49311,117,13,1271.57,4,4,3,11,Loyal
49312,91,12,1229.18,4,4,2,10,Loyal
49313,235,9,1680.03,3,2,3,8,Regulars
49314,278,8,1545.27,2,2,3,7,Regulars
49315,108,15,4258.82,4,5,5,14,Champions
49316,86,11,3317.37,4,3,5,12,Loyal
49317,147,16,2142.74,4,5,4,13,Champions
49318,245,9,524.13,3,2,1,6,Regulars
49319,101,11,1635.42,4,3,3,10,Loyal
49320,587,11,1024.91,1,3,2,6,Regulars
49321,245,12,4595.82,3,4,5,12,Big Spenders
49322,196,9,695.87,3,2,1,6,Regulars
49323,149,12,1015.08,3,4,2,9,Regulars
49324,40,12,1231.9,5,4,2,11,Loyal
49325,188,7,1150.02,3,1,2,6,Regulars
49326,0,11,1746.01,5,3,4,12,Loyal
49327,123,8,2540.88,4,2,4,10,Big Spenders
49328,36,14,2688.72,5,5,5,15,Champions
49329,3,9,1120.26,5,2,2,9,Regulars
49330,121,11,1195.55,4,3,2,9,Loyal
49331,79,10,1808.8600000000001,4,3,4,11,Loyal
49332,297,8,1002.38,2,2,2,6,Hibernating
49333,570,9,1135.99,1,2,2,5,Hibernating
49334,213,11,1414.0900000000001,3,3,3,9,Regulars
49335,108,12,1411.71,4,4,3,11,Loyal
49336,90,12,2107.7999999999997,4,4,4,12,Champions
49337,174,11,1687.6799999999998,3,3,3,9,Regulars
49338,782,11,816.31,1,3,1,5,Regulars
49339,450,5,932.06,2,1,2,5,Hibernating
49340,176,11,902.85,3,3,2,8,Regulars
49341,5,4,226.82,5,1,1,7,Regulars
49342,272,9,2480.27,2,2,4,8,Regulars
49343,490,6,767.38,1,1,1,3,Hibernating
49344,96,10,899.1700000000001,4,3,2,9,Loyal
49345,111,10,3185.35,4,3,5,12,Loyal
49346,65,9,1424.28,5,2,3,10,Regulars
49347,83,12,1261.7,4,4,3,11,Loyal
49348,295,6,862.81,2,1,2,5,Hibernating
49349,68,12,839.23,4,4,1,9,Loyal
49350,416,7,966.6399999999999,2,1,2,5,Hibernating
49351,49,8,637.3199999999999,5,2,1,8,Regulars
49352,310,9,2874.2799999999997,2,2,5,9,Regulars
49353,83,17,2205.06,4,5,4,13,Champions
49354,260,13,984.84,2,4,2,8,At Risk
49355,152,6,1871.93,3,1,4,8,Big Spenders
49356,859,4,1476.26,1,1,3,5,Regulars
49357,74,14,1533.03,4,5,3,12,Loyal
49358,71,13,2062.05,4,4,4,12,Champions
49359,318,14,1908.77,2,5,4,11,At Risk
49360,1458,6,391.29999999999995,1,1,1,3,Hibernating
49361,459,7,403.99,2,1,1,4,Hibernating
49362,2015,4,937.75,1,1,2,4,Hibernating
49363,461,11,1317.25,1,3,3,7,Regulars
49364,161,9,1118.84,3,2,2,7,Regulars
49365,127,9,2309.36,4,2,4,10,Big Spenders
49366,525,8,779.13,1,2,1,4,Hibernating
49367,243,12,1227.46,3,4,2,9,Regulars
49368,41,13,780.77,5,4,1,10,Loyal
49369,72,12,648.15,4,4,1,9,Loyal
49370,393,7,968.4300000000001,2,1,2,5,Hibernating
49371,2,13,1521.53,5,4,3,12,Loyal
49372,180,11,1591.06,3,3,3,9,Regulars
49373,45,12,1641.34,5,4,3,12,Loyal
49374,69,11,2481.79,4,3,4,11,Loyal
49375,234,12,1043.13,3,4,2,9,Regulars
49376,570,8,3364.0,1,2,5,8,Regulars
49377,152,9,666.03,3,2,1,6,Regulars
49378,0,11,1626.3400000000001,5,3,3,11,Loyal
49379,70,12,1409.64,4,4,3,11,Loyal
49380,197,7,331.26,3,1,1,5,Regulars
49381,108,9,972.05,4,2,2,8,Regulars
49382,53,14,3658.35,5,5,5,15,Champions
49383,990,7,588.92,1,1,1,3,Hibernating
49384,257,7,706.19,2,1,1,4,Hibernating
49385,1646,5,369.74,1,1,1,3,Hibernating
49386,29,6,1116.1,5,1,2,8,Regulars
49387,227,9,1315.21,3,2,3,8,Regulars
49388,269,6,511.84000000000003,2,1,1,4,Hibernating
49389,305,7,1510.3200000000002,2,1,3,6,Regulars
49390,294,5,621.89,2,1,1,4,Hibernating
49391,85,8,1720.0800000000002,4,2,3,9,Regulars
49392,140,9,593.18,4,2,1,7,Regulars
49393,724,8,1230.1399999999999,1,2,2,5,Hibernating
49394,91,12,2447.05,4,4,4,12,Champions
49395,2089,6,2748.1,1,1,5,7,Regulars
49396,200,9,1160.01,3,2,2,7,Regulars
49397,349,8,686.52,2,2,1,5,Hibernating
49398,232,9,1067.6299999999999,3,2,2,7,Regulars
49399,8,12,2957.9900000000002,5,4,5,14,Champions
49400,201,8,4197.6,3,2,5,10,Big Spenders
49401,246,9,2102.82,3,2,4,9,Big Spenders
49402,314,10,1245.28,2,3,3,8,Regulars
49403,543,12,2525.65,1,4,4,9,At Risk
49404,50,9,1676.2199999999998,5,2,3,10,Regulars
49405,142,14,1631.71,4,5,3,12,Loyal
49406,8,12,931.61,5,4,2,11,Loyal
49407,408,15,1527.67,2,5,3,10,At Risk
49408,71,11,859.0400000000001,4,3,2,9,Loyal
49409,10,12,774.7,5,4,1,10,Loyal
49410,46,11,1062.37,5,3,2,10,Loyal
49411,501,7,1460.91,1,1,3,5,Regulars
49412,217,10,1099.6299999999999,3,3,2,8,Regulars
49413,75,7,2783.91,4,1,5,10,Big Spenders
49414,52,14,3361.1800000000003,5,5,5,15,Champions
49415,703,11,2038.6599999999999,1,3,4,8,Regulars
49416,235,13,2537.84,3,4,4,11,Big Spenders
49417,668,13,4338.37,1,4,5,10,At Risk
49418,301,12,1200.7,2,4,2,8,At Risk
49419,77,14,1625.78,4,5,3,12,Loyal
49420,104,15,1962.06,4,5,4,13,Champions
49421,76,12,1949.8,4,4,4,12,Champions
49422,468,11,2185.62,1,3,4,8,Regulars
49423,236,6,1249.3200000000002,3,1,3,7,Regulars
49424,1327,8,1210.1,1,2,2,5,Hibernating
49425,147,11,1394.26,4,3,3,10,Loyal
49426,74,16,1767.76,4,5,4,13,Champions
49427,196,8,2782.98,3,2,5,10,Big Spenders
49428,1,9,1557.36,5,2,3,10,Regulars
49429,166,3,459.6,3,1,1,5,Regulars
49430,16,8,2381.64,5,2,4,11,Big Spenders
49431,287,10,885.4200000000001,2,3,2,7,Regulars
49432,295,9,2132.94,2,2,4,8,Regulars
49433,1010,9,1047.83,1,2,2,5,Hibernating
49434,757,8,2928.89,1,2,5,8,Regulars
49435,94,9,659.5,4,2,1,7,Regulars
49436,486,12,3053.2300000000005,1,4,5,10,At Risk
49437,82,6,595.25,4,1,1,6,Regulars
49438,63,20,3621.09,5,5,5,15,Champions
49439,398,7,489.83000000000004,2,1,1,4,Hibernating
49440,181,11,4545.599999999999,3,3,5,11,Big Spenders
49441,42,11,2470.8,5,3,4,12,Loyal
49442,262,9,1010.77,2,2,2,6,Hibernating
49443,21,19,2633.96,5,5,5,15,Champions
49444,191,10,1535.6499999999999,3,3,3,9,Regulars
49445,303,7,1412.94,2,1,3,6,Regulars
49446,104,11,4139.700000000001,4,3,5,12,Loyal
49447,81,9,2090.93,4,2,4,10,Big Spenders
49448,27,12,1650.27,5,4,3,12,Loyal
49449,819,9,3896.03,1,2,5,8,Regulars
49450,7,8,1802.6299999999999,5,2,4,11,Big Spenders
49451,83,16,4260.28,4,5,5,14,Champions
49452,40,12,1355.6299999999999,5,4,3,12,Loyal
49453,97,10,676.8100000000001,4,3,1,8,Loyal
49454,548,7,1095.07,1,1,2,4,Hibernating
49455,231,13,1307.8200000000002,3,4,3,10,Regulars
49456,413,7,1971.21,2,1,4,7,Regulars
49457,402,9,2020.37,2,2,4,8,Regulars
49458,0,10,1135.75,5,3,2,10,Loyal
49459,473,7,341.6,1,1,1,3,Hibernating
49460,227,9,1688.49,3,2,3,8,Regulars
49461,255,4,686.1899999999999,2,1,1,4,Hibernating
49462,370,13,2090.83,2,4,4,10,At Risk
49463,480,8,1109.8400000000001,1,2,2,5,Hibernating
49464,116,8,448.31,4,2,1,7,Regulars
49465,1411,7,1845.46,1,1,4,6,Regulars
49466,192,12,1705.26,3,4,3,10,Regulars
49467,69,11,1169.95,4,3,2,9,Loyal
49468,179,13,3050.29,3,4,5,12,Big Spenders
49469,57,15,1729.72,5,5,4,14,Champions
49470,205,11,1444.79,3,3,3,9,Regulars
49471,97,8,4125.23,4,2,5,11,Big Spenders
49472,31,11,1297.33,5,3,3,11,Loyal
49473,29,12,2113.66,5,4,4,13,Champions
49474,697,8,1306.2599999999998,1,2,3,6,Regulars
49475,211,10,949.13,3,3,2,8,Regulars
49476,167,15,4810.39,3,5,5,13,Big Spenders
49477,741,14,1578.52,1,5,3,9,At Risk
49478,1333,7,718.4300000000001,1,1,1,3,Hibernating
49479,40,15,3546.8199999999997,5,5,5,15,Champions
49480,587,8,3158.05,1,2,5,8,Regulars
49481,26,11,668.69,5,3,1,9,Loyal
49482,44,12,2598.1000000000004,5,4,5,14,Champions
49483,80,9,3063.71,4,2,5,11,Big Spenders
49484,161,10,1883.42,3,3,4,10,Big Spenders
49485,95,4,236.91,4,1,1,6,Regulars
49486,254,4,212.53,2,1,1,4,Hibernating
49487,65,15,1767.2800000000002,5,5,4,14,Champions
49488,278,16,5683.370000000001,2,5,5,12,At Risk
49489,229,9,669.2099999999999,3,2,1,6,Regulars
49490,36,9,805.55,5,2,1,8,Regulars
49491,590,12,1021.82,1,4,2,7,At Risk
49492,682,8,431.87,1,2,1,4,Hibernating
49493,740,6,441.09000000000003,1,1,1,3,Hibernating
49494,91,14,2006.52,4,5,4,13,Champions
49495,198,13,1842.48,3,4,4,11,Big Spenders
49496,209,10,514.47,3,3,1,7,Regulars
49497,190,10,2306.61,3,3,4,10,Big Spenders
49498,171,14,951.3800000000001,3,5,2,10,Regulars
49499,204,8,2091.13,3,2,4,9,Big Spenders
49500,539,9,1323.71,1,2,3,6,Regulars
49501,183,14,2869.88,3,5,5,13,Big Spenders
49502,115,7,2717.0699999999997,4,1,5,10,Big Spenders
49503,29,12,1794.0700000000002,5,4,4,13,Champions
49504,846,4,2388.34,1,1,4,6,Regulars
49505,186,10,1508.81,3,3,3,9,Regulars
49506,196,10,1863.23,3,3,4,10,Big Spenders
49507,322,10,966.92,2,3,2,7,Regulars
49508,261,12,1026.9,2,4,2,8,At Risk
49509,177,14,3156.82,3,5,5,13,Big Spenders
49510,65,9,1163.42,5,2,2,9,Regulars
49511,297,12,1426.85,2,4,3,9,At Risk
49512,398,10,3133.14,2,3,5,10,Regulars
49513,145,15,1719.69,4,5,3,12,Loyal
49514,351,9,953.72,2,2,2,6,Hibernating
49515,46,8,1462.53,5,2,3,10,Regulars
49516,315,5,598.06,2,1,1,4,Hibernating
49517,161,15,3730.45,3,5,5,13,Big Spenders
49518,453,12,2635.3599999999997,2,4,5,11,At Risk
49519,392,8,1621.48,2,2,3,7,Regulars
49520,888,10,5790.2699999999995,1,3,5,9,Regulars
49521,451,8,828.8700000000001,2,2,1,5,Hibernating
49522,113,10,616.28,4,3,1,8,Loyal
49523,254,14,1626.97,2,5,3,10,At Risk
49524,966,9,2257.7200000000003,1,2,4,7,Regulars
49525,6,13,1266.89,5,4,3,12,Loyal
49526,42,11,1445.5,5,3,3,11,Loyal
49527,243,14,5466.42,3,5,5,13,Big Spenders
49528,10,8,1064.25,5,2,2,9,Regulars
49529,585,7,1438.9199999999998,1,1,3,5,Regulars
49530,38,9,643.59,5,2,1,8,Regulars
49531,557,9,1461.44,1,2,3,6,Regulars
49532,118,14,2821.36,4,5,5,14,Champions
49533,101,10,1328.3,4,3,3,10,Loyal
49534,78,8,543.57,4,2,1,7,Regulars
49535,501,13,2495.3,1,4,4,9,At Risk
49536,208,11,1447.1299999999999,3,3,3,9,Regulars
49537,23,16,2784.37,5,5,5,15,Champions
49538,315,10,3206.12,2,3,5,10,Regulars
49539,252,9,3107.41,2,2,5,9,Regulars
49540,53,10,1026.45,5,3,2,10,Loyal
49541,18,12,2790.59,5,4,5,14,Champions
49542,33,9,1072.93,5,2,2,9,Regulars
49543,452,3,252.76999999999998,2,1,1,4,Hibernating
49544,194,9,1606.0500000000002,3,2,3,8,Regulars
49545,236,14,5121.68,3,5,5,13,Big Spenders
49546,586,12,3760.7599999999998,1,4,5,10,At Risk
49547,268,8,1137.38,2,2,2,6,Hibernating
49548,312,13,1551.76,2,4,3,9,At Risk
49549,591,4,344.62,1,1,1,3,Hibernating
49550,144,5,558.5799999999999,4,1,1,6,Regulars
49551,143,12,2784.07,4,4,5,13,Champions
49552,296,12,1533.61,2,4,3,9,At Risk
49553,139,5,613.21,4,1,1,6,Regulars
49554,100,11,963.29,4,3,2,9,Loyal
49555,888,7,882.84,1,1,2,4,Hibernating
49556,330,6,532.8399999999999,2,1,1,4,Hibernating
49557,307,12,2385.54,2,4,4,10,At Risk
49558,121,8,765.88,4,2,1,7,Regulars
49559,1228,10,1221.1299999999999,1,3,2,6,Regulars
49560,160,11,894.65,3,3,2,8,Regulars
49561,323,9,612.1,2,2,1,5,Hibernating
49562,294,14,1212.82,2,5,2,9,At Risk
49563,170,9,1192.2,3,2,2,7,Regulars
49564,247,9,1335.6,3,2,3,8,Regulars
49565,159,9,571.3,3,2,1,6,Regulars
49566,289,5,218.19,2,1,1,4,Hibernating
49567,12,11,841.24,5,3,1,9,Loyal
49568,154,8,495.79,3,2,1,6,Regulars
49569,448,8,1057.51,2,2,2,6,Hibernating
49570,6,11,945.7099999999999,5,3,2,10,Loyal
49571,14,16,2015.4,5,5,4,14,Champions
49572,35,13,1627.07,5,4,3,12,Loyal
49573,424,9,1313.04,2,2,3,7,Regulars
49574,24,10,543.88,5,3,1,9,Loyal
49575,161,11,719.8,3,3,1,7,Regulars
49576,45,12,2294.58,5,4,4,13,Champions
49577,109,12,1427.28,4,4,3,11,Loyal
49578,434,16,2242.7,2,5,4,11,At Risk
49579,28,13,1938.74,5,4,4,13,Champions
49580,185,9,844.71,3,2,1,6,Regulars
49581,99,16,2490.17,4,5,4,13,Champions
49582,6,10,1694.56,5,3,3,11,Loyal
49583,98,13,2543.39,4,4,4,12,Champions
49584,1936,6,435.44,1,1,1,3,Hibernating
49585,85,11,1598.9599999999998,4,3,3,10,Loyal
49586,213,16,3104.09,3,5,5,13,Big Spenders
49587,295,10,699.74,2,3,1,6,Regulars
49588,217,7,454.42,3,1,1,5,Regulars
49589,27,18,4461.74,5,5,5,15,Champions
49590,311,9,1049.14,2,2,2,6,Hibernating
49591,435,16,3723.3399999999997,2,5,5,12,At Risk
49592,379,10,1147.76,2,3,2,7,Regulars
49593,90,17,1890.5,4,5,4,13,Champions
49594,121,10,2393.0099999999998,4,3,4,11,Loyal
49595,310,9,1947.05,2,2,4,8,Regulars
49596,540,7,1480.38,1,1,3,5,Regulars
49597,44,17,3053.3900000000003,5,5,5,15,Champions
49598,175,10,1500.4499999999998,3,3,3,9,Regulars
49599,595,12,1031.22,1,4,2,7,At Risk
49600,492,10,1157.56,1,3,2,6,Regulars
49601,292,8,701.14,2,2,1,5,Hibernating
49602,116,7,683.91,4,1,1,6,Regulars
49603,3,10,1680.63,5,3,3,11,Loyal
49604,243,10,1132.8,3,3,2,8,Regulars
49605,915,4,761.5100000000001,1,1,1,3,Hibernating
49606,28,11,2006.96,5,3,4,12,Loyal
49607,186,8,563.9699999999999,3,2,1,6,Regulars
49608,571,9,3630.1,1,2,5,8,Regulars
49609,531,9,2203.36,1,2,4,7,Regulars
49610,848,3,211.71999999999997,1,1,1,3,Hibernating
49611,150,11,2203.32,3,3,4,10,Big Spenders
49612,393,15,3820.6600000000003,2,5,5,12,At Risk
49613,536,7,684.91,1,1,1,3,Hibernating
49614,106,13,2224.39,4,4,4,12,Champions
49615,815,7,1416.24,1,1,3,5,Regulars
49616,69,11,3081.2799999999997,4,3,5,12,Loyal
49617,15,8,857.9200000000001,5,2,2,9,Regulars
49618,163,12,3153.3,3,4,5,12,Big Spenders
49619,61,10,1642.83,5,3,3,11,Loyal
49620,1077,8,552.34,1,2,1,4,Hibernating
49621,78,12,2489.52,4,4,4,12,Champions
49622,548,11,1341.91,1,3,3,7,Regulars
49623,39,10,1114.02,5,3,2,10,Loyal
49624,216,11,1552.48,3,3,3,9,Regulars
49625,343,8,3204.47,2,2,5,9,Regulars
49626,27,14,3823.63,5,5,5,15,Champions
49627,116,10,1152.02,4,3,2,9,Loyal
49628,67,9,986.59,4,2,2,8,Regulars
49629,645,10,1073.14,1,3,2,6,Regulars
49630,295,12,1366.65,2,4,3,9,At Risk
49631,7,12,2433.54,5,4,4,13,Champions
49632,163,8,789.4,3,2,1,6,Regulars
49633,225,12,2852.69,3,4,5,12,Big Spenders
49634,378,11,1775.9,2,3,4,9,Regulars
49635,65,13,2139.48,5,4,4,13,Champions
49636,313,12,1515.24,2,4,3,9,At Risk
49637,31,16,4192.89,5,5,5,15,Champions
49638,119,14,1739.71,4,5,4,13,Champions
49639,112,9,1715.61,4,2,3,9,Regulars
49640,274,14,1098.12,2,5,2,9,At Risk
49641,293,9,1160.39,2,2,2,6,Hibernating
49642,67,9,1101.55,4,2,2,8,Regulars
49643,79,5,2227.91,4,1,4,9,Big Spenders
49644,128,7,674.23,4,1,1,6,Regulars
49645,177,17,1368.72,3,5,3,11,Regulars
49646,568,6,956.3399999999999,1,1,2,4,Hibernating
49647,58,10,868.3900000000001,5,3,2,10,Loyal
49648,68,10,3467.3700000000003,4,3,5,12,Loyal
49649,3,16,2434.22,5,5,4,14,Champions
49650,306,15,4733.71,2,5,5,12,At Risk
49651,547,6,558.44,1,1,1,3,Hibernating
49652,764,3,138.2,1,1,1,3,Hibernating
49653,170,14,2499.2599999999998,3,5,4,12,Big Spenders
49654,1086,5,801.11,1,1,1,3,Hibernating
49655,184,14,2904.7999999999997,3,5,5,13,Big Spenders
49656,198,10,1185.83,3,3,2,8,Regulars
49657,286,14,817.92,2,5,1,8,At Risk
49658,267,9,1030.22,2,2,2,6,Hibernating
49659,484,9,468.41,1,2,1,4,Hibernating
49660,267,12,916.34,2,4,2,8,At Risk
49661,180,14,2365.95,3,5,4,12,Big Spenders
49662,329,8,3510.91,2,2,5,9,Regulars
49663,198,13,979.7199999999999,3,4,2,9,Regulars
49664,154,12,1230.58,3,4,2,9,Regulars
49665,90,15,1609.65,4,5,3,12,Loyal
49666,14,18,1573.83,5,5,3,13,Loyal
49667,280,12,2052.59,2,4,4,10,At Risk
49668,71,9,2043.5100000000002,4,2,4,10,Big Spenders
49669,208,5,686.28,3,1,1,5,Regulars
49670,119,9,2866.15,4,2,5,11,Big Spenders
49671,39,9,1004.93,5,2,2,9,Regulars
49672,197,12,993.48,3,4,2,9,Regulars
49673,86,12,1823.21,4,4,4,12,Champions
49674,7,8,1690.43,5,2,3,10,Regulars
49675,86,9,626.53,4,2,1,7,Regulars
49676,977,4,227.57999999999998,1,1,1,3,Hibernating
49677,365,9,1513.28,2,2,3,7,Regulars
49678,416,11,1354.15,2,3,3,8,Regulars
49679,718,5,279.5,1,1,1,3,Hibernating
49680,136,9,981.53,4,2,2,8,Regulars
49681,169,11,1980.83,3,3,4,10,Big Spenders
49682,171,8,2553.8,3,2,4,9,Big Spenders
49683,1006,12,2771.53,1,4,5,10,At Risk
49684,62,16,3135.21,5,5,5,15,Champions
49685,1041,11,3205.21,1,3,5,9,Regulars
49686,126,11,1147.3700000000001,4,3,2,9,Loyal
49687,461,12,2348.29,1,4,4,9,At Risk
49688,115,12,1255.1599999999999,4,4,3,11,Loyal
49689,82,8,1993.1999999999998,4,2,4,10,Big Spenders
49690,123,11,2739.48,4,3,5,12,Loyal
49691,442,11,1841.6600000000003,2,3,4,9,Regulars
49692,479,9,2380.8900000000003,1,2,4,7,Regulars
49693,120,7,2436.21,4,1,4,9,Big Spenders
49694,169,11,2794.15,3,3,5,11,Big Spenders
49695,6,10,1562.47,5,3,3,11,Loyal
49696,146,13,1424.19,4,4,3,11,Loyal
49697,205,11,5003.17,3,3,5,11,Big Spenders
49698,173,11,893.02,3,3,2,8,Regulars
49699,99,19,4320.51,4,5,5,14,Champions
49700,124,7,767.99,4,1,1,6,Regulars
49701,582,7,4614.969999999999,1,1,5,7,Regulars
49702,586,8,1179.06,1,2,2,5,Hibernating
49703,615,14,1904.53,1,5,4,10,At Risk
49704,81,13,1467.14,4,4,3,11,Loyal
49705,508,11,2570.78,1,3,4,8,Regulars
49706,151,9,1836.84,3,2,4,9,Big Spenders
49707,60,12,2878.19,5,4,5,14,Champions
49708,80,12,3011.53,4,4,5,13,Champions
49709,345,10,783.61,2,3,1,6,Regulars
49710,306,9,861.84,2,2,2,6,Hibernating
49711,80,11,1096.6100000000001,4,3,2,9,Loyal
49712,629,8,648.25,1,2,1,4,Hibernating
49713,555,10,925.6999999999999,1,3,2,6,Regulars
49714,302,7,794.3899999999999,2,1,1,4,Hibernating
49715,525,5,625.65,1,1,1,3,Hibernating
49716,91,12,3831.46,4,4,5,13,Champions
49717,261,13,3323.14,2,4,5,11,At Risk
49718,215,12,881.74,3,4,2,9,Regulars
49719,474,5,170.05999999999997,1,1,1,3,Hibernating
49720,78,10,1861.31,4,3,4,11,Loyal
49721,609,9,792.91,1,2,1,4,Hibernating
49722,266,11,442.38,2,3,1,6,Regulars
49723,39,9,748.23,5,2,1,8,Regulars
49724,172,9,1320.95,3,2,3,8,Regulars
49725,149,10,559.6899999999999,3,3,1,7,Regulars
49726,50,10,1347.25,5,3,3,11,Loyal
49727,148,14,2351.4,3,5,4,12,Big Spenders
49728,73,9,1794.3100000000002,4,2,4,10,Big Spenders
49729,793,4,192.14,1,1,1,3,Hibernating
49730,254,6,1717.2800000000002,2,1,3,6,Regulars
49731,172,9,1743.7199999999998,3,2,4,9,Big Spenders
49732,155,18,3149.43,3,5,5,13,Big Spenders
49733,131,7,472.76,4,1,1,6,Regulars
49734,3,7,1114.37,5,1,2,8,Regulars
49735,95,9,1122.58,4,2,2,8,Regulars
49736,363,8,700.9200000000001,2,2,1,5,Hibernating
49737,269,9,1391.7,2,2,3,7,Regulars
49738,1201,5,548.2,1,1,1,3,Hibernating
49739,1108,4,651.48,1,1,1,3,Hibernating
49740,12,10,1364.8700000000001,5,3,3,11,Loyal
49741,337,9,436.13,2,2,1,5,Hibernating
49742,208,13,1413.71,3,4,3,10,Regulars
49743,689,8,1470.12,1,2,3,6,Regulars
49744,466,6,2049.0,1,1,4,6,Regulars
49745,55,17,1861.45,5,5,4,14,Champions
49746,104,9,1428.9,4,2,3,9,Regulars
49747,21,11,900.7199999999999,5,3,2,10,Loyal
49748,157,10,1093.79,3,3,2,8,Regulars
49749,365,7,799.7900000000001,2,1,1,4,Hibernating
49750,1203,4,443.91999999999996,1,1,1,3,Hibernating
49751,48,12,4961.29,5,4,5,14,Champions
49752,715,10,2048.29,1,3,4,8,Regulars
49753,480,12,3749.87,1,4,5,10,At Risk
49754,90,16,2039.21,4,5,4,13,Champions
49755,259,6,708.48,2,1,1,4,Hibernating
49756,250,6,568.89,2,1,1,4,Hibernating
49757,82,6,1128.6799999999998,4,1,2,7,Regulars
49758,593,9,928.8299999999999,1,2,2,5,Hibernating
49759,297,9,2541.02,2,2,4,8,Regulars
49760,111,8,2006.28,4,2,4,10,Big Spenders
49761,59,12,5421.72,5,4,5,14,Champions
49762,724,12,880.35,1,4,2,7,At Risk
49763,220,8,605.59,3,2,1,6,Regulars
49764,260,8,737.33,2,2,1,5,Hibernating
49765,107,9,1034.25,4,2,2,8,Regulars
49766,855,7,1182.09,1,1,2,4,Hibernating
49767,69,10,545.6800000000001,4,3,1,8,Loyal
49768,771,16,3449.9799999999996,1,5,5,11,At Risk
49769,589,10,2246.67,1,3,4,8,Regulars
49770,157,11,3130.4300000000003,3,3,5,11,Big Spenders
49771,524,7,797.9799999999999,1,1,1,3,Hibernating
49772,124,6,2690.2400000000002,4,1,5,10,Big Spenders
49773,190,10,1194.5700000000002,3,3,2,8,Regulars
49774,475,9,1235.13,1,2,2,5,Hibernating
49775,885,4,147.76,1,1,1,3,Hibernating
49776,63,15,4202.59,5,5,5,15,Champions
49777,176,15,1630.73,3,5,3,11,Regulars
49778,407,11,3641.84,2,3,5,10,Regulars
49779,261,12,1838.56,2,4,4,10,At Risk
49780,174,6,446.11,3,1,1,5,Regulars
49781,47,14,2344.33,5,5,4,14,Champions
49782,699,6,1474.72,1,1,3,5,Regulars
49783,82,12,6123.14,4,4,5,13,Champions
49784,193,15,1380.78,3,5,3,11,Regulars
49785,304,13,1799.76,2,4,4,10,At Risk
49786,43,12,2064.9,5,4,4,13,Champions
49787,531,7,571.63,1,1,1,3,Hibernating
49788,8,8,1991.4699999999998,5,2,4,11,Big Spenders
49789,243,14,1612.64,3,5,3,11,Regulars
49790,183,9,2089.29,3,2,4,9,Big Spenders
49791,953,7,5302.55,1,1,5,7,Regulars
49792,70,9,2261.2,4,2,4,10,Big Spenders
49793,229,9,2996.4100000000003,3,2,5,10,Big Spenders
49794,3,7,1325.75,5,1,3,9,Regulars
49795,40,9,929.72,5,2,2,9,Regulars
49796,851,10,3413.5800000000004,1,3,5,9,Regulars
49797,261,6,904.61,2,1,2,5,Hibernating
49798,141,13,1046.45,4,4,2,10,Loyal
49799,300,8,821.85,2,2,1,5,Hibernating
49800,121,14,2419.4700000000003,4,5,4,13,Champions
49801,126,12,1114.47,4,4,2,10,Loyal
49802,334,13,1506.91,2,4,3,9,At Risk
49803,498,6,1751.1299999999997,1,1,4,6,Regulars
49804,74,11,2428.81,4,3,4,11,Loyal
49805,704,10,894.8199999999999,1,3,2,6,Regulars
49806,46,11,1699.7,5,3,3,11,Loyal
49807,275,15,1441.75,2,5,3,10,At Risk
49808,27,12,1855.07,5,4,4,13,Champions
49809,46,8,650.46,5,2,1,8,Regulars
49810,50,10,711.71,5,3,1,9,Loyal
49811,588,4,289.65000000000003,1,1,1,3,Hibernating
49812,152,6,251.38,3,1,1,5,Regulars
49813,189,13,1378.73,3,4,3,10,Regulars
49814,285,11,1063.1100000000001,2,3,2,7,Regulars
49815,85,8,698.99,4,2,1,7,Regulars
49816,138,8,757.41,4,2,1,7,Regulars
49817,181,11,1635.6100000000001,3,3,3,9,Regulars
49818,266,13,2047.69,2,4,4,10,At Risk
49819,120,14,2057.79,4,5,4,13,Champions
49820,827,12,2913.24,1,4,5,10,At Risk
49821,99,12,3165.24,4,4,5,13,Champions
49822,402,6,657.72,2,1,1,4,Hibernating
49823,354,12,3649.52,2,4,5,11,At Risk
49824,0,9,930.4999999999999,5,2,2,9,Regulars
49825,43,6,487.31,5,1,1,7,Regulars
49826,323,12,1300.5,2,4,3,9,At Risk
49827,400,9,1133.09,2,2,2,6,Hibernating
49828,496,15,3290.59,1,5,5,11,At Risk
49829,79,13,3419.94,4,4,5,13,Champions
49830,167,12,772.8499999999999,3,4,1,8,Regulars
49831,252,11,1488.48,2,3,3,8,Regulars
49832,45,7,786.56,5,1,1,7,Regulars
49833,186,7,1161.13,3,1,2,6,Regulars
49834,72,10,3134.6400000000003,4,3,5,12,Loyal
49835,609,6,854.8199999999999,1,1,2,4,Hibernating
49836,398,7,938.32,2,1,2,5,Hibernating
49837,485,9,837.47,1,2,1,4,Hibernating
49838,70,25,4428.36,4,5,5,14,Champions
49839,230,8,1075.65,3,2,2,7,Regulars
49840,203,8,1210.16,3,2,2,7,Regulars
49841,577,14,1984.17,1,5,4,10,At Risk
49842,7,15,2406.48,5,5,4,14,Champions
49843,10,12,1616.01,5,4,3,12,Loyal
49844,398,6,2308.41,2,1,4,7,Regulars
49845,47,13,2286.58,5,4,4,13,Champions
49846,231,15,1815.97,3,5,4,12,Big Spenders
49847,292,7,633.87,2,1,1,4,Hibernating
49848,5,8,763.2099999999999,5,2,1,8,Regulars
49849,260,6,3082.94,2,1,5,8,Regulars
49850,874,7,569.57,1,1,1,3,Hibernating
49851,9,8,2041.97,5,2,4,11,Big Spenders
49852,169,10,1297.46,3,3,3,9,Regulars
49853,49,11,1439.8000000000002,5,3,3,11,Loyal
49854,386,6,587.6999999999999,2,1,1,4,Hibernating
49855,14,15,1044.01,5,5,2,12,Loyal
49856,257,14,2739.6,2,5,5,12,At Risk
49857,195,8,1293.35,3,2,3,8,Regulars
49858,956,7,1256.8,1,1,3,5,Regulars
49859,626,7,1157.41,1,1,2,4,Hibernating
49860,528,8,1691.77,1,2,3,6,Regulars
49861,60,11,1705.33,5,3,3,11,Loyal
49862,449,12,2622.65,2,4,5,11,At Risk
49863,151,13,3419.54,3,4,5,12,Big Spenders
49864,223,9,1699.29,3,2,3,8,Regulars
49865,463,10,739.26,1,3,1,5,Regulars
49866,72,15,1478.5500000000002,4,5,3,12,Loyal
49867,50,10,777.23,5,3,1,9,Loyal
49868,959,15,1700.56,1,5,3,9,At Risk
49869,805,5,425.84000000000003,1,1,1,3,Hibernating
49870,573,9,1237.37,1,2,2,5,Hibernating
49871,41,16,2362.75,5,5,4,14,Champions
49872,41,12,2872.6,5,4,5,14,Champions
49873,298,8,3415.92,2,2,5,9,Regulars
49874,19,6,494.78,5,1,1,7,Regulars
49875,261,10,983.74,2,3,2,7,Regulars
49876,15,12,1361.26,5,4,3,12,Loyal
49877,365,7,924.4599999999999,2,1,2,5,Hibernating
49878,163,10,1753.77,3,3,4,10,Big Spenders
49879,38,11,1315.7,5,3,3,11,Loyal
49880,159,14,1786.72,3,5,4,12,Big Spenders
49881,417,6,2168.0,2,1,4,7,Regulars
49882,411,10,1074.79,2,3,2,7,Regulars
49883,1221,7,586.98,1,1,1,3,Hibernating
49884,43,9,951.97,5,2,2,9,Regulars
49885,109,11,2258.24,4,3,4,11,Loyal
49886,333,8,1456.3100000000002,2,2,3,7,Regulars
49887,410,9,1197.82,2,2,2,6,Hibernating
49888,651,9,1993.0600000000002,1,2,4,7,Regulars
49889,156,17,2126.09,3,5,4,12,Big Spenders
49890,1725,6,3466.87,1,1,5,7,Regulars
49891,49,13,918.13,5,4,2,11,Loyal
49892,152,15,3179.19,3,5,5,13,Big Spenders
49893,259,14,1943.59,2,5,4,11,At Risk
49894,168,7,739.51,3,1,1,5,Regulars
49895,154,14,2055.75,3,5,4,12,Big Spenders
49896,21,10,817.5899999999999,5,3,1,9,Loyal
49897,108,12,1263.77,4,4,3,11,Loyal
49898,159,11,1046.76,3,3,2,8,Regulars
49899,235,16,3062.64,3,5,5,13,Big Spenders
49900,398,10,3023.1000000000004,2,3,5,10,Regulars
49901,127,10,1393.14,4,3,3,10,Loyal
49902,90,8,5821.04,4,2,5,11,Big Spenders
49903,687,9,941.97,1,2,2,5,Hibernating
49904,208,10,1767.41,3,3,4,10,Big Spenders
49905,101,7,503.32,4,1,1,6,Regulars
49906,440,11,2478.37,2,3,4,9,Regulars
49907,94,14,1266.41,4,5,3,12,Loyal
49908,46,5,3473.88,5,1,5,11,Big Spenders
49909,186,8,2061.54,3,2,4,9,Big Spenders
49910,1755,5,694.9399999999999,1,1,1,3,Hibernating
49911,122,11,1329.33,4,3,3,10,Loyal
49912,20,14,6106.48,5,5,5,15,Champions
49913,443,8,1792.5099999999998,2,2,4,8,Regulars
49914,83,18,4052.29,4,5,5,14,Champions
49915,406,10,2034.25,2,3,4,9,Regulars
49916,180,13,1663.88,3,4,3,10,Regulars
49917,128,9,2497.24,4,2,4,10,Big Spenders
49918,113,12,5625.2,4,4,5,13,Champions
49919,33,18,2047.48,5,5,4,14,Champions
49920,15,12,1479.71,5,4,3,12,Loyal
49921,15,16,4743.139999999999,5,5,5,15,Champions
49922,1,14,3961.4,5,5,5,15,Champions
49923,2,14,1377.71,5,5,3,13,Loyal
49924,27,9,1073.88,5,2,2,9,Regulars
49925,156,11,1038.5800000000002,3,3,2,8,Regulars
49926,161,8,612.72,3,2,1,6,Regulars
49927,173,14,1199.5,3,5,2,10,Regulars
49928,290,9,1568.8600000000001,2,2,3,7,Regulars
49929,37,12,3676.2000000000003,5,4,5,14,Champions
49930,391,11,1254.26,2,3,3,8,Regulars
49931,186,11,2144.14,3,3,4,10,Big Spenders
49932,166,12,2314.45,3,4,4,11,Big Spenders
49933,411,14,4372.93,2,5,5,12,At Risk
49934,112,10,948.52,4,3,2,9,Loyal
49935,614,8,1415.52,1,2,3,6,Regulars
49936,300,12,1386.3,2,4,3,9,At Risk
49937,255,8,824.71,2,2,1,5,Hibernating
49938,146,9,929.97,4,2,2,8,Regulars
49939,888,7,718.0899999999999,1,1,1,3,Hibernating
49940,1139,5,281.23,1,1,1,3,Hibernating
49941,82,8,554.78,4,2,1,7,Regulars
49942,92,9,768.81,4,2,1,7,Regulars
49943,49,9,3140.0699999999997,5,2,5,12,Big Spenders
49944,274,6,852.32,2,1,2,5,Hibernating
49945,766,4,370.17,1,1,1,3,Hibernating
49946,1283,4,801.71,1,1,1,3,Hibernating
49947,3,8,1563.9500000000003,5,2,3,10,Regulars
49948,203,11,1384.45,3,3,3,9,Regulars
49949,125,9,1560.03,4,2,3,9,Regulars
49950,55,12,3969.55,5,4,5,14,Champions
49951,9,10,2158.05,5,3,4,12,Loyal
49952,80,9,757.76,4,2,1,7,Regulars
49953,146,10,1072.81,4,3,2,9,Loyal
49954,206,11,2033.1100000000001,3,3,4,10,Big Spenders
49955,138,10,2911.24,4,3,5,12,Loyal
49956,367,11,3885.9000000000005,2,3,5,10,Regulars
49957,156,5,792.86,3,1,1,5,Regulars
49958,43,10,4336.04,5,3,5,13,Loyal
49959,1194,5,1350.55,1,1,3,5,Regulars
49960,167,5,1670.17,3,1,3,7,Regulars
49961,149,19,2885.7000000000003,3,5,5,13,Big Spenders
49962,128,11,1174.64,4,3,2,9,Loyal
49963,822,7,1407.82,1,1,3,5,Regulars
49964,153,8,1336.56,3,2,3,8,Regulars
49965,176,11,1324.46,3,3,3,9,Regulars
49966,159,10,3523.12,3,3,5,11,Big Spenders
49967,64,8,1396.93,5,2,3,10,Regulars
49968,162,11,2306.73,3,3,4,10,Big Spenders
49969,38,6,681.3800000000001,5,1,1,7,Regulars
49970,142,10,1145.4,4,3,2,9,Loyal
49971,166,5,944.07,3,1,2,6,Regulars
49972,139,15,3669.9599999999996,4,5,5,14,Champions
49973,28,13,2172.27,5,4,4,13,Champions
49974,538,7,653.52,1,1,1,3,Hibernating
49975,90,8,798.62,4,2,1,7,Regulars
49976,588,8,722.67,1,2,1,4,Hibernating
49977,415,12,1954.03,2,4,4,10,At Risk
49978,306,11,1496.7,2,3,3,8,Regulars
49979,24,6,1717.0900000000001,5,1,3,9,Regulars
49980,170,10,1012.27,3,3,2,8,Regulars
49981,152,10,1736.27,3,3,4,10,Big Spenders
49982,1249,5,755.07,1,1,1,3,Hibernating
49983,62,11,1344.8600000000001,5,3,3,11,Loyal
49984,288,7,527.99,2,1,1,4,Hibernating
49985,383,6,555.01,2,1,1,4,Hibernating
49986,436,10,3359.99,2,3,5,10,Regulars
49987,356,15,3064.3,2,5,5,12,At Risk
49988,835,7,451.46,1,1,1,3,Hibernating
49989,554,12,3898.4500000000003,1,4,5,10,At Risk
49990,279,15,3193.98,2,5,5,12,At Risk
49991,128,9,2060.54,4,2,4,10,Big Spenders
49992,129,10,871.39,4,3,2,9,Loyal
49993,226,9,518.73,3,2,1,6,Regulars
49994,212,17,1903.04,3,5,4,12,Big Spenders
49995,279,7,1458.1000000000001,2,1,3,6,Regulars
49996,161,9,3682.8799999999997,3,2,5,10,Big Spenders
49997,793,10,3639.05,1,3,5,9,Regulars
49998,34,13,2969.62,5,4,5,14,Champions
49999,143,11,1173.48,4,3,2,9,Loyal
50000,174,12,1515.42,3,4,3,10,Regulars
